Reference ID,Query ID,Reference POS,Reference END,Query POS,REF,ALT,SVLEN
NC_037333.1,NC_032655.1,106045,106046,266,AC,A,1
NC_037333.1,NC_032655.1,110236,110237,4457,GT,G,1
NC_037333.1,NC_032655.1,110482,110484,4704,GGT,G,2
NC_037333.1,NC_032655.1,319172,319173,205269,CT,C,1
NC_037333.1,NC_032655.1,319188,319189,205284,GT,G,1
NC_037333.1,NC_032655.1,406221,406222,292750,AG,A,1
NC_037333.1,NC_032655.1,434136,434137,320675,AT,A,1
NC_037333.1,NC_032655.1,523591,523592,411165,CT,C,1
NC_037333.1,NC_032655.1,595183,595184,483984,TC,T,1
NC_037333.1,NC_032655.1,595236,595237,484034,GT,G,1
NC_037333.1,NC_032655.1,595245,595246,484042,CA,C,1
NC_037333.1,NC_032655.1,595253,595254,484049,GT,G,1
NC_037333.1,NC_032655.1,723328,723333,627530,GTTTAA,G,5
NC_037333.1,NC_032655.1,851364,851366,757739,TTG,T,2
NC_037333.1,NC_032655.1,852023,852024,758402,TG,T,1
NC_037333.1,NC_032655.1,970152,970156,891374,TCCAC,T,4
NC_037333.1,NC_032655.1,982393,982402,903645,CAGCACTCTA,C,9
NC_037333.1,NC_032655.1,1024090,1024091,945303,GT,G,1
NC_037333.1,NC_032655.1,1087999,1088001,1009269,TAA,T,2
NC_037333.1,NC_032655.1,1092815,1092816,1014085,TG,T,1
NC_037333.1,NC_032655.1,1122923,1122925,1044787,CTT,C,2
NC_037333.1,NC_032655.1,1363771,1363772,1377319,TC,T,1
NC_037333.1,NC_032655.1,1910514,1910515,1455385,CT,C,1
NC_037333.1,NC_032655.1,1947175,1947176,1491947,GC,G,1
NC_037333.1,NC_032655.1,2037074,2037075,1597123,GT,G,1
NC_037333.1,NC_032655.1,2077501,2077519,1681414,TTCAAGAATACATCCAGCA,T,18
NC_037333.1,NC_032655.1,2344656,2344657,1948965,AT,A,1
NC_037333.1,NC_032655.1,2620960,2620961,2487351,AG,A,1
NC_037333.1,NC_032655.1,2814247,2814248,2697024,GC,G,1
NC_037333.1,NC_032655.1,2949632,2949634,2833481,CAT,C,2
NC_037333.1,NC_032655.1,2970482,2970484,2854342,ATG,A,2
NC_037333.1,NC_032655.1,3393689,3393690,3349121,GT,G,1
NC_037333.1,NC_032655.1,3428205,3428207,3383693,CTT,C,2
NC_037333.1,NC_032655.1,3490661,3490662,3446309,GC,G,1
NC_037333.1,NC_032655.1,3831517,3831518,3754752,TG,T,1
NC_037333.1,NC_032655.1,3899882,3899884,3787684,GAT,G,2
NC_037333.1,NC_032655.1,3912481,3912482,3800315,CT,C,1
NC_037333.1,NC_032655.1,3982249,3982250,3871953,AC,A,1
NC_037333.1,NC_032655.1,4002340,4002361,3892046,CAATTTGTTAATTTACAATACA,C,21
NC_037333.1,NC_032655.1,4014517,4014520,3903974,TAAC,T,3
NC_037333.1,NC_032655.1,4167480,4167481,4056090,TC,T,1
NC_037333.1,NC_032655.1,4227086,4227087,4117074,TG,T,1
NC_037333.1,NC_032655.1,4264887,4264888,4155023,CT,C,1
NC_037333.1,NC_032655.1,4327491,4327493,4215561,ACT,A,2
NC_037333.1,NC_032655.1,4334303,4334304,4222371,AC,A,1
NC_037333.1,NC_032655.1,4368590,4368591,4256490,GC,G,1
NC_037333.1,NC_032655.1,4590505,4590506,4599649,AT,A,1
NC_037333.1,NC_032655.1,4590542,4590543,4599684,TG,T,1
NC_037333.1,NC_032655.1,4623837,4623838,4633974,GC,G,1
NC_037333.1,NC_032655.1,4870772,4870773,4998370,GC,G,1
NC_037333.1,NC_032655.1,4887844,4887845,5015389,TC,T,1
NC_037333.1,NC_032655.1,4888025,4888026,5015569,AT,A,1
NC_037333.1,NC_032655.1,5199880,5199881,5218924,AG,A,1
NC_037333.1,NC_032655.1,5211108,5211110,5230159,TAA,T,2
NC_037333.1,NC_032655.1,5435457,5435458,5464218,TC,T,1
NC_037333.1,NC_032655.1,5436143,5436144,5464931,CG,C,1
NC_037333.1,NC_032655.1,5436544,5436545,5465331,TA,T,1
NC_037333.1,NC_032655.1,5443725,5443726,5472068,CA,C,1
NC_037333.1,NC_032655.1,5650277,5650278,6063023,CT,C,1
NC_037333.1,NC_032655.1,5650282,5650283,6063027,GC,G,1
NC_037333.1,NC_032655.1,5676641,5676642,6089406,TC,T,1
NC_037333.1,NC_032655.1,5786340,5786349,6199227,TAACAAACTG,T,9
NC_037333.1,NC_032655.1,5786351,5786357,6199229,TCTAACA,T,6
NC_037333.1,NC_032655.1,5789424,5789438,6202312,ATGTAAAGCACTGGT,A,14
NC_037333.1,NC_032655.1,5791248,5791249,6204130,GC,G,1
NC_037333.1,NC_032655.1,5795557,5795558,6208498,CA,C,1
NC_037333.1,NC_032655.1,5795895,5795904,6208835,TTGGTTGTGA,T,9
NC_037333.1,NC_032655.1,5796090,5796091,6209021,CT,C,1
NC_037333.1,NC_032655.1,5800627,5800628,6213589,GC,G,1
NC_037333.1,NC_032655.1,5800627,5800628,6668485,GC,G,1
NC_037333.1,NC_032655.1,5822797,5822798,6690654,GA,G,1
NC_037333.1,NC_032655.1,5837904,5837905,6705791,CG,C,1
NC_037333.1,NC_032655.1,5857679,5857680,6725678,TG,T,1
NC_037333.1,NC_032655.1,5881845,5881846,6749838,TA,T,1
NC_037333.1,NC_032655.1,5897086,5897088,6339082,TTG,T,2
NC_037333.1,NC_032655.1,6180450,6180451,7040203,CA,C,1
NC_037333.1,NC_032655.1,6411046,6411052,7281923,TTAAGAA,T,6
NC_037333.1,NC_032655.1,6505429,6505489,7376676,AGGCAATGTGCATTAGCCGTTATTGATACCAGCTCACTGGACTTGGGAAGTCTCTGGTCTG,A,60
NC_037333.1,NC_032655.1,6540590,6540591,7411784,AT,A,1
NC_037333.1,NC_032655.1,6592696,6592697,7463865,GT,G,1
NC_037333.1,NC_032655.1,6637609,6637611,7508863,CTG,C,2
NC_037333.1,NC_032655.1,6835453,6835454,7768834,GT,G,1
NC_037333.1,NC_032655.1,6853988,6853989,7792672,GC,G,1
NC_037333.1,NC_032655.1,6944871,6944890,7884765,AAAATAACTTATTTACAGGT,A,19
NC_037333.1,NC_032655.1,6947023,6947024,7886932,AT,A,1
NC_037333.1,NC_032655.1,7214196,7214197,8151506,TG,T,1
NC_037333.1,NC_032655.1,7215506,7215508,8152816,CTT,C,2
NC_037333.1,NC_032655.1,7234835,7234836,8172147,AG,A,1
NC_037333.1,NC_032655.1,7243494,7243496,8180789,GCT,G,2
NC_037333.1,NC_032655.1,7512868,7512869,8450743,TC,T,1
NC_037333.1,NC_032655.1,7520115,7520126,8457398,TGTGGTACATAG,T,11
NC_037333.1,NC_032655.1,7524699,7524700,8461894,AC,A,1
NC_037333.1,NC_032655.1,7611977,7611978,8550582,CA,C,1
NC_037333.1,NC_032655.1,7611990,7611991,8550594,GT,G,1
NC_037333.1,NC_032655.1,7695781,7695782,8634396,AC,A,1
NC_037333.1,NC_032655.1,7705778,7705783,8644386,CATCTT,C,5
NC_037333.1,NC_032655.1,7709528,7709531,8648145,CAGG,C,3
NC_037333.1,NC_032655.1,7755861,7755862,8681084,TC,T,1
NC_037333.1,NC_032655.1,7867150,7867151,8793837,CA,C,1
NC_037333.1,NC_032655.1,7867158,7867159,8793844,GT,G,1
NC_037333.1,NC_032655.1,8164483,8164484,9053723,CG,C,1
NC_037333.1,NC_032655.1,8301008,8301022,9190275,CTTAATATAATACAA,C,14
NC_037333.1,NC_032655.1,8301074,8301075,9190327,AT,A,1
NC_037333.1,NC_032655.1,8558083,8558085,9445825,TTG,T,2
NC_037333.1,NC_032655.1,8622355,8622356,9505109,TC,T,1
NC_037333.1,NC_032655.1,8888642,8888643,9776030,AG,A,1
NC_037333.1,NC_032655.1,8995897,8995898,9881560,CT,C,1
NC_037333.1,NC_032655.1,8997686,8997687,9883354,CT,C,1
NC_037333.1,NC_032655.1,8997742,8997743,9883409,CA,C,1
NC_037333.1,NC_032655.1,8997768,8997769,9883434,GT,G,1
NC_037333.1,NC_032655.1,8997978,8997979,9883647,CA,C,1
NC_037333.1,NC_032655.1,8998785,8998786,9884449,GA,G,1
NC_037333.1,NC_032655.1,9131882,9131883,10037572,TA,T,1
NC_037333.1,NC_032655.1,9131928,9131929,10037617,AG,A,1
NC_037333.1,NC_032655.1,9131939,9131940,10037627,TA,T,1
NC_037333.1,NC_032655.1,9131993,9131994,10037678,AC,A,1
NC_037333.1,NC_032655.1,9204240,9204242,10263115,CTA,C,2
NC_037333.1,NC_032655.1,9204568,9204570,10263440,CAA,C,2
NC_037333.1,NC_032655.1,9407498,9407499,10457596,TG,T,1
NC_037333.1,NC_032655.1,9415630,9415631,10465689,TG,T,1
NC_037333.1,NC_032655.1,9563701,9563702,10500707,AT,A,1
NC_037333.1,NC_032655.1,9678843,9678844,10724554,CA,C,1
NC_037333.1,NC_032655.1,9688234,9688235,10733999,TA,T,1
NC_037333.1,NC_032655.1,9690923,9690924,10736719,TG,T,1
NC_037333.1,NC_032655.1,9701525,9701526,10747341,GT,G,1
NC_037333.1,NC_032655.1,10021821,10021823,11088627,TAA,T,2
NC_037333.1,NC_032655.1,10033855,10033856,11100581,TA,T,1
NC_037333.1,NC_032655.1,10203594,10203595,11275903,TG,T,1
NC_037333.1,NC_032655.1,10253945,10253947,11324113,CTT,C,2
NC_037333.1,NC_032655.1,11044665,11044672,12121172,CAGTCATA,C,7
NC_037333.1,NC_032655.1,11069516,11069517,12143589,GC,G,1
NC_037333.1,NC_032655.1,11091224,11091225,12165354,GC,G,1
NC_037333.1,NC_032655.1,11100911,11100912,12175938,GC,G,1
NC_037333.1,NC_032655.1,11109271,11109272,12184303,GA,G,1
NC_037333.1,NC_032655.1,11132631,11132632,12207744,GT,G,1
NC_037333.1,NC_032655.1,11133814,11133816,12208927,AAC,A,2
NC_037333.1,NC_032655.1,11372934,11372935,12452531,TC,T,1
NC_037333.1,NC_032655.1,11399650,11399651,12479248,TA,T,1
NC_037333.1,NC_032655.1,11403869,11403870,12483465,AT,A,1
NC_037333.1,NC_032655.1,11405282,11405283,12484878,TC,T,1
NC_037333.1,NC_032655.1,11409179,11409180,12488774,CA,C,1
NC_037333.1,NC_032655.1,11416396,11416397,12496023,AT,A,1
NC_037333.1,NC_032655.1,11418031,11418032,12497657,AT,A,1
NC_037333.1,NC_032655.1,11470981,11470983,12550429,CTT,C,2
NC_037333.1,NC_032655.1,11475448,11475451,12554887,CCTT,C,3
NC_037333.1,NC_032655.1,11490635,11490639,12570068,TACAA,T,4
NC_037333.1,NC_032655.1,11490813,11490817,12570240,TCATC,T,4
NC_037333.1,NC_032655.1,11515558,11515559,12595001,TG,T,1
NC_037333.1,NC_032655.1,11611698,11611699,12691142,GA,G,1
NC_037333.1,NC_032655.1,11614909,11614910,12694352,AC,A,1
NC_037333.1,NC_032655.1,11776398,11776399,12875590,CT,C,1
NC_037333.1,NC_032655.1,11794601,11794617,12893584,CAGATGGATTCTGCTTT,C,16
NC_037333.1,NC_032655.1,11807119,11807121,12906080,TTA,T,2
NC_037333.1,NC_032655.1,11807126,11807127,12906085,GA,G,1
NC_037333.1,NC_032655.1,11835128,11835129,12933304,CA,C,1
NC_037333.1,NC_032655.1,11856875,11856876,12955051,GT,G,1
NC_037333.1,NC_032655.1,11876629,11876630,12972847,CT,C,1
NC_037333.1,NC_032655.1,11936680,11936681,13033813,AT,A,1
NC_037333.1,NC_032655.1,11955745,11955746,13052885,TG,T,1
NC_037333.1,NC_032655.1,11956629,11956631,13053769,CAT,C,2
NC_037333.1,NC_032655.1,11999837,11999838,13097295,AG,A,1
NC_037333.1,NC_032655.1,12095084,12095090,13212229,CATATTA,C,6
NC_037333.1,NC_032655.1,12227515,12227516,13346074,TC,T,1
NC_037333.1,NC_032655.1,12409627,12409629,13529357,AAT,A,2
NC_037333.1,NC_032655.1,12409642,12409643,13529370,GT,G,1
NC_037333.1,NC_032655.1,12542273,12542275,13669650,CCT,C,2
NC_037333.1,NC_032655.1,12547823,12547824,13675205,TC,T,1
NC_037333.1,NC_032655.1,12558246,12558248,13685629,CAG,C,2
NC_037333.1,NC_032655.1,12562805,12562806,13688206,TC,T,1
NC_037333.1,NC_032655.1,12563938,12563939,13689338,TG,T,1
NC_037333.1,NC_032655.1,12616828,12616829,13742235,CA,C,1
NC_037333.1,NC_032655.1,12643641,12643653,13769054,TATATTGATATAG,T,12
NC_037333.1,NC_032655.1,12809058,12809059,14014078,CT,C,1
NC_037333.1,NC_032655.1,12878929,12878930,14083951,TA,T,1
NC_037333.1,NC_032655.1,12879022,12879023,14084043,AG,A,1
NC_037333.1,NC_032655.1,12892586,12892587,13954264,TC,T,1
NC_037333.1,NC_032655.1,12922272,12922275,13983983,TCAA,T,3
NC_037333.1,NC_032655.1,13062316,13062317,14213066,TC,T,1
NC_037333.1,NC_032655.1,13110364,13110365,14265891,TA,T,1
NC_037333.1,NC_032655.1,13110802,13110803,14266319,GC,G,1
NC_037333.1,NC_032655.1,13849414,13849415,15271479,TG,T,1
NC_037333.1,NC_032655.1,14033200,14033201,15455288,CT,C,1
NC_037333.1,NC_032655.1,14037589,14037590,15459677,TG,T,1
NC_037333.1,NC_032655.1,14122182,14122184,15545059,TTC,T,2
NC_037333.1,NC_032655.1,14173582,14173583,15596463,GT,G,1
NC_037333.1,NC_032655.1,14175320,14175321,15598198,GC,G,1
NC_037333.1,NC_032655.1,14176156,14176157,15599032,AT,A,1
NC_037333.1,NC_032655.1,14176167,14176168,15599042,TA,T,1
NC_037333.1,NC_032655.1,14176218,14176219,15599092,AT,A,1
NC_037333.1,NC_032655.1,14176909,14176910,15599784,AC,A,1
NC_037333.1,NC_032655.1,14177211,14177212,15600086,GT,G,1
NC_037333.1,NC_032655.1,14177596,14177597,15600471,GA,G,1
NC_037333.1,NC_032655.1,14177621,14177622,15600495,CT,C,1
NC_037333.1,NC_032655.1,14177660,14177661,15600533,TA,T,1
NC_037333.1,NC_032655.1,14177776,14177777,15600648,GT,G,1
NC_037333.1,NC_032655.1,14178048,14178049,15600924,AC,A,1
NC_037333.1,NC_032655.1,14178142,14178143,15601018,CT,C,1
NC_037333.1,NC_032655.1,14178175,14178176,15601050,GC,G,1
NC_037333.1,NC_032655.1,14178314,14178315,15601188,AT,A,1
NC_037333.1,NC_032655.1,14178415,14178417,15601287,ATT,A,2
NC_037333.1,NC_032655.1,14178453,14178454,15601323,CT,C,1
NC_037333.1,NC_032655.1,14178612,14178613,15601482,AG,A,1
NC_037333.1,NC_032655.1,14178737,14178739,15601606,CAT,C,2
NC_037333.1,NC_032655.1,14319834,14319835,15723586,CT,C,1
NC_037333.1,NC_032655.1,15004737,15004739,16413621,AAC,A,2
NC_037333.1,NC_032655.1,15037961,15037962,16431881,CG,C,1
NC_037333.1,NC_032655.1,15611516,15611517,17015086,CT,C,1
NC_037333.1,NC_032655.1,15611635,15611636,17015204,TG,T,1
NC_037333.1,NC_032655.1,15621024,15621025,17024596,TG,T,1
NC_037333.1,NC_032655.1,15709809,15709810,17116511,CT,C,1
NC_037333.1,NC_032655.1,15715916,15715917,17122621,TA,T,1
NC_037333.1,NC_032655.1,15766457,15766458,17172776,GC,G,1
NC_037333.1,NC_032655.1,15800871,15800872,17207212,GT,G,1
NC_037333.1,NC_032655.1,16244445,16244449,17648670,AGGCC,A,4
NC_037333.1,NC_032655.1,16402924,16402925,17806953,AC,A,1
NC_037333.1,NC_032655.1,16471822,16471866,17875863,TTTCTGCCACCGTCCCTTCTCCATCCTAGCCTAATGTTCTCTTGG,T,44
NC_037333.1,NC_032655.1,16538083,16538084,17954070,AG,A,1
NC_037333.1,NC_032655.1,16665723,16665724,18080357,TA,T,1
NC_037333.1,NC_032655.1,16665744,16665745,18080377,TA,T,1
NC_037333.1,NC_032655.1,16720130,16720131,18135081,CA,C,1
NC_037333.1,NC_032655.1,16880713,16880714,18295370,GT,G,1
NC_037333.1,NC_032655.1,17056313,17056314,18458375,GT,G,1
NC_037333.1,NC_032655.1,17571825,17571826,18975998,CA,C,1
NC_037333.1,NC_032655.1,17571848,17571849,18976020,GT,G,1
NC_037333.1,NC_032655.1,17796418,17796419,19249503,AT,A,1
NC_037333.1,NC_032655.1,17852765,17852767,19304948,TCA,T,2
NC_037333.1,NC_032655.1,18325319,18325320,19796576,GT,G,1
NC_037333.1,NC_032655.1,18325340,18325341,19796596,AG,A,1
NC_037333.1,NC_032655.1,18325345,18325346,19796600,TG,T,1
NC_037333.1,NC_032655.1,18453365,18453366,19924593,AT,A,1
NC_037333.1,NC_032655.1,18705577,18705578,20200000,AG,A,1
NC_037333.1,NC_032655.1,18984051,18984052,20493608,TG,T,1
NC_037333.1,NC_032655.1,19001998,19001999,20511211,AT,A,1
NC_037333.1,NC_032655.1,19002013,19002014,20511225,GT,G,1
NC_037333.1,NC_032655.1,19002047,19002048,20511257,TA,T,1
NC_037333.1,NC_032655.1,19002055,19002062,20511264,AACTCATT,A,7
NC_037333.1,NC_032655.1,19029070,19029072,20541321,AAG,A,2
NC_037333.1,NC_032655.1,19066032,19066033,20579029,CG,C,1
NC_037333.1,NC_032655.1,19763417,19763426,21246153,ATCTGATAGT,A,9
NC_037333.1,NC_032655.1,19826735,19826796,21310250,GAGTCTGAAGTAAACACAGCTGATCGGCAAGGGCCATAAAATCTCTTCCACCGAATCTTTGA,G,61
NC_037333.1,NC_032655.1,20088491,20088492,21574704,CA,C,1
NC_037333.1,NC_032655.1,20302086,20302087,21794149,CA,C,1
NC_037333.1,NC_032655.1,20306695,20306696,21798757,GA,G,1
NC_037333.1,NC_032655.1,20370366,20370367,21861345,CT,C,1
NC_037333.1,NC_032655.1,20391356,20391357,21882314,CT,C,1
NC_037333.1,NC_032655.1,20599222,20599223,22111939,AC,A,1
NC_037333.1,NC_032655.1,20599226,20599227,22111942,TA,T,1
NC_037333.1,NC_032655.1,20601171,20601172,22113885,AC,A,1
NC_037333.1,NC_032655.1,20610409,20610410,22149734,AT,A,1
NC_037333.1,NC_032655.1,20633007,20633010,22172320,TCTG,T,3
NC_037333.1,NC_032655.1,20698853,20698854,22237729,GC,G,1
NC_037333.1,NC_032655.1,20912213,20912214,22452802,GA,G,1
NC_037333.1,NC_032655.1,20914527,20914528,22455114,AG,A,1
NC_037333.1,NC_032655.1,20984072,20984073,22524742,GA,G,1
NC_037333.1,NC_032655.1,21320491,21320492,22874165,CG,C,1
NC_037333.1,NC_032655.1,21355799,21355800,22909302,TA,T,1
NC_037333.1,NC_032655.1,22014303,22014305,23628379,ATC,A,2
NC_037333.1,NC_032655.1,22096144,22096145,23710133,AC,A,1
NC_037333.1,NC_032655.1,22096325,22096327,23710311,TTG,T,2
NC_037333.1,NC_032655.1,22246328,22246329,23860351,TA,T,1
NC_037333.1,NC_032655.1,22264427,22264428,23878452,CA,C,1
NC_037333.1,NC_032655.1,22553812,22553813,24126972,TC,T,1
NC_037333.1,NC_032655.1,22867941,22867942,24493793,GC,G,1
NC_037333.1,NC_032655.1,23388963,23388964,25048517,AG,A,1
NC_037333.1,NC_032655.1,23536778,23536780,25200298,CTT,C,2
NC_037333.1,NC_032655.1,24569711,24569712,26246346,GA,G,1
NC_037333.1,NC_032655.1,24569721,24569723,26246355,TTA,T,2
NC_037333.1,NC_032655.1,24569736,24569737,26246368,CA,C,1
NC_037333.1,NC_032655.1,25177985,25177986,26937011,TG,T,1
NC_037333.1,NC_032655.1,25364253,25364255,27164633,TAC,T,2
NC_037333.1,NC_032655.1,25564653,25564654,27373633,GC,G,1
NC_037333.1,NC_032655.1,25597844,25597845,27405443,TA,T,1
NC_037333.1,NC_032655.1,25881669,25881671,27693724,GGC,G,2
NC_037333.1,NC_032655.1,26462649,26462650,28243680,GT,G,1
NC_037333.1,NC_032655.1,26515743,26515744,28296777,GA,G,1
NC_037333.1,NC_032655.1,26655887,26655888,28463718,TC,T,1
NC_037333.1,NC_032655.1,26655984,26655985,28463812,AT,A,1
NC_037333.1,NC_032655.1,26969323,26969324,28777671,AT,A,1
NC_037333.1,NC_032655.1,27516677,27516678,29330434,CT,C,1
NC_037333.1,NC_032655.1,27650278,27650279,29518874,TA,T,1
NC_037333.1,NC_032655.1,28103567,28103568,29977515,TA,T,1
NC_037333.1,NC_032655.1,28326684,28326686,30200616,TTC,T,2
NC_037333.1,NC_032655.1,28326706,28326707,30200636,GA,G,1
NC_037333.1,NC_032655.1,28326717,28326718,30200646,TA,T,1
NC_037333.1,NC_032655.1,29057759,29057760,30937718,CA,C,1
NC_037333.1,NC_032655.1,30400103,30400104,32312200,TG,T,1
NC_037333.1,NC_032655.1,30878798,30878799,32824448,TG,T,1
NC_037333.1,NC_032655.1,31005527,31005528,32951415,GA,G,1
NC_037333.1,NC_032655.1,32629686,32629687,34684576,CA,C,1
NC_037333.1,NC_032655.1,32629782,32629783,34684670,GC,G,1
NC_037333.1,NC_032655.1,32630221,32630222,34685106,TA,T,1
NC_037333.1,NC_032655.1,32630234,32630235,34685118,CA,C,1
NC_037333.1,NC_032655.1,32630242,32630244,34685125,TTG,T,2
NC_037333.1,NC_032655.1,32630277,32630278,34685158,AG,A,1
NC_037333.1,NC_032655.1,32630553,32630554,34685431,AC,A,1
NC_037333.1,NC_032655.1,32631170,32631171,34686048,TC,T,1
NC_037333.1,NC_032655.1,32631835,32631836,34686708,CT,C,1
NC_037333.1,NC_032655.1,32633468,32633469,34688329,CT,C,1
NC_037333.1,NC_032655.1,33194126,33194127,34735783,GA,G,1
NC_037333.1,NC_032655.1,33194187,33194188,34735843,AT,A,1
NC_037333.1,NC_032655.1,33194196,33194197,34735851,GA,G,1
NC_037333.1,NC_032655.1,33474802,33474803,35016539,CA,C,1
NC_037333.1,NC_032655.1,33544555,33544556,35086237,AT,A,1
NC_037333.1,NC_032655.1,33619537,33619538,35161211,GA,G,1
NC_037333.1,NC_032655.1,33619547,33619548,35161220,GA,G,1
NC_037333.1,NC_032655.1,33775471,33775473,35318691,TTA,T,2
NC_037333.1,NC_032655.1,33775478,33775479,35318696,AG,A,1
NC_037333.1,NC_032655.1,33775489,33775490,35318706,CT,C,1
NC_037333.1,NC_032655.1,33775497,33775498,35318713,TG,T,1
NC_037333.1,NC_032655.1,33775511,33775512,35318726,CT,C,1
NC_037333.1,NC_032655.1,33775531,33775532,35318745,AC,A,1
NC_037333.1,NC_032655.1,33994254,33994256,35599905,GGA,G,2
NC_037333.1,NC_032655.1,33994308,33994309,35599956,TA,T,1
NC_037333.1,NC_032655.1,33994335,33994336,35599982,TC,T,1
NC_037333.1,NC_032655.1,34157571,34157605,35763225,AATATCACTAGAGGAACTTCTCTGAAAGTAGAAAC,A,34
NC_037333.1,NC_032655.1,34259410,34259411,35865038,AT,A,1
NC_037333.1,NC_032655.1,34437907,34437908,36043427,TA,T,1
NC_037333.1,NC_032655.1,34483417,34483418,36088254,AT,A,1
NC_037333.1,NC_032655.1,34483423,34483424,36088259,GA,G,1
NC_037333.1,NC_032655.1,34483432,34483433,36088267,AT,A,1
NC_037333.1,NC_032655.1,34483457,34483458,36088291,AT,A,1
NC_037333.1,NC_032655.1,34694867,34694869,36346427,AAG,A,2
NC_037333.1,NC_032655.1,34762174,34762175,36413792,TC,T,1
NC_037333.1,NC_032655.1,34861117,34861118,36513589,AG,A,1
NC_037333.1,NC_032655.1,34886491,34886493,36538854,AAC,A,2
NC_037333.1,NC_032655.1,34991903,34991905,36644264,TTC,T,2
NC_037333.1,NC_032655.1,36019014,36019015,36832655,GA,G,1
NC_037333.1,NC_032655.1,36236969,36236970,37057493,GA,G,1
NC_037333.1,NC_032655.1,36236992,36236993,37057515,GC,G,1
NC_037333.1,NC_032655.1,36237009,36237010,37057531,GC,G,1
NC_037333.1,NC_032655.1,36237018,36237019,37057539,TA,T,1
NC_037333.1,NC_032655.1,36237038,36237039,37057558,CA,C,1
NC_037333.1,NC_032655.1,36250337,36250338,37070919,CA,C,1
NC_037333.1,NC_032655.1,36286356,36286357,37106666,GT,G,1
NC_037333.1,NC_032655.1,36415672,36415673,37236292,GT,G,1
NC_037333.1,NC_032655.1,36760763,36760765,37582854,AAG,A,2
NC_037333.1,NC_032655.1,37044346,37044347,37867878,TC,T,1
NC_037333.1,NC_032655.1,37168187,37168188,37990772,CT,C,1
NC_037333.1,NC_032655.1,37168187,37168188,38070217,CT,C,1
NC_037333.1,NC_032655.1,37196020,37196022,38098059,GTA,G,2
NC_037333.1,NC_032655.1,37700828,37700829,38603466,AC,A,1
NC_037333.1,NC_032655.1,38396624,38396625,39304221,AC,A,1
NC_037333.1,NC_032655.1,38725013,38725014,39724350,TC,T,1
NC_037333.1,NC_032655.1,38768744,38768749,39768018,TTGGTG,T,5
NC_037333.1,NC_032655.1,38774606,38774607,39773904,TC,T,1
NC_037333.1,NC_032655.1,38956960,38956962,39952967,AAT,A,2
NC_037333.1,NC_032655.1,39068096,39068097,40064152,CG,C,1
NC_037333.1,NC_032655.1,39442627,39442631,40692106,AACGG,A,4
NC_037333.1,NC_032655.1,39442627,39442631,40629332,AACGG,A,4
NC_037333.1,NC_032655.1,39646877,39646878,40897937,GA,G,1
NC_037333.1,NC_032655.1,39734041,39734042,40984893,AG,A,1
NC_037333.1,NC_032655.1,39766915,39766916,41017372,CA,C,1
NC_037333.1,NC_032655.1,39846751,39846752,41098221,GT,G,1
NC_037333.1,NC_032655.1,39850700,39850701,41102169,TG,T,1
NC_037333.1,NC_032655.1,40305878,40305879,41554896,GA,G,1
NC_037333.1,NC_032655.1,40337344,40337345,41587199,CT,C,1
NC_037333.1,NC_032655.1,40345037,40345038,41593842,AT,A,1
NC_037333.1,NC_032655.1,40346963,40346964,41595763,TC,T,1
NC_037333.1,NC_032655.1,40376944,40376945,41625775,AT,A,1
NC_037333.1,NC_032655.1,40380330,40380332,41628824,AAG,A,2
NC_037333.1,NC_032655.1,40409763,40409764,41658991,AC,A,1
NC_037333.1,NC_032655.1,40449287,40449288,41698669,GA,G,1
NC_037333.1,NC_032655.1,40462483,40462484,41712872,AC,A,1
NC_037333.1,NC_032655.1,40545393,40545394,41795794,GT,G,1
NC_037333.1,NC_032655.1,40550701,40550702,41801101,AG,A,1
NC_037333.1,NC_032655.1,40582552,40582553,41832960,TA,T,1
NC_037333.1,NC_032655.1,40954222,40954223,42206204,CG,C,1
NC_037333.1,NC_032655.1,41067763,41067764,42319826,TA,T,1
NC_037333.1,NC_032655.1,41067806,41067807,42319869,AG,A,1
NC_037333.1,NC_032655.1,41067816,41067817,42319878,AG,A,1
NC_037333.1,NC_032655.1,41302716,41302717,42564820,CA,C,1
NC_037333.1,NC_032655.1,41413910,41413911,42676029,TA,T,1
NC_037333.1,NC_032655.1,41432748,41432749,42693932,GA,G,1
NC_037333.1,NC_032655.1,41432755,41432756,42693938,GA,G,1
NC_037333.1,NC_032655.1,41432762,41432763,42693944,CA,C,1
NC_037333.1,NC_032655.1,41432769,41432770,42693950,GA,G,1
NC_037333.1,NC_032655.1,41566744,41566745,42842412,AT,A,1
NC_037333.1,NC_032655.1,41726783,41726784,43023262,TC,T,1
NC_037333.1,NC_032655.1,41783197,41783215,43079688,CCATTGTCAAAAGTCAATT,C,18
NC_037333.1,NC_032655.1,41961335,41961336,43258359,TG,T,1
NC_037333.1,NC_032655.1,42057647,42057648,43354916,CA,C,1
NC_037333.1,NC_032655.1,42057725,42057726,43354989,CT,C,1
NC_037333.1,NC_032655.1,42057736,42057737,43354999,AT,A,1
NC_037333.1,NC_032655.1,42057746,42057747,43355008,GC,G,1
NC_037333.1,NC_032655.1,42075231,42075236,43372492,GGTATA,G,5
NC_037333.1,NC_032655.1,42210650,42210651,43506321,AT,A,1
NC_037333.1,NC_032655.1,42216254,42216255,43514031,CA,C,1
NC_037333.1,NC_032655.1,42380394,42380397,43676942,GGTA,G,3
NC_037333.1,NC_032655.1,42380399,42380404,43676944,AGGAAT,A,5
NC_037333.1,NC_032655.1,42795170,42795171,44228612,GC,G,1
NC_037333.1,NC_032655.1,42798525,42798526,44231966,GA,G,1
NC_037333.1,NC_032655.1,42941847,42941848,44375656,TC,T,1
NC_037333.1,NC_032655.1,42942310,42942311,44376118,AC,A,1
NC_037333.1,NC_032655.1,42950309,42950310,44384123,CA,C,1
NC_037333.1,NC_032655.1,42950509,42950510,44384322,TC,T,1
NC_037333.1,NC_032655.1,42986377,42986378,44420201,CA,C,1
NC_037333.1,NC_032655.1,43058243,43058244,44494568,AT,A,1
NC_037333.1,NC_032655.1,43065434,43065437,44501753,CCTT,C,3
NC_037333.1,NC_032655.1,43155794,43155795,44589955,TA,T,1
NC_037333.1,NC_032655.1,43215193,43215196,44649390,AGCC,A,3
NC_037333.1,NC_032655.1,43231778,43231779,44666062,AT,A,1
NC_037333.1,NC_032655.1,43286510,43286513,44720797,ACTG,A,3
NC_037333.1,NC_032655.1,43473167,43473168,44905531,CT,C,1
NC_037333.1,NC_032655.1,43849988,43849989,45282413,GC,G,1
NC_037333.1,NC_032655.1,43888640,43888641,45321065,CT,C,1
NC_037333.1,NC_032655.1,43888657,43888658,45321081,GT,G,1
NC_037333.1,NC_032655.1,44236427,44236428,45668839,AT,A,1
NC_037333.1,NC_032655.1,44240540,44240541,45672935,GC,G,1
NC_037333.1,NC_032655.1,44343268,44343269,45775508,CA,C,1
NC_037333.1,NC_032655.1,44343280,44343281,45775519,CA,C,1
NC_037333.1,NC_032655.1,44516066,44516067,45948233,TG,T,1
NC_037333.1,NC_032655.1,44599543,44599545,46038325,AAG,A,2
NC_037333.1,NC_032655.1,44733429,44733430,46172057,TA,T,1
NC_037333.1,NC_032655.1,44733469,44733471,46172094,AAT,A,2
NC_037333.1,NC_032655.1,44775835,44775837,46214459,AAC,A,2
NC_037333.1,NC_032655.1,44775891,44775892,46214512,GT,G,1
NC_037333.1,NC_032655.1,45186128,45186129,46584327,AG,A,1
NC_037333.1,NC_032655.1,45863658,45863659,47269816,GT,G,1
NC_037333.1,NC_032655.1,45932985,45932986,47339514,CT,C,1
NC_037333.1,NC_032655.1,46172237,46172238,47621907,CA,C,1
NC_037333.1,NC_032655.1,46182064,46182066,47635455,TTG,T,2
NC_037333.1,NC_032655.1,46182072,46182073,47635461,CT,C,1
NC_037333.1,NC_032655.1,46182088,46182089,47635476,CT,C,1
NC_037333.1,NC_032655.1,46182097,46182098,47635484,GT,G,1
NC_037333.1,NC_032655.1,46182113,46182114,47635499,AT,A,1
NC_037333.1,NC_032655.1,46325195,46325196,47777974,CT,C,1
NC_037333.1,NC_032655.1,46325203,46325204,47777981,TG,T,1
NC_037333.1,NC_032655.1,46325211,46325212,47777988,GC,G,1
NC_037333.1,NC_032655.1,46325249,46325250,47778024,CT,C,1
NC_037333.1,NC_032655.1,46328174,46328175,47780946,CT,C,1
NC_037333.1,NC_032655.1,46331808,46331810,47784914,TTC,T,2
NC_037333.1,NC_032655.1,46685829,46685834,48146015,AGTTGT,A,5
NC_037333.1,NC_032655.1,46734324,46734325,48194508,CA,C,1
NC_037333.1,NC_032655.1,46882578,46882580,48342757,ATT,A,2
NC_037333.1,NC_032655.1,46909127,46909128,48371162,AT,A,1
NC_037333.1,NC_032655.1,46925092,46925098,48386669,TATGAAC,T,6
NC_037333.1,NC_032655.1,46931861,46931862,48393439,TA,T,1
NC_037333.1,NC_032655.1,46932217,46932218,48393794,CA,C,1
NC_037333.1,NC_032655.1,46932233,46932235,48393809,ACG,A,2
NC_037333.1,NC_032655.1,46932247,46932249,48393821,TTG,T,2
NC_037333.1,NC_032655.1,46932257,46932258,48393829,TA,T,1
NC_037333.1,NC_032655.1,46932266,46932268,48393837,TTG,T,2
NC_037333.1,NC_032655.1,46932304,46932305,48393870,GT,G,1
NC_037333.1,NC_032655.1,46975448,46975450,48444253,TTC,T,2
NC_037333.1,NC_032655.1,47015647,47015648,48484538,AT,A,1
NC_037333.1,NC_032655.1,47015653,47015654,48484543,AT,A,1
NC_037333.1,NC_032655.1,47074552,47074563,48570684,TGTTTATATTCC,T,11
NC_037333.1,NC_032655.1,47075320,47075321,48571441,TG,T,1
NC_037333.1,NC_032655.1,47089861,47089865,48586014,GATAA,G,4
NC_037333.1,NC_032655.1,47154734,47154742,48650001,TCTAGTATA,T,8
NC_037333.1,NC_032655.1,47546944,47546950,49067182,TGGACTG,T,6
NC_037333.1,NC_032655.1,47550768,47550769,49070985,AT,A,1
NC_037333.1,NC_032655.1,47558511,47558512,49078730,AG,A,1
NC_037333.1,NC_032655.1,47572454,47572455,49092685,TG,T,1
NC_037333.1,NC_032655.1,47589239,47589242,49109489,TTAC,T,3
NC_037333.1,NC_032655.1,47591041,47591042,49111289,AG,A,1
NC_037333.1,NC_032655.1,47608077,47608079,49128332,CTT,C,2
NC_037333.1,NC_032655.1,47625872,47625874,49146411,GAT,G,2
NC_037333.1,NC_032655.1,47639585,47639586,49160133,CG,C,1
NC_037333.1,NC_032655.1,47657446,47657447,49177994,GT,G,1
NC_037333.1,NC_032655.1,47659339,47659340,49179884,TA,T,1
NC_037333.1,NC_032655.1,47659363,47659364,49179907,AT,A,1
NC_037333.1,NC_032655.1,47659377,47659378,49179920,AT,A,1
NC_037333.1,NC_032655.1,47685736,47685738,49205365,GGA,G,2
NC_037333.1,NC_032655.1,47717843,47717856,49239337,GAAACTATAAATAC,G,13
NC_037333.1,NC_032655.1,47717931,47717933,49239412,TAA,T,2
NC_037333.1,NC_032655.1,47783169,47783170,49304505,TG,T,1
NC_037333.1,NC_032655.1,47798914,47798916,49320293,CTT,C,2
NC_037333.1,NC_032655.1,47800298,47800299,49321676,CT,C,1
NC_037333.1,NC_032655.1,47943112,47943113,49470585,AC,A,1
NC_037333.1,NC_032655.1,47945772,47945784,49473317,GAGTGCTTAACTA,G,12
NC_037333.1,NC_032655.1,48001513,48001514,49529084,AT,A,1
NC_037333.1,NC_032655.1,48010264,48010265,49537838,TA,T,1
NC_037333.1,NC_032655.1,48012633,48012636,49539524,TATC,T,3
NC_037333.1,NC_032655.1,48022989,48022990,49550009,TA,T,1
NC_037333.1,NC_032655.1,48025120,48025121,49552141,AC,A,1
NC_037333.1,NC_032655.1,48027343,48027344,49554364,CA,C,1
NC_037333.1,NC_032655.1,48093302,48093303,49690285,AG,A,1
NC_037333.1,NC_032655.1,48203428,48203429,49722842,AG,A,1
NC_037333.1,NC_032655.1,48295443,48295444,49856087,CG,C,1
NC_037333.1,NC_032655.1,48569883,48569884,50175005,AC,A,1
NC_037333.1,NC_032655.1,48725509,48725510,50329562,TG,T,1
NC_037333.1,NC_032655.1,48752397,48752398,50356456,AG,A,1
NC_037333.1,NC_032655.1,48899792,48899793,50502558,AG,A,1
NC_037333.1,NC_032655.1,49005533,49005534,50616435,CT,C,1
NC_037333.1,NC_032655.1,49073148,49073149,50696391,GC,G,1
NC_037333.1,NC_032655.1,49159274,49159275,50803270,AG,A,1
NC_037333.1,NC_032655.1,49424581,49424585,51070130,GTTAA,G,4
NC_037333.1,NC_032655.1,49450348,49450349,51096310,AT,A,1
NC_037333.1,NC_032655.1,49451709,49451710,51097668,TC,T,1
NC_037333.1,NC_032655.1,49476836,49476837,51116073,CT,C,1
NC_037333.1,NC_032655.1,49637450,49637451,51277527,GA,G,1
NC_037333.1,NC_032655.1,49706554,49706555,51346612,AT,A,1
NC_037333.1,NC_032655.1,49706576,49706578,51346633,CCT,C,2
NC_037333.1,NC_032655.1,49706580,49706581,51346635,CT,C,1
NC_037333.1,NC_032655.1,49761860,49761862,51400940,TTG,T,2
NC_037333.1,NC_032655.1,49761874,49761875,51400952,CT,C,1
NC_037333.1,NC_032655.1,49761882,49761883,51400959,AT,A,1
NC_037333.1,NC_032655.1,49766889,49766893,51405956,GCTAC,G,4
NC_037333.1,NC_032655.1,49767314,49767315,51406385,TC,T,1
NC_037333.1,NC_032655.1,49979310,49979311,51617990,GC,G,1
NC_037333.1,NC_032655.1,50021104,50021105,51659742,CT,C,1
NC_037333.1,NC_032655.1,50047250,50047251,51685926,AC,A,1
NC_037333.1,NC_032655.1,50048320,50048322,51686994,CAA,C,2
NC_037333.1,NC_032655.1,50057161,50057162,51695834,TG,T,1
NC_037333.1,NC_032655.1,50130343,50130353,51770665,TAAATTAAATA,T,10
NC_037333.1,NC_032655.1,50243301,50243302,51883655,CT,C,1
NC_037333.1,NC_032655.1,51059769,51059770,52649919,AG,A,1
NC_037333.1,NC_032655.1,51081171,51081172,52671322,AG,A,1
NC_037333.1,NC_032655.1,51134636,51134637,52724644,TA,T,1
NC_037333.1,NC_032655.1,51178202,51178203,52767672,AT,A,1
NC_037333.1,NC_032655.1,51221199,51221200,52810669,AT,A,1
NC_037333.1,NC_032655.1,51224452,51224453,52813928,TC,T,1
NC_037333.1,NC_032655.1,51529132,51529133,53081000,AG,A,1
NC_037333.1,NC_032655.1,51535739,51535740,53087596,CT,C,1
NC_037333.1,NC_032655.1,51557489,51557491,53109566,ACT,A,2
NC_037333.1,NC_032655.1,51744390,51744391,53414379,AG,A,1
NC_037333.1,NC_032655.1,51778167,51778168,53448164,GT,G,1
NC_037333.1,NC_032655.1,51802328,51802329,53472325,AT,A,1
NC_037333.1,NC_032655.1,51942903,51942904,53632427,GA,G,1
NC_037333.1,NC_032655.1,52028991,52028992,53728682,TC,T,1
NC_037333.1,NC_032655.1,52062088,52062089,53765140,TC,T,1
NC_037333.1,NC_032655.1,52065247,52065249,53768299,TTG,T,2
NC_037333.1,NC_032655.1,52265375,52265376,53969270,TA,T,1
NC_037333.1,NC_032655.1,52275835,52275836,53979729,GC,G,1
NC_037333.1,NC_032655.1,52295470,52295471,53999313,AC,A,1
NC_037333.1,NC_032655.1,52459570,52459571,54226193,AC,A,1
NC_037333.1,NC_032655.1,52459580,52459581,54226202,TC,T,1
NC_037333.1,NC_032655.1,52471841,52471842,54238459,CA,C,1
NC_037333.1,NC_032655.1,52648140,52648142,54411893,AAT,A,2
NC_037333.1,NC_032655.1,52898584,52898585,54665625,TG,T,1
NC_037333.1,NC_032655.1,52919137,52919138,54689566,TC,T,1
NC_037333.1,NC_032655.1,52934081,52934082,54704471,GA,G,1
NC_037333.1,NC_032655.1,52949977,52949978,54720364,AC,A,1
NC_037333.1,NC_032655.1,53329538,53329539,55134530,TG,T,1
NC_037333.1,NC_032655.1,53689520,53689522,55494783,TTA,T,2
NC_037333.1,NC_032655.1,53690680,53690681,55495941,GA,G,1
NC_037333.1,NC_032655.1,53777790,53777795,55588609,TTACTC,T,5
NC_037333.1,NC_032655.1,53884315,53884317,55694729,TAA,T,2
NC_037333.1,NC_032655.1,54239696,54239698,56088081,AAT,A,2
NC_037333.1,NC_032655.1,54430373,54430374,56249585,CA,C,1
NC_037333.1,NC_032655.1,54430373,54430374,56425460,CA,C,1
NC_037333.1,NC_032655.1,54628843,54628844,56626036,TG,T,1
NC_037333.1,NC_032655.1,54980569,54980570,57070026,GA,G,1
NC_037333.1,NC_032655.1,55294123,55294124,57463850,CT,C,1
NC_037333.1,NC_032655.1,55333505,55333506,57503247,AG,A,1
NC_037333.1,NC_032655.1,55333525,55333526,57503266,GC,G,1
NC_037333.1,NC_032655.1,55333534,55333535,57503274,AG,A,1
NC_037333.1,NC_032655.1,55429666,55429667,57608888,TA,T,1
NC_037333.1,NC_032655.1,55583168,55583178,57839308,ATACAGTTCCC,A,10
NC_037333.1,NC_032655.1,55595645,55595646,57851779,TA,T,1
NC_037333.1,NC_032655.1,55595678,55595679,57851810,TA,T,1
NC_037333.1,NC_032655.1,55595724,55595725,57851854,TC,T,1
NC_037333.1,NC_032655.1,55595731,55595732,57851860,AC,A,1
NC_037333.1,NC_032655.1,56285221,56285222,58578267,AT,A,1
NC_037333.1,NC_032655.1,56740239,56740241,59039423,TTG,T,2
NC_037333.1,NC_032655.1,57661128,57661138,60037573,ACTGTGAGTTG,A,10
NC_037333.1,NC_032655.1,58081776,58081777,60467477,CA,C,1
NC_037333.1,NC_032655.1,58115669,58115672,60500234,GCGT,G,3
NC_037333.1,NC_032655.1,59011286,59011287,61468124,GT,G,1
NC_037333.1,NC_032655.1,59011308,59011309,61468145,AT,A,1
NC_037333.1,NC_032655.1,59234489,59234490,61692853,GC,G,1
NC_037333.1,NC_032655.1,59543818,59543819,62007384,CA,C,1
NC_037333.1,NC_032655.1,60045917,60045918,62517391,AT,A,1
NC_037333.1,NC_032655.1,60045922,60045923,62517395,GA,G,1
NC_037333.1,NC_032655.1,60189942,60189943,62661470,CG,C,1
NC_037333.1,NC_032655.1,60383467,60383470,62869436,CCTT,C,3
NC_037333.1,NC_032655.1,60383481,60383482,62869447,TA,T,1
NC_037333.1,NC_032655.1,60383487,60383488,62869452,CA,C,1
NC_037333.1,NC_032655.1,60383501,60383502,62869465,CT,C,1
NC_037333.1,NC_032655.1,60383512,60383513,62869475,CT,C,1
NC_037333.1,NC_032655.1,60383533,60383535,62869495,CCA,C,2
NC_037333.1,NC_032655.1,60431265,60431266,62917256,CA,C,1
NC_037333.1,NC_032655.1,60792991,60792992,63280012,AC,A,1
NC_037333.1,NC_032655.1,60825751,60825753,63519931,CAG,C,2
NC_037333.1,NC_032655.1,60825751,60825753,63312479,CAG,C,2
NC_037333.1,NC_032655.1,60973975,60973977,63434250,AAC,A,2
NC_037333.1,NC_032655.1,60973983,60973984,63434256,AT,A,1
NC_037333.1,NC_032655.1,60974000,60974001,63434272,GT,G,1
NC_037333.1,NC_032655.1,60974022,60974023,63434293,GT,G,1
NC_037333.1,NC_032655.1,60974133,60974135,63434402,AAG,A,2
NC_037333.1,NC_032655.1,61143855,61143856,63792251,TC,T,1
NC_037333.1,NC_032655.1,61143866,61143867,63792261,TC,T,1
NC_037333.1,NC_032655.1,61143873,61143874,63792267,GA,G,1
NC_037333.1,NC_032655.1,61178932,61178933,63842476,AC,A,1
NC_037333.1,NC_032655.1,61178948,61178949,63842491,TA,T,1
NC_037333.1,NC_032655.1,61183689,61183693,63848394,AGTCC,A,4
NC_037333.1,NC_032655.1,61249216,61249225,63914821,TCCCTCTTTG,T,9
NC_037333.1,NC_032655.1,61408075,61408078,63996227,AATC,A,3
NC_037333.1,NC_032655.1,61581276,61581277,64170814,AT,A,1
NC_037333.1,NC_032655.1,61663037,61663038,64251932,AG,A,1
NC_037333.1,NC_032655.1,62256068,62256069,64844451,GT,G,1
NC_037333.1,NC_032655.1,62304023,62304024,64892406,AT,A,1
NC_037333.1,NC_032655.1,62873249,62873250,65736568,GC,G,1
NC_037333.1,NC_032655.1,62915074,62915080,65778436,GCTAAAA,G,6
NC_037333.1,NC_032655.1,62915082,62915083,65778438,CT,C,1
NC_037333.1,NC_032655.1,63439031,63439032,66289309,CT,C,1
NC_037333.1,NC_032655.1,64245003,64245004,66701276,TG,T,1
NC_037333.1,NC_032655.1,64356714,64356715,66812594,GA,G,1
NC_037333.1,NC_032655.1,64388986,64388987,66837102,CA,C,1
NC_037333.1,NC_032655.1,64554388,64554389,67002517,GA,G,1
NC_037333.1,NC_032655.1,64580054,64580055,67028177,AT,A,1
NC_037333.1,NC_032655.1,64583569,64583570,67031692,GA,G,1
NC_037333.1,NC_032655.1,64673256,64673257,67126981,GA,G,1
NC_037333.1,NC_032655.1,65123050,65123051,67582617,GC,G,1
NC_037333.1,NC_032655.1,65420357,65420364,67889631,TACTTAAC,T,7
NC_037333.1,NC_032655.1,65420917,65420928,67890196,AGAGGGGTTGAG,A,11
NC_037333.1,NC_032655.1,65457168,65457169,67925274,GT,G,1
NC_037333.1,NC_032655.1,65491470,65491471,67959664,TA,T,1
NC_037333.1,NC_032655.1,65493856,65493857,67962049,TC,T,1
NC_037333.1,NC_032655.1,65711846,65711848,68215914,TTG,T,2
NC_037333.1,NC_032655.1,65711853,65711854,68215919,CT,C,1
NC_037333.1,NC_032655.1,66216973,66216974,68819520,TA,T,1
NC_037333.1,NC_032655.1,66216977,66216978,68819523,AT,A,1
NC_037333.1,NC_032655.1,66216983,66216984,68819528,TA,T,1
NC_037333.1,NC_032655.1,66983041,66983042,69581464,CA,C,1
NC_037333.1,NC_032655.1,66983052,66983053,69581474,CA,C,1
NC_037333.1,NC_032655.1,67471029,67471030,70830364,AG,A,1
NC_037333.1,NC_032655.1,67978235,67978236,70626837,GT,G,1
NC_037333.1,NC_032655.1,67978278,67978279,70626878,AT,A,1
NC_037333.1,NC_032655.1,67978296,67978297,70626895,GT,G,1
NC_037333.1,NC_032655.1,68044632,68044633,70693230,TA,T,1
NC_037333.1,NC_032655.1,68044639,68044640,70693236,GA,G,1
NC_037333.1,NC_032655.1,68063120,68063121,70711854,AT,A,1
NC_037333.1,NC_032655.1,68063139,68063140,70711872,GT,G,1
NC_037333.1,NC_032655.1,68070660,68070661,70720000,CT,C,1
NC_037333.1,NC_032655.1,68428902,68428903,71139349,AT,A,1
NC_037333.1,NC_032655.1,68439210,68439211,71149654,TG,T,1
NC_037333.1,NC_032655.1,68439214,68439215,71149657,CA,C,1
NC_037333.1,NC_032655.1,68744697,68744698,71456306,CA,C,1
NC_037333.1,NC_032655.1,68874719,68874720,71585861,TG,T,1
NC_037333.1,NC_032655.1,68987157,68987158,71698167,AG,A,1
NC_037333.1,NC_032655.1,70512883,70512884,73174285,GA,G,1
NC_037333.1,NC_032655.1,70512896,70512897,73174297,CT,C,1
NC_037333.1,NC_032655.1,70618595,70618596,73280804,AT,A,1
NC_037333.1,NC_032655.1,70748178,70748180,73410342,AAG,A,2
NC_037333.1,NC_032655.1,70748184,70748185,73410346,AT,A,1
NC_037333.1,NC_032655.1,70803529,70803530,73465358,GA,G,1
NC_037333.1,NC_032655.1,70803544,70803545,73465372,TC,T,1
NC_037333.1,NC_032655.1,70803558,70803560,73465385,TTA,T,2
NC_037333.1,NC_032655.1,70803570,70803571,73465395,GC,G,1
NC_037333.1,NC_032655.1,70895920,70895921,73557990,AT,A,1
NC_037333.1,NC_032655.1,71011883,71011885,73656486,GGA,G,2
NC_037333.1,NC_032655.1,71135726,71135728,73780324,AAC,A,2
NC_037333.1,NC_032655.1,71313598,71313599,73957337,TC,T,1
NC_037333.1,NC_032655.1,71453905,71453906,74097681,CG,C,1
NC_037333.1,NC_032655.1,71498998,71498999,74142803,CT,C,1
NC_037333.1,NC_032655.1,71506994,71506995,74150794,TC,T,1
NC_037333.1,NC_032655.1,71607521,71607522,74251413,AC,A,1
NC_037333.1,NC_032655.1,71637185,71637189,74281044,CGGTG,C,4
NC_037333.1,NC_032655.1,71903480,71903481,74554195,GT,G,1
NC_037333.1,NC_032655.1,71904384,71904402,74555097,TGCATGCTTAATACCACTA,T,18
NC_037333.1,NC_032655.1,71928491,71928495,74579190,AACCC,A,4
NC_037333.1,NC_032655.1,72195862,72195863,74925465,TA,T,1
NC_037333.1,NC_032655.1,72217349,72217350,74946957,TG,T,1
NC_037333.1,NC_032655.1,72294955,72294967,75024639,GGTCATTGAGACA,G,12
NC_037333.1,NC_032655.1,72944582,72944583,75730673,AC,A,1
NC_037333.1,NC_032655.1,73023429,73023430,75808199,AG,A,1
NC_037333.1,NC_032655.1,73602913,73602915,76543792,GGA,G,2
NC_037333.1,NC_032655.1,73602923,73602924,76543800,AG,A,1
NC_037333.1,NC_032655.1,73602941,73602942,76543817,CT,C,1
NC_037333.1,NC_032655.1,73602955,73602956,76543830,TC,T,1
NC_037333.1,NC_032655.1,74189476,74189477,77131177,GT,G,1
NC_037333.1,NC_032655.1,74189484,74189486,77131184,TTA,T,2
NC_037333.1,NC_032655.1,74189489,74189490,77131187,GA,G,1
NC_037333.1,NC_032655.1,74471566,74471567,77422629,AG,A,1
NC_037333.1,NC_032655.1,74471592,74471593,77422655,GT,G,1
NC_037333.1,NC_032655.1,75334382,75334383,78295167,CA,C,1
NC_037333.1,NC_032655.1,75617346,75617347,78621223,AC,A,1
NC_037333.1,NC_032655.1,75617361,75617362,78621237,AT,A,1
NC_037333.1,NC_032655.1,75910302,75910303,78908931,GT,G,1
NC_037333.1,NC_032655.1,75910310,75910311,78908938,AG,A,1
NC_037333.1,NC_032655.1,76554276,76554277,79646133,GT,G,1
NC_037333.1,NC_032655.1,76554347,76554348,79646202,CT,C,1
NC_037333.1,NC_032655.1,76839654,76839655,79930823,AT,A,1
NC_037333.1,NC_032655.1,77253542,77253543,80367762,TA,T,1
NC_037333.1,NC_032655.1,77792144,77792145,80904313,GA,G,1
NC_037333.1,NC_032655.1,77818809,77818810,80919791,GT,G,1
NC_037333.1,NC_032655.1,77822208,77822209,80934615,TA,T,1
NC_037333.1,NC_032655.1,77837377,77837378,80949785,TG,T,1
NC_037333.1,NC_032655.1,77853572,77853573,80965977,TC,T,1
NC_037333.1,NC_032655.1,78438807,78438808,81685248,GA,G,1
NC_037333.1,NC_032655.1,78580448,78580449,81859238,GC,G,1
NC_037333.1,NC_032655.1,78589410,78589411,81868580,GT,G,1
NC_037333.1,NC_032655.1,78591053,78591054,81870226,CT,C,1
NC_037333.1,NC_032655.1,78618376,78618377,81896946,GC,G,1
NC_037333.1,NC_032655.1,78631759,78631765,81911884,CTTGATT,C,6
NC_037333.1,NC_032655.1,78703177,78703178,81983332,CT,C,1
NC_037333.1,NC_032655.1,78745077,78745085,82027072,TCAGGAAAC,T,8
NC_037333.1,NC_032655.1,78746565,78746576,82028546,TAGAAATGATAA,T,11
NC_037333.1,NC_032655.1,78919894,78919895,82267057,AG,A,1
NC_037333.1,NC_032655.1,78919964,78919965,82267122,TA,T,1
NC_037333.1,NC_032655.1,78984885,78984889,82333116,ACTCT,A,4
NC_037333.1,NC_032655.1,79001026,79001027,82349272,AT,A,1
NC_037333.1,NC_032655.1,79133519,79133520,82490954,CT,C,1
NC_037333.1,NC_032655.1,79214458,79214462,82582212,GTTCA,G,4
NC_037333.1,NC_032655.1,79223094,79223095,82590917,GA,G,1
NC_037333.1,NC_032655.1,79310091,79310093,82677364,GGT,G,2
NC_037333.1,NC_032655.1,79368634,79368635,82735368,CA,C,1
NC_037333.1,NC_032655.1,79492499,79492501,82858536,TAA,T,2
NC_037333.1,NC_032655.1,79499920,79499921,82864874,AC,A,1
NC_037333.1,NC_032655.1,80669090,80669091,84085340,AT,A,1
NC_037333.1,NC_032655.1,81683099,81683101,85156883,TTA,T,2
NC_037333.1,NC_032655.1,81683139,81683140,85156920,AC,A,1
NC_037333.1,NC_032655.1,81781382,81781384,85255235,TTA,T,2
NC_037333.1,NC_032655.1,82585200,82585202,85331528,AGG,A,2
NC_037333.1,NC_032655.1,82828377,82828378,85584813,TA,T,1
NC_037333.1,NC_032655.1,82973175,82973176,85730017,GT,G,1
NC_037333.1,NC_032655.1,83211470,83211477,85968447,ATAATGCT,A,7
NC_037333.1,NC_032655.1,83211479,83211480,85968449,TA,T,1
NC_037333.1,NC_032655.1,85561177,85561178,88525160,CT,C,1
NC_037333.1,NC_032655.1,85958340,85958341,88778852,TA,T,1
NC_037333.1,NC_032655.1,86196444,86196445,89160285,AC,A,1
NC_037333.1,NC_032655.1,86913281,86913283,89913531,GGA,G,2
NC_037333.1,NC_032655.1,86919066,86919067,89919310,AT,A,1
NC_037333.1,NC_032655.1,87020942,87020958,90021257,GTGTATCTGTGAACATA,G,16
NC_037333.1,NC_032655.1,87090474,87090476,90093427,TTC,T,2
NC_037333.1,NC_032655.1,87142163,87142164,90146256,AG,A,1
NC_037333.1,NC_032655.1,87146694,87146696,90150819,CTT,C,2
NC_037333.1,NC_032655.1,87147024,87147026,90151146,ATT,A,2
NC_037333.1,NC_032655.1,87152956,87152957,90157074,TA,T,1
NC_037333.1,NC_032655.1,87332064,87332074,90335603,GCTTTACTTTA,G,10
NC_037333.1,NC_032655.1,87472309,87472310,90476199,TA,T,1
NC_037333.1,NC_032655.1,87934573,87934575,90984957,TAA,T,2
NC_037333.1,NC_032655.1,88358232,88358233,91419706,TG,T,1
NC_037333.1,NC_032655.1,88358244,88358245,91419717,GT,G,1
NC_037333.1,NC_032655.1,88919112,88919113,91985600,CG,C,1
NC_037333.1,NC_032655.1,88936315,88936316,92002994,TG,T,1
NC_037333.1,NC_032655.1,89141735,89141736,92225605,GA,G,1
NC_037333.1,NC_032655.1,89303852,89303853,92387173,GC,G,1
NC_037333.1,NC_032655.1,89393612,89393613,92554776,GA,G,1
NC_037333.1,NC_032655.1,89414303,89414304,92584765,AT,A,1
NC_037333.1,NC_032655.1,89418140,89418141,92588624,GT,G,1
NC_037333.1,NC_032655.1,89418144,89418145,92588627,AC,A,1
NC_037333.1,NC_032655.1,89559966,89559967,92726105,AG,A,1
NC_037333.1,NC_032655.1,89675520,89675521,92864240,GC,G,1
NC_037333.1,NC_032655.1,89675534,89675535,92864253,GC,G,1
NC_037333.1,NC_032655.1,89679824,89679826,92868544,AAG,A,2
NC_037333.1,NC_032655.1,89679838,89679839,92868556,GA,G,1
NC_037333.1,NC_032655.1,89679868,89679869,92868584,CA,C,1
NC_037333.1,NC_032655.1,89716669,89716670,92905481,AG,A,1
NC_037333.1,NC_032655.1,89716678,89716679,92905489,AT,A,1
NC_037333.1,NC_032655.1,89716692,89716693,92905502,AT,A,1
NC_037333.1,NC_032655.1,89764099,89764100,92967137,CT,C,1
NC_037333.1,NC_032655.1,89764345,89764346,92967382,CA,C,1
NC_037333.1,NC_032655.1,89766851,89766852,92970113,GT,G,1
NC_037333.1,NC_032655.1,89924146,89924147,93130036,CT,C,1
NC_037333.1,NC_032655.1,89924154,89924155,93130043,AT,A,1
NC_037333.1,NC_032655.1,89924182,89924183,93130070,TG,T,1
NC_037333.1,NC_032655.1,89924229,89924230,93130115,AT,A,1
NC_037333.1,NC_032655.1,90231682,90231684,93519698,AAG,A,2
NC_037333.1,NC_032655.1,90231712,90231713,93519725,AT,A,1
NC_037333.1,NC_032655.1,90317955,90317956,93631921,AG,A,1
NC_037333.1,NC_032655.1,90319206,90319207,93633172,GT,G,1
NC_037333.1,NC_032655.1,90319226,90319227,93633191,AG,A,1
NC_037333.1,NC_032655.1,90319262,90319263,93633225,GA,G,1
NC_037333.1,NC_032655.1,90323344,90323345,93637438,AG,A,1
NC_037333.1,NC_032655.1,90604552,90604553,93914030,GT,G,1
NC_037333.1,NC_032655.1,90604560,90604562,93914037,AGT,A,2
NC_037333.1,NC_032655.1,90604574,90604575,93914049,AG,A,1
NC_037333.1,NC_032655.1,90604690,90604691,93914164,GA,G,1
NC_037333.1,NC_032655.1,90607895,90607896,93917358,CA,C,1
NC_037333.1,NC_032655.1,90628510,90628511,93937980,GC,G,1
NC_037333.1,NC_032655.1,90725909,90725911,94044000,CAT,C,2
NC_037333.1,NC_032655.1,90809418,90809419,94135095,TG,T,1
NC_037333.1,NC_032655.1,90834524,90834525,94165366,TA,T,1
NC_037333.1,NC_032655.1,90834899,90834900,94165739,GT,G,1
NC_037333.1,NC_032655.1,90834913,90834914,94165752,AT,A,1
NC_037333.1,NC_032655.1,90834925,90834926,94165763,GT,G,1
NC_037333.1,NC_032655.1,90834945,90834946,94165782,GT,G,1
NC_037333.1,NC_032655.1,91066225,91066226,94362035,AG,A,1
NC_037333.1,NC_032655.1,91067907,91067915,94363824,TTATGCTAA,T,8
NC_037333.1,NC_032655.1,91249123,91249124,94545068,TG,T,1
NC_037333.1,NC_032655.1,91298597,91298598,94596831,CT,C,1
NC_037333.1,NC_032655.1,91309296,91309297,94607531,AC,A,1
NC_037333.1,NC_032655.1,91317259,91317272,94615495,ACTATTTTACTACT,A,13
NC_037333.1,NC_032655.1,91322931,91322932,94621157,GC,G,1
NC_037333.1,NC_032655.1,91326196,91326197,94624425,GC,G,1
NC_037333.1,NC_032655.1,91426601,91426603,94727326,CAG,C,2
NC_037333.1,NC_032655.1,91516245,91516247,94818551,CCT,C,2
NC_037333.1,NC_032655.1,91524058,91524059,94826324,CA,C,1
NC_037333.1,NC_032655.1,91545541,91545542,94873761,CA,C,1
NC_037333.1,NC_032655.1,91689256,91689257,95017562,CG,C,1
NC_037333.1,NC_032655.1,91985422,91985423,95315914,AT,A,1
NC_037333.1,NC_032655.1,92079013,92079014,95484722,CA,C,1
NC_037333.1,NC_032655.1,92080349,92080350,95486058,TC,T,1
NC_037333.1,NC_032655.1,92265768,92265769,95713279,AG,A,1
NC_037333.1,NC_032655.1,92346732,92346733,95792765,AG,A,1
NC_037333.1,NC_032655.1,92439507,92439508,95895588,AT,A,1
NC_037333.1,NC_032655.1,92493566,92493569,95951847,TCTA,T,3
NC_037333.1,NC_032655.1,92526932,92526940,95994856,CCCCGCGAG,C,8
NC_037333.1,NC_032655.1,92528498,92528500,95996416,AGG,A,2
NC_037333.1,NC_032655.1,92571181,92571182,96039150,TG,T,1
NC_037333.1,NC_032655.1,92892010,92892011,96365920,CA,C,1
NC_037333.1,NC_032655.1,92893019,92893020,96366928,AC,A,1
NC_037333.1,NC_032655.1,92896060,92896061,96369970,TG,T,1
NC_037333.1,NC_032655.1,93108471,93108495,96600800,GCTCCCCTCACTGCTCCCTGGTCCA,G,24
NC_037333.1,NC_032655.1,93178544,93178546,96671009,TTG,T,2
NC_037333.1,NC_032655.1,93292167,93292169,96785770,CTG,C,2
NC_037333.1,NC_032655.1,93570524,93570526,97064719,CTT,C,2
NC_037333.1,NC_032655.1,93918222,93918223,97413487,CT,C,1
NC_037333.1,NC_032655.1,93918256,93918257,97413519,TA,T,1
NC_037333.1,NC_032655.1,94239448,94239449,97747282,AG,A,1
NC_037333.1,NC_032655.1,94255546,94255549,97763341,TCTA,T,3
NC_037333.1,NC_032655.1,94256772,94256773,97764565,AT,A,1
NC_037333.1,NC_032655.1,94290634,94290635,97798356,AT,A,1
NC_037333.1,NC_032655.1,94292631,94292635,97800357,CACCA,C,4
NC_037333.1,NC_032655.1,95214355,95214356,98657576,GA,G,1
NC_037333.1,NC_032655.1,95537648,95537649,98982224,TA,T,1
NC_037333.1,NC_032655.1,95537753,95537754,98982324,GT,G,1
NC_037333.1,NC_032655.1,95537795,95537796,98982364,GA,G,1
NC_037333.1,NC_032655.1,95537802,95537804,98982370,AAC,A,2
NC_037333.1,NC_032655.1,95537816,95537817,98982382,AT,A,1
NC_037333.1,NC_032655.1,95537823,95537824,98982388,CT,C,1
NC_037333.1,NC_032655.1,95614480,95614481,99064696,AT,A,1
NC_037333.1,NC_032655.1,95766965,95766966,99255772,AC,A,1
NC_037333.1,NC_032655.1,95858611,95858612,99346270,AC,A,1
NC_037333.1,NC_032655.1,96221054,96221055,99735162,GT,G,1
NC_037333.1,NC_032655.1,96315043,96315044,99829248,AC,A,1
NC_037333.1,NC_032655.1,96339123,96339124,99853330,TA,T,1
NC_037333.1,NC_032655.1,96424273,96424277,100075585,AGGCT,A,4
NC_037333.1,NC_032655.1,96525870,96525872,100177527,CAT,C,2
NC_037333.1,NC_032655.1,96691245,96691246,100275137,GC,G,1
NC_037333.1,NC_032655.1,96734157,96734158,100487826,AT,A,1
NC_037333.1,NC_032655.1,96734163,96734164,100487831,AG,A,1
NC_037333.1,NC_032655.1,96752034,96752035,100505132,TC,T,1
NC_037333.1,NC_032655.1,96873837,96873838,100625772,CT,C,1
NC_037333.1,NC_032655.1,97062001,97062005,100815449,CGCTT,C,4
NC_037333.1,NC_032655.1,97351431,97351432,101104670,GA,G,1
NC_037333.1,NC_032655.1,97376773,97376774,101144132,GC,G,1
NC_037333.1,NC_032655.1,97425289,97425290,101192202,TA,T,1
NC_037333.1,NC_032655.1,97425296,97425297,101192208,TA,T,1
NC_037333.1,NC_032655.1,97444558,97444559,101304103,AT,A,1
NC_037333.1,NC_032655.1,97461811,97461812,101320431,CA,C,1
NC_037333.1,NC_032655.1,97527649,97527650,101386332,GC,G,1
NC_037333.1,NC_032655.1,97600379,97600380,101457811,TA,T,1
NC_037333.1,NC_032655.1,98040561,98040562,101909262,TC,T,1
NC_037333.1,NC_032655.1,98040571,98040572,101909271,GT,G,1
NC_037333.1,NC_032655.1,98040575,98040576,101909274,TA,T,1
NC_037333.1,NC_032655.1,98137082,98137083,102006446,CT,C,1
NC_037333.1,NC_032655.1,98211908,98211909,102084275,GC,G,1
NC_037333.1,NC_032655.1,98237335,98237381,102109564,CCCTGCCTACTACCATGGCATCCTCTGGCCCGTAAAATGTGAGTGGA,C,46
NC_037333.1,NC_032655.1,98308469,98308470,102284622,TG,T,1
NC_037333.1,NC_032655.1,98400466,98400469,102376757,GAAA,G,3
NC_037333.1,NC_032655.1,98482945,98482946,102459327,TG,T,1
NC_037333.1,NC_032655.1,98497643,98497644,102473526,CT,C,1
NC_037333.1,NC_032655.1,98624165,98624166,102706044,CG,C,1
NC_037333.1,NC_032655.1,99094904,99094905,103166372,GT,G,1
NC_037333.1,NC_032655.1,99439964,99439968,103514642,GCCTC,G,4
NC_037333.1,NC_032655.1,99442609,99442610,103517289,CA,C,1
NC_037333.1,NC_032655.1,99667610,99667611,103726998,AC,A,1
NC_037333.1,NC_032655.1,99697272,99697273,103756654,AG,A,1
NC_037333.1,NC_032655.1,99868702,99868703,103928599,CT,C,1
NC_037333.1,NC_032655.1,100187539,100187541,104295108,GGA,G,2
NC_037333.1,NC_032655.1,100188940,100188941,104301707,TA,T,1
NC_037333.1,NC_032655.1,100472866,100472867,104585607,TG,T,1
NC_037333.1,NC_032655.1,100513187,100513188,104625952,AC,A,1
NC_037333.1,NC_032655.1,100918298,100918299,105030988,AG,A,1
NC_037333.1,NC_032655.1,100927493,100927494,105040203,TC,T,1
NC_037333.1,NC_032655.1,101448394,101448395,105589074,CG,C,1
NC_037333.1,NC_032655.1,101449690,101449696,105590402,TTCTCAG,T,6
NC_037333.1,NC_032655.1,101617937,101617938,105761264,CT,C,1
NC_037333.1,NC_032655.1,101617941,101617942,105761267,TA,T,1
NC_037333.1,NC_032655.1,101637497,101637498,105780811,AG,A,1
NC_037333.1,NC_032655.1,101793153,101793154,105982088,TG,T,1
NC_037333.1,NC_032655.1,101925749,101925750,106083168,AG,A,1
NC_037333.1,NC_032655.1,102024231,102024232,106181675,CT,C,1
NC_037333.1,NC_032655.1,102143544,102143545,106299812,AG,A,1
NC_037333.1,NC_032655.1,102165247,102165248,106321528,AT,A,1
NC_037333.1,NC_032655.1,102199753,102199777,106356362,CAATTGTCATAGGAATTTCTCATGT,C,24
NC_037333.1,NC_032655.1,102199841,102199864,106356426,ACTCATGTAATTTCTTACTAATTT,A,23
NC_037333.1,NC_032655.1,102649919,102649920,106837106,CA,C,1
NC_037333.1,NC_032655.1,102650016,102650017,106837198,TA,T,1
NC_037333.1,NC_032655.1,102674753,102674754,106861966,GT,G,1
NC_037333.1,NC_032655.1,102724338,102724339,106910983,AG,A,1
NC_037333.1,NC_032655.1,102947741,102947759,107149510,GGAGGATTTGACTCTTCTT,G,18
NC_037333.1,NC_032655.1,103029459,103029460,107237343,CA,C,1
NC_037333.1,NC_032655.1,103138346,103138347,107346286,AG,A,1
NC_037333.1,NC_032655.1,103223199,103223202,107480896,GCTT,G,3
NC_037333.1,NC_032655.1,103224857,103224858,107482551,AG,A,1
NC_037333.1,NC_032655.1,103242985,103242986,107500680,CA,C,1
NC_037333.1,NC_032655.1,103243249,103243250,107500943,AG,A,1
NC_037333.1,NC_032655.1,103268830,103268831,107526521,TC,T,1
NC_037333.1,NC_032655.1,103297497,103297498,107555237,TC,T,1
NC_037333.1,NC_032655.1,103309206,103309207,107566945,CA,C,1
NC_037333.1,NC_032655.1,103328632,103328633,107586142,GA,G,1
NC_037333.1,NC_032655.1,103338556,103338558,107596077,TTA,T,2
NC_037333.1,NC_032655.1,103339385,103339386,107596907,TG,T,1
NC_037333.1,NC_032655.1,103403192,103403193,107661110,GA,G,1
NC_037333.1,NC_032655.1,103486871,103486872,107744879,TC,T,1
NC_037333.1,NC_032655.1,103554200,103554201,107994867,GA,G,1
NC_037333.1,NC_032655.1,103556745,103556746,107997412,CA,C,1
NC_037333.1,NC_032655.1,104771253,104771254,109394855,TA,T,1
NC_037333.1,NC_032655.1,104813230,104813231,109436855,TA,T,1
NC_037333.1,NC_032655.1,105132540,105132541,109586597,TG,T,1
NC_037333.1,NC_032655.1,105142309,105142313,109596125,CAGAG,C,4
NC_037333.1,NC_032655.1,105230037,105230038,109700697,GC,G,1
NC_037333.1,NC_032655.1,105242992,105242993,109714107,GC,G,1
NC_037333.1,NC_032655.1,105446133,105446134,109928874,TG,T,1
NC_037333.1,NC_032655.1,105606632,105606634,110095315,CCT,C,2
NC_037333.1,NC_032655.1,105612337,105612338,110100703,AT,A,1
NC_037333.1,NC_032655.1,105807559,105807564,110340908,TAGTTA,T,5
NC_037333.1,NC_032655.1,105810226,105810227,110343570,GA,G,1
NC_037333.1,NC_032655.1,105882354,105882355,110414536,TA,T,1
NC_037333.1,NC_032655.1,106027600,106027601,110585848,AC,A,1
NC_037333.1,NC_032655.1,106370180,106370181,110929310,GC,G,1
NC_037333.1,NC_032655.1,106757042,106757047,111315081,TAAACC,T,5
NC_037333.1,NC_032655.1,106786601,106786642,111344689,CTACAAGTCAAGGATTAGAGGGAGAGATCTGGGCTAGCTGTA,C,41
NC_037333.1,NC_032655.1,106818283,106818284,111376373,AG,A,1
NC_037333.1,NC_032655.1,106843601,106843602,111465164,AG,A,1
NC_037333.1,NC_032655.1,106862627,106862628,111483890,TC,T,1
NC_037333.1,NC_032655.1,107322741,107322742,111945419,GT,G,1
NC_037333.1,NC_032655.1,107322747,107322748,111945424,GA,G,1
NC_037333.1,NC_032655.1,107352834,107352835,111975513,CG,C,1
NC_037333.1,NC_032655.1,107434176,107434177,112056895,CA,C,1
NC_037333.1,NC_032655.1,107454701,107454703,112084232,TAA,T,2
NC_037333.1,NC_032655.1,107497980,107497981,112127521,AC,A,1
NC_037333.1,NC_032655.1,107543644,107543646,112173203,ATT,A,2
NC_037333.1,NC_032655.1,107926466,107926467,112580539,TA,T,1
NC_037333.1,NC_032655.1,108025055,108025056,112679980,CT,C,1
NC_037333.1,NC_032655.1,108241369,108241370,112891104,AT,A,1
NC_037333.1,NC_032655.1,108596328,108596329,113310466,TA,T,1
NC_037333.1,NC_032655.1,108609261,108609262,113323402,CT,C,1
NC_037333.1,NC_032655.1,108609285,108609286,113323424,CA,C,1
NC_037333.1,NC_032655.1,109018844,109018845,113734784,CG,C,1
NC_037333.1,NC_032655.1,109029936,109029937,113745876,TG,T,1
NC_037333.1,NC_032655.1,109110885,109110886,113827027,TA,T,1
NC_037333.1,NC_032655.1,109153201,109153202,113869674,GT,G,1
NC_037333.1,NC_032655.1,109218704,109218706,113935262,AGT,A,2
NC_037333.1,NC_032655.1,109258778,109258779,113977445,AC,A,1
NC_037333.1,NC_032655.1,109262166,109262175,113980836,CTGGCCTCAA,C,9
NC_037333.1,NC_032655.1,109262977,109263000,113981641,ATACTTCTCTCGGGTTGAAGACTG,A,23
NC_037333.1,NC_032655.1,109279758,109279759,113998400,AC,A,1
NC_037333.1,NC_032655.1,109279783,109279784,113998424,AG,A,1
NC_037333.1,NC_032655.1,109279823,109279824,113998463,AG,A,1
NC_037333.1,NC_032655.1,109283456,109283457,114002095,TA,T,1
NC_037333.1,NC_032655.1,109407627,109407628,114138242,CT,C,1
NC_037333.1,NC_032655.1,109409801,109409802,114140414,AC,A,1
NC_037333.1,NC_032655.1,109409804,109409805,114140416,GC,G,1
NC_037333.1,NC_032655.1,109502775,109502776,114233432,AG,A,1
NC_037333.1,NC_032655.1,109502795,109502796,114233451,AC,A,1
NC_037333.1,NC_032655.1,109708049,109708050,114439053,GT,G,1
NC_037333.1,NC_032655.1,109842824,109842825,114570141,GT,G,1
NC_037333.1,NC_032655.1,110250545,110250546,114964087,GT,G,1
NC_037333.1,NC_032655.1,110263942,110263943,114977505,GT,G,1
NC_037333.1,NC_032655.1,110278796,110278797,114992362,AC,A,1
NC_037333.1,NC_032655.1,110449481,110449482,115154900,AG,A,1
NC_037333.1,NC_032655.1,110449546,110449548,115154965,AAT,A,2
NC_037333.1,NC_032655.1,110449951,110449952,115155368,GA,G,1
NC_037333.1,NC_032655.1,110613728,110613729,115318834,GA,G,1
NC_037333.1,NC_032655.1,110624523,110624524,115329299,AG,A,1
NC_037333.1,NC_032655.1,110645636,110645637,115350410,CT,C,1
NC_037333.1,NC_032655.1,110651928,110651929,115356703,GT,G,1
NC_037333.1,NC_032655.1,110806738,110806739,115505371,TC,T,1
NC_037333.1,NC_032655.1,110851061,110851062,115549798,AC,A,1
NC_037333.1,NC_032655.1,110987378,110987379,115688274,GT,G,1
NC_037333.1,NC_032655.1,111165421,111165422,115867298,AG,A,1
NC_037333.1,NC_032655.1,111165472,111165473,115867347,AG,A,1
NC_037333.1,NC_032655.1,111173133,111173134,115875011,CG,C,1
NC_037333.1,NC_032655.1,111174653,111174656,115876534,TCAC,T,3
NC_037333.1,NC_032655.1,111198239,111198240,115900120,AG,A,1
NC_037333.1,NC_032655.1,111211388,111211389,115913272,TG,T,1
NC_037333.1,NC_032655.1,111224089,111224090,115925988,TG,T,1
NC_037333.1,NC_032655.1,111226040,111226041,115927942,TA,T,1
NC_037333.1,NC_032655.1,111532884,111532885,116235851,AG,A,1
NC_037333.1,NC_032655.1,111615823,111615824,116319189,AC,A,1
NC_037333.1,NC_032655.1,111752845,111752850,116456135,CCATTA,C,5
NC_037333.1,NC_032655.1,111753985,111753986,116457270,AC,A,1
NC_037333.1,NC_032655.1,111759755,111759756,116463040,AG,A,1
NC_037333.1,NC_032655.1,111842783,111842784,116545987,CG,C,1
NC_037333.1,NC_032655.1,111849239,111849240,116552496,CT,C,1
NC_037333.1,NC_032655.1,111944632,111944648,116645886,AGGGTGGTGCTATAGAC,A,16
NC_037333.1,NC_032655.1,111991705,111991706,116692966,TG,T,1
NC_037333.1,NC_032655.1,112068050,112068051,116833841,TC,T,1
NC_037333.1,NC_032655.1,112068064,112068065,116833854,GC,G,1
NC_037333.1,NC_032655.1,112530487,112530488,117133033,AC,A,1
NC_037333.1,NC_032655.1,112605946,112605947,117209717,CT,C,1
NC_037333.1,NC_032655.1,112729906,112729907,117369537,CT,C,1
NC_037333.1,NC_032655.1,112730936,112730937,117370564,AG,A,1
NC_037333.1,NC_032655.1,112730942,112730943,117370569,GA,G,1
NC_037333.1,NC_032655.1,112731590,112731591,117371217,GA,G,1
NC_037333.1,NC_032655.1,112892105,112892106,117585863,CT,C,1
NC_037333.1,NC_032655.1,113208590,113208591,121364303,AT,A,1
NC_037333.1,NC_032655.1,113349119,113349120,121506849,TC,T,1
NC_037333.1,NC_032655.1,113370610,113370612,121528065,CCG,C,2
NC_037333.1,NC_032655.1,113370632,113370633,121528085,GC,G,1
NC_037333.1,NC_032655.1,113442592,113442593,121608940,GT,G,1
NC_037333.1,NC_032655.1,113556769,113556770,121710915,CA,C,1
NC_037333.1,NC_032655.1,113571738,113571747,121726451,AGGCTTCGCC,A,9
NC_037333.1,NC_032655.1,113604599,113604600,121759131,CT,C,1
NC_037333.1,NC_032655.1,113605989,113605991,121760520,GAT,G,2
NC_037333.1,NC_032655.1,113605997,113605998,121760526,GA,G,1
NC_037333.1,NC_032655.1,113606564,113606565,121761092,CT,C,1
NC_037333.1,NC_032655.1,113669479,113669480,121823596,TG,T,1
NC_037333.1,NC_032655.1,113669829,113669830,121823944,TA,T,1
NC_037333.1,NC_032655.1,113683426,113683427,121837541,GT,G,1
NC_037333.1,NC_032655.1,113695392,113695400,121849585,GGCGGTATT,G,8
NC_037333.1,NC_032655.1,113696122,113696124,121850307,CTG,C,2
NC_037333.1,NC_032655.1,113745609,113745610,121899796,TA,T,1
NC_037333.1,NC_032655.1,113797427,113797428,121951406,CA,C,1
NC_037333.1,NC_032655.1,113841933,113841937,121995933,GAGGC,G,4
NC_037333.1,NC_032655.1,113841950,113841965,121995946,GGGAATGCCTGGGCGA,G,15
NC_037333.1,NC_032655.1,113930392,113930394,122155300,AAG,A,2
NC_037333.1,NC_032655.1,114033808,114033810,122261767,CCT,C,2
NC_037333.1,NC_032655.1,114038434,114038435,122266336,GT,G,1
NC_037333.1,NC_032655.1,114038445,114038446,122266346,GT,G,1
NC_037333.1,NC_032655.1,114038468,114038469,122266368,TG,T,1
NC_037333.1,NC_032655.1,114171122,114171123,122395137,CA,C,1
NC_037333.1,NC_032655.1,114298089,114298090,122522411,CG,C,1
NC_037333.1,NC_032655.1,114404826,114404827,122627581,TG,T,1
NC_037333.1,NC_032655.1,114404855,114404857,122627609,TTA,T,2
NC_037333.1,NC_032655.1,114404865,114404866,122627617,TG,T,1
