Reference ID,Query ID,Reference POS,Reference END,Query POS,REF,ALT,SVLEN
NC_037335.1,NC_032657.1,783613,783614,495338,CA,C,1
NC_037335.1,NC_032657.1,1134130,1134131,842771,AC,A,1
NC_037335.1,NC_032657.1,1134176,1134177,842816,AG,A,1
NC_037335.1,NC_032657.1,1277294,1277296,1000089,CCT,C,2
NC_037335.1,NC_032657.1,1277304,1277305,1000097,TG,T,1
NC_037335.1,NC_032657.1,1277320,1277321,1000112,CT,C,1
NC_037335.1,NC_032657.1,1277362,1277363,1000153,AC,A,1
NC_037335.1,NC_032657.1,1327314,1327316,1064172,CCA,C,2
NC_037335.1,NC_032657.1,1426420,1426421,1163515,GA,G,1
NC_037335.1,NC_032657.1,1426492,1426494,1163585,AAG,A,2
NC_037335.1,NC_032657.1,1426509,1426510,1163600,AT,A,1
NC_037335.1,NC_032657.1,1604893,1604895,1361947,GGC,G,2
NC_037335.1,NC_032657.1,1604906,1604907,1361958,GT,G,1
NC_037335.1,NC_032657.1,1625780,1625781,1382882,GT,G,1
NC_037335.1,NC_032657.1,1864273,1864274,1613352,AT,A,1
NC_037335.1,NC_032657.1,1938396,1938416,1687704,CAGAATAGATGTTCTAAATGT,C,20
NC_037335.1,NC_032657.1,2433782,2433785,2147843,GAAT,G,3
NC_037335.1,NC_032657.1,2862346,2862365,2578874,AAATAACTAATTCCAGAACT,A,19
NC_037335.1,NC_032657.1,3324149,3324151,3088936,AAT,A,2
NC_037335.1,NC_032657.1,3794032,3794033,3567147,GT,G,1
NC_037335.1,NC_032657.1,3794370,3794371,3567485,AT,A,1
NC_037335.1,NC_032657.1,3908299,3908300,3682757,GC,G,1
NC_037335.1,NC_032657.1,4135614,4135615,3910365,TC,T,1
NC_037335.1,NC_032657.1,4499138,4499139,4250857,CA,C,1
NC_037335.1,NC_032657.1,4575241,4575242,4329243,CA,C,1
NC_037335.1,NC_032657.1,4789819,4789820,4637087,AC,A,1
NC_037335.1,NC_032657.1,4797469,4797470,4644740,GT,G,1
NC_037335.1,NC_032657.1,4823201,4823204,4670461,TAAA,T,3
NC_037335.1,NC_032657.1,5217786,5217787,5080368,CT,C,1
NC_037335.1,NC_032657.1,5240193,5240194,5102760,GT,G,1
NC_037335.1,NC_032657.1,5282984,5282985,5145607,GA,G,1
NC_037335.1,NC_032657.1,5515847,5515848,5379412,AT,A,1
NC_037335.1,NC_032657.1,5746971,5746972,5610582,CT,C,1
NC_037335.1,NC_032657.1,6105688,6105698,6005383,TCTTCCAATCA,T,10
NC_037335.1,NC_032657.1,6189792,6189794,6088900,ACC,A,2
NC_037335.1,NC_032657.1,6204075,6204076,6103178,GC,G,1
NC_037335.1,NC_032657.1,6536491,6536492,6476554,TA,T,1
NC_037335.1,NC_032657.1,6618610,6618611,6559399,GC,G,1
NC_037335.1,NC_032657.1,6639224,6639225,6580010,AT,A,1
NC_037335.1,NC_032657.1,6639253,6639254,6580039,GT,G,1
NC_037335.1,NC_032657.1,6639338,6639339,6580123,AC,A,1
NC_037335.1,NC_032657.1,6643938,6643939,6584672,AC,A,1
NC_037335.1,NC_032657.1,7123982,7123983,7074017,TG,T,1
NC_037335.1,NC_032657.1,7151468,7151529,7101529,CGCATTGCCTTTATTAGCTTAACTGAGTGGGAACTGGTCTCTTCTCCACTGGATTCTTACAG,C,61
NC_037335.1,NC_032657.1,7282998,7282999,7207947,TA,T,1
NC_037335.1,NC_032657.1,7329008,7329011,7212232,GAAT,G,3
NC_037335.1,NC_032657.1,7340867,7340868,7225675,TA,T,1
NC_037335.1,NC_032657.1,7604426,7604427,7483505,AC,A,1
NC_037335.1,NC_032657.1,7963316,7963317,7842665,CG,C,1
NC_037335.1,NC_032657.1,7977335,7977337,7856609,TTG,T,2
NC_037335.1,NC_032657.1,8344449,8344450,8226618,TA,T,1
NC_037335.1,NC_032657.1,8506650,8506653,8389144,GTGA,G,3
NC_037335.1,NC_032657.1,8703250,8703251,8591728,GT,G,1
NC_037335.1,NC_032657.1,8711004,8711023,8599474,AAGGACTAACATCTAGGCAG,A,19
NC_037335.1,NC_032657.1,9342327,9342332,9399532,CCTGCT,C,5
NC_037335.1,NC_032657.1,9384395,9384396,9448098,TA,T,1
NC_037335.1,NC_032657.1,9400152,9400153,9463582,CG,C,1
NC_037335.1,NC_032657.1,9406458,9406459,9469866,TG,T,1
NC_037335.1,NC_032657.1,9528181,9528182,9591090,AG,A,1
NC_037335.1,NC_032657.1,9591022,9591023,9653932,AC,A,1
NC_037335.1,NC_032657.1,9734946,9734947,9797705,CA,C,1
NC_037335.1,NC_032657.1,9750170,9750171,9812938,AG,A,1
NC_037335.1,NC_032657.1,9774629,9774630,9837549,GA,G,1
NC_037335.1,NC_032657.1,9782713,9782726,9845627,ATAAATCACATATC,A,13
NC_037335.1,NC_032657.1,10291034,10291035,10352544,AT,A,1
NC_037335.1,NC_032657.1,10293656,10293657,10355161,AT,A,1
NC_037335.1,NC_032657.1,10294112,10294114,10355626,CTT,C,2
NC_037335.1,NC_032657.1,10294805,10294806,10356304,CT,C,1
NC_037335.1,NC_032657.1,10296913,10296914,10358399,GA,G,1
NC_037335.1,NC_032657.1,10296921,10296923,10358406,GTA,G,2
NC_037335.1,NC_032657.1,10737527,10737529,10824694,TTA,T,2
NC_037335.1,NC_032657.1,10737533,10737534,10824698,GA,G,1
NC_037335.1,NC_032657.1,10737540,10737541,10824704,GT,G,1
NC_037335.1,NC_032657.1,10806292,10806294,10893918,CTG,C,2
NC_037335.1,NC_032657.1,10861204,10861205,10949941,TC,T,1
NC_037335.1,NC_032657.1,11281134,11281135,11370209,GC,G,1
NC_037335.1,NC_032657.1,11281195,11281196,11370268,GT,G,1
NC_037335.1,NC_032657.1,11812011,11812013,11908597,TTG,T,2
NC_037335.1,NC_032657.1,11812025,11812026,11908609,CA,C,1
NC_037335.1,NC_032657.1,11812032,11812033,11908615,GA,G,1
NC_037335.1,NC_032657.1,11818710,11818712,11915292,TTC,T,2
NC_037335.1,NC_032657.1,12018757,12018758,12136161,GC,G,1
NC_037335.1,NC_032657.1,12780413,12780414,12969983,CA,C,1
NC_037335.1,NC_032657.1,14062047,14062048,14293115,CT,C,1
NC_037335.1,NC_032657.1,14559232,14559233,14788547,AC,A,1
NC_037335.1,NC_032657.1,14765749,14765750,15017193,CT,C,1
NC_037335.1,NC_032657.1,14841265,14841266,15093656,GT,G,1
NC_037335.1,NC_032657.1,14919365,14919366,15170697,GC,G,1
NC_037335.1,NC_032657.1,15063970,15063971,15332823,CA,C,1
NC_037335.1,NC_032657.1,15066394,15066395,15335247,TG,T,1
NC_037335.1,NC_032657.1,15066402,15066403,15335254,AG,A,1
NC_037335.1,NC_032657.1,15066436,15066438,15335287,AAG,A,2
NC_037335.1,NC_032657.1,15220233,15220234,15489399,CA,C,1
NC_037335.1,NC_032657.1,15241103,15241104,15510236,CT,C,1
NC_037335.1,NC_032657.1,15241116,15241117,15510248,AT,A,1
NC_037335.1,NC_032657.1,15241128,15241129,15510259,CT,C,1
NC_037335.1,NC_032657.1,15241139,15241140,15510269,AT,A,1
NC_037335.1,NC_032657.1,15241313,15241314,15510440,AC,A,1
NC_037335.1,NC_032657.1,15340098,15340100,15614586,CCA,C,2
NC_037335.1,NC_032657.1,15380843,15380844,15655486,AG,A,1
NC_037335.1,NC_032657.1,15390407,15390409,15665029,TTA,T,2
NC_037335.1,NC_032657.1,15430593,15430596,15705431,ACGT,A,3
NC_037335.1,NC_032657.1,15462455,15462456,15737299,TA,T,1
NC_037335.1,NC_032657.1,15539517,15539518,15813725,GC,G,1
NC_037335.1,NC_032657.1,15569578,15569580,15843817,GGT,G,2
NC_037335.1,NC_032657.1,15614648,15614649,15889016,TG,T,1
NC_037335.1,NC_032657.1,16601817,16601818,16996837,GC,G,1
NC_037335.1,NC_032657.1,16709854,16709855,17103850,TA,T,1
NC_037335.1,NC_032657.1,16709892,16709899,17103887,AGACAAAC,A,7
NC_037335.1,NC_032657.1,16709901,16709902,17103889,GT,G,1
NC_037335.1,NC_032657.1,16990622,16990623,17448449,GT,G,1
NC_037335.1,NC_032657.1,18005866,18005868,18474806,TAG,T,2
NC_037335.1,NC_032657.1,18313820,18313823,18783221,AACT,A,3
NC_037335.1,NC_032657.1,18421788,18421789,18890877,AC,A,1
NC_037335.1,NC_032657.1,18511139,18511140,18980548,TC,T,1
NC_037335.1,NC_032657.1,18540602,18540603,19010097,TG,T,1
NC_037335.1,NC_032657.1,18641176,18641177,19111418,TC,T,1
NC_037335.1,NC_032657.1,18719177,18719179,19186352,CAG,C,2
NC_037335.1,NC_032657.1,18772445,18772446,19239685,CA,C,1
NC_037335.1,NC_032657.1,18772464,18772466,19239703,CCT,C,2
NC_037335.1,NC_032657.1,18772477,18772478,19239714,AT,A,1
NC_037335.1,NC_032657.1,18837562,18837563,19304796,GT,G,1
NC_037335.1,NC_032657.1,18900901,18900902,19368166,GA,G,1
NC_037335.1,NC_032657.1,19055539,19055541,19522688,AAT,A,2
NC_037335.1,NC_032657.1,19055546,19055547,19522693,GA,G,1
NC_037335.1,NC_032657.1,19055558,19055559,19522704,GA,G,1
NC_037335.1,NC_032657.1,19179813,19179814,19625392,TA,T,1
NC_037335.1,NC_032657.1,19179821,19179822,19625399,TG,T,1
NC_037335.1,NC_032657.1,19179833,19179834,19625410,GA,G,1
NC_037335.1,NC_032657.1,19459174,19459176,19940398,TTG,T,2
NC_037335.1,NC_032657.1,19508341,19508342,20142579,AG,A,1
NC_037335.1,NC_032657.1,19511830,19511838,20146080,ATCATCCAG,A,8
NC_037335.1,NC_032657.1,19538152,19538153,20183630,GA,G,1
NC_037335.1,NC_032657.1,19538169,19538170,20183646,CA,C,1
NC_037335.1,NC_032657.1,19596920,19596921,20242759,GT,G,1
NC_037335.1,NC_032657.1,19602775,19602779,20248614,TATGC,T,4
NC_037335.1,NC_032657.1,19698034,19698036,20346027,AAC,A,2
NC_037335.1,NC_032657.1,19698094,19698095,20346085,AC,A,1
NC_037335.1,NC_032657.1,19698100,19698101,20346090,AC,A,1
NC_037335.1,NC_032657.1,19711128,19711129,20359119,GT,G,1
NC_037335.1,NC_032657.1,19717190,19717191,20365181,AG,A,1
NC_037335.1,NC_032657.1,20086328,20086334,20663558,CAGCAGA,C,6
NC_037335.1,NC_032657.1,20104403,20104404,20681640,AC,A,1
NC_037335.1,NC_032657.1,20163991,20163992,20741235,TG,T,1
NC_037335.1,NC_032657.1,20164038,20164039,20741280,AC,A,1
NC_037335.1,NC_032657.1,20164046,20164047,20741287,TG,T,1
NC_037335.1,NC_032657.1,20164051,20164052,20741291,CA,C,1
NC_037335.1,NC_032657.1,20456745,20456746,21118187,AC,A,1
NC_037335.1,NC_032657.1,20518569,20518570,21180012,AG,A,1
NC_037335.1,NC_032657.1,20537677,20537678,21199121,TG,T,1
NC_037335.1,NC_032657.1,20848345,20848346,21506465,TA,T,1
NC_037335.1,NC_032657.1,20848354,20848355,21506473,TA,T,1
NC_037335.1,NC_032657.1,20923983,20923984,21637192,AT,A,1
NC_037335.1,NC_032657.1,20932221,20932224,21646084,AACC,A,3
NC_037335.1,NC_032657.1,21005417,21005418,21720121,AC,A,1
NC_037335.1,NC_032657.1,21117497,21117498,21868719,TA,T,1
NC_037335.1,NC_032657.1,21166628,21166629,21917687,GC,G,1
NC_037335.1,NC_032657.1,21176996,21176997,21928054,GC,G,1
NC_037335.1,NC_032657.1,21180906,21180907,21931956,TA,T,1
NC_037335.1,NC_032657.1,21659583,21659584,22572758,TA,T,1
NC_037335.1,NC_032657.1,21750570,21750571,22664389,CA,C,1
NC_037335.1,NC_032657.1,21786689,21786695,22700914,GCAATCA,G,6
NC_037335.1,NC_032657.1,21836618,21836619,22778561,GC,G,1
NC_037335.1,NC_032657.1,21839556,21839563,22781547,AAGTCTTC,A,7
NC_037335.1,NC_032657.1,21927646,21927647,22872332,AG,A,1
NC_037335.1,NC_032657.1,22207469,22207470,23218788,GA,G,1
NC_037335.1,NC_032657.1,22573079,22573080,23648002,AT,A,1
NC_037335.1,NC_032657.1,22573182,22573183,23648104,GA,G,1
NC_037335.1,NC_032657.1,22573893,22573894,23648816,CA,C,1
NC_037335.1,NC_032657.1,22573917,22573918,23648839,TC,T,1
NC_037335.1,NC_032657.1,22605546,22605550,23610622,CTTAT,C,4
NC_037335.1,NC_032657.1,22624973,22624974,23629546,CT,C,1
NC_037335.1,NC_032657.1,22625156,22625160,23629728,GAAAT,G,4
NC_037335.1,NC_032657.1,22625232,22625233,23629800,AT,A,1
NC_037335.1,NC_032657.1,22938578,22938579,23935100,AG,A,1
NC_037335.1,NC_032657.1,22938607,22938608,23935072,TG,T,1
NC_037335.1,NC_032657.1,22978723,22978724,24287120,TA,T,1
NC_037335.1,NC_032657.1,22979541,22979542,24287937,CT,C,1
NC_037335.1,NC_032657.1,22982652,22982653,24291048,AT,A,1
NC_037335.1,NC_032657.1,22985234,22985235,24294457,CT,C,1
NC_037335.1,NC_032657.1,23007934,23007936,24316102,CCA,C,2
NC_037335.1,NC_032657.1,23040441,23040442,24353032,CT,C,1
NC_037335.1,NC_032657.1,23040612,23040614,24353209,CAA,C,2
NC_037335.1,NC_032657.1,23060523,23060524,24373142,GT,G,1
NC_037335.1,NC_032657.1,23084392,23084393,24397015,AC,A,1
NC_037335.1,NC_032657.1,23246332,23246333,24673437,CT,C,1
NC_037335.1,NC_032657.1,23246340,23246341,24673444,AG,A,1
NC_037335.1,NC_032657.1,23247208,23247209,24674311,CA,C,1
NC_037335.1,NC_032657.1,23258159,23258160,24685264,GA,G,1
NC_037335.1,NC_032657.1,23261774,23261775,24688904,TC,T,1
NC_037335.1,NC_032657.1,23264926,23264927,24692022,AT,A,1
NC_037335.1,NC_032657.1,23265484,23265488,24692585,AAATT,A,4
NC_037335.1,NC_032657.1,23271475,23271476,24695173,TC,T,1
NC_037335.1,NC_032657.1,23271516,23271517,24695214,AG,A,1
NC_037335.1,NC_032657.1,23271524,23271525,24695221,GC,G,1
NC_037335.1,NC_032657.1,23271554,23271556,24695250,AGG,A,2
NC_037335.1,NC_032657.1,23271661,23271662,24695352,GT,G,1
NC_037335.1,NC_032657.1,23271671,23271672,24695361,GC,G,1
NC_037335.1,NC_032657.1,23271712,23271713,24695401,AG,A,1
NC_037335.1,NC_032657.1,23271763,23271764,24695448,CA,C,1
NC_037335.1,NC_032657.1,23282960,23282961,24706666,AT,A,1
NC_037335.1,NC_032657.1,23283014,23283015,24706717,AC,A,1
NC_037335.1,NC_032657.1,23283021,23283022,24706723,AT,A,1
NC_037335.1,NC_032657.1,23283025,23283026,24706726,CT,C,1
NC_037335.1,NC_032657.1,23512791,23512792,24994650,AT,A,1
NC_037335.1,NC_032657.1,23515462,23515463,24997115,AC,A,1
NC_037335.1,NC_032657.1,23516578,23516579,24998230,GA,G,1
NC_037335.1,NC_032657.1,23516610,23516611,24998261,GA,G,1
NC_037335.1,NC_032657.1,23642679,23642680,25119935,CT,C,1
NC_037335.1,NC_032657.1,23672557,23672558,25149973,TA,T,1
NC_037335.1,NC_032657.1,24197554,24197555,25690570,AC,A,1
NC_037335.1,NC_032657.1,24558127,24558128,26069938,CA,C,1
NC_037335.1,NC_032657.1,24741542,24741544,26256088,AAG,A,2
NC_037335.1,NC_032657.1,25219391,25219392,26734658,TC,T,1
NC_037335.1,NC_032657.1,25718967,25718968,27279742,AT,A,1
NC_037335.1,NC_032657.1,25719000,25719001,27279770,CA,C,1
NC_037335.1,NC_032657.1,25719025,25719026,27279794,CA,C,1
NC_037335.1,NC_032657.1,25719051,25719052,27279819,TC,T,1
NC_037335.1,NC_032657.1,25725910,25725911,27286746,CT,C,1
NC_037335.1,NC_032657.1,25844205,25844206,27404953,GC,G,1
NC_037335.1,NC_032657.1,25844244,25844245,27404991,CA,C,1
NC_037335.1,NC_032657.1,26020874,26020875,27581410,CA,C,1
NC_037335.1,NC_032657.1,26081468,26081469,27642022,AC,A,1
NC_037335.1,NC_032657.1,26338447,26338448,27884617,GA,G,1
NC_037335.1,NC_032657.1,26661817,26661818,28214577,TG,T,1
NC_037335.1,NC_032657.1,26768828,26768829,28321728,CT,C,1
NC_037335.1,NC_032657.1,26820495,26820511,28507349,TCTGACAGGCTAAGAAA,T,16
NC_037335.1,NC_032657.1,26830295,26830296,28517168,GT,G,1
NC_037335.1,NC_032657.1,26855267,26855268,28542144,CA,C,1
NC_037335.1,NC_032657.1,26866284,26866285,28552829,GC,G,1
NC_037335.1,NC_032657.1,26895956,26895957,28602573,GA,G,1
NC_037335.1,NC_032657.1,26996564,26996565,28703003,AG,A,1
NC_037335.1,NC_032657.1,26996620,26996622,28703058,TTC,T,2
NC_037335.1,NC_032657.1,27027560,27027562,28734032,GGA,G,2
NC_037335.1,NC_032657.1,27112360,27112361,28817391,AG,A,1
NC_037335.1,NC_032657.1,27414385,27414386,29142552,AT,A,1
NC_037335.1,NC_032657.1,27414393,27414394,29142559,CT,C,1
NC_037335.1,NC_032657.1,27497518,27497519,29224196,TA,T,1
NC_037335.1,NC_032657.1,27508982,27508983,29236238,TA,T,1
NC_037335.1,NC_032657.1,27520234,27520235,29247492,GT,G,1
NC_037335.1,NC_032657.1,27550797,27550798,29278066,TC,T,1
NC_037335.1,NC_032657.1,27558573,27558574,29285841,TA,T,1
NC_037335.1,NC_032657.1,27641107,27641109,29368346,TTG,T,2
NC_037335.1,NC_032657.1,27641117,27641118,29368354,GA,G,1
NC_037335.1,NC_032657.1,27641125,27641126,29368361,CT,C,1
NC_037335.1,NC_032657.1,27648578,27648579,29375797,CT,C,1
NC_037335.1,NC_032657.1,27654379,27654380,29381541,CA,C,1
NC_037335.1,NC_032657.1,27656365,27656383,29383526,AACCAGCCCGACTCCGCCT,A,18
NC_037335.1,NC_032657.1,28085575,28085576,29806314,AC,A,1
NC_037335.1,NC_032657.1,28169948,28169950,29898178,CCT,C,2
NC_037335.1,NC_032657.1,28271985,28271986,30012100,TG,T,1
NC_037335.1,NC_032657.1,28287545,28287546,30027656,GA,G,1
NC_037335.1,NC_032657.1,28287552,28287553,30027662,TC,T,1
NC_037335.1,NC_032657.1,28287565,28287566,30027674,TA,T,1
NC_037335.1,NC_032657.1,28417257,28417259,30157432,CCT,C,2
NC_037335.1,NC_032657.1,28575585,28575586,30315744,GC,G,1
NC_037335.1,NC_032657.1,28705324,28705325,30446033,GA,G,1
NC_037335.1,NC_032657.1,28718077,28718078,30458780,GT,G,1
NC_037335.1,NC_032657.1,28861098,28861099,30637057,AG,A,1
NC_037335.1,NC_032657.1,28861121,28861123,30637079,TTA,T,2
NC_037335.1,NC_032657.1,28861129,28861130,30637085,CA,C,1
NC_037335.1,NC_032657.1,28866622,28866623,30642581,AG,A,1
NC_037335.1,NC_032657.1,28971710,28971711,30747704,CT,C,1
NC_037335.1,NC_032657.1,28982635,28982636,30759096,TC,T,1
NC_037335.1,NC_032657.1,29586607,29586609,31367423,AAG,A,2
NC_037335.1,NC_032657.1,29586619,29586620,31367433,GT,G,1
NC_037335.1,NC_032657.1,29607668,29607669,31388481,AG,A,1
NC_037335.1,NC_032657.1,29611155,29611157,31391970,CAA,C,2
NC_037335.1,NC_032657.1,29799762,29799763,31598483,AT,A,1
NC_037335.1,NC_032657.1,29822819,29822820,31621108,AG,A,1
NC_037335.1,NC_032657.1,29858307,29858308,31656119,AG,A,1
NC_037335.1,NC_032657.1,29972606,29972607,31769817,GA,G,1
NC_037335.1,NC_032657.1,30340914,30340915,32142010,AC,A,1
NC_037335.1,NC_032657.1,30424930,30424931,32229305,GT,G,1
NC_037335.1,NC_032657.1,30470369,30470370,32291082,TA,T,1
NC_037335.1,NC_032657.1,30470438,30470439,32291149,TA,T,1
NC_037335.1,NC_032657.1,30508516,30508519,32334853,CCTT,C,3
NC_037335.1,NC_032657.1,30528500,30528501,32354845,TG,T,1
NC_037335.1,NC_032657.1,30607914,30607915,32434078,TC,T,1
NC_037335.1,NC_032657.1,30637075,30637076,32463248,TA,T,1
NC_037335.1,NC_032657.1,30653420,30653421,32479629,GA,G,1
NC_037335.1,NC_032657.1,30695301,30695302,32521508,CG,C,1
NC_037335.1,NC_032657.1,31638061,31638062,33480089,AG,A,1
NC_037335.1,NC_032657.1,31672881,31672884,33514762,TGTA,T,3
NC_037335.1,NC_032657.1,31685643,31685644,33527552,TC,T,1
NC_037335.1,NC_032657.1,31693283,31693284,33535196,TC,T,1
NC_037335.1,NC_032657.1,31730445,31730446,33574862,TG,T,1
NC_037335.1,NC_032657.1,31738677,31738678,33583095,TG,T,1
NC_037335.1,NC_032657.1,31785816,31785817,33630688,TG,T,1
NC_037335.1,NC_032657.1,31877712,31877713,33722748,AC,A,1
NC_037335.1,NC_032657.1,31907910,31907911,33752855,TC,T,1
NC_037335.1,NC_032657.1,32056580,32056581,33908191,GT,G,1
NC_037335.1,NC_032657.1,32221246,32221247,34072952,CT,C,1
NC_037335.1,NC_032657.1,32827743,32827744,34679662,CA,C,1
NC_037335.1,NC_032657.1,32962161,32962162,34817788,CA,C,1
NC_037335.1,NC_032657.1,32973466,32973467,34829095,AG,A,1
NC_037335.1,NC_032657.1,33168307,33168308,35025285,CT,C,1
NC_037335.1,NC_032657.1,33368918,33368919,35246134,AT,A,1
NC_037335.1,NC_032657.1,33374132,33374133,35251352,GC,G,1
NC_037335.1,NC_032657.1,33566098,33566099,35444304,TG,T,1
NC_037335.1,NC_032657.1,33813015,33813017,35691413,TTA,T,2
NC_037335.1,NC_032657.1,33938811,33938812,35842963,TC,T,1
NC_037335.1,NC_032657.1,34157558,34157559,36062533,TC,T,1
NC_037335.1,NC_032657.1,34233639,34233640,36138888,TA,T,1
NC_037335.1,NC_032657.1,34579367,34579368,36534584,GT,G,1
NC_037335.1,NC_032657.1,34772368,34772369,36732902,GT,G,1
NC_037335.1,NC_032657.1,34813799,34813800,36769676,TA,T,1
NC_037335.1,NC_032657.1,34814323,34814324,36770199,AC,A,1
NC_037335.1,NC_032657.1,34879984,34879985,36835774,TC,T,1
NC_037335.1,NC_032657.1,34951226,34951230,36906346,CAGCT,C,4
NC_037335.1,NC_032657.1,35178008,35178009,37132244,TC,T,1
NC_037335.1,NC_032657.1,35216455,35216456,37170706,CA,C,1
NC_037335.1,NC_032657.1,35217951,35217952,37172201,AC,A,1
NC_037335.1,NC_032657.1,35441227,35441228,37435262,CT,C,1
NC_037335.1,NC_032657.1,35459481,35459482,37453516,TC,T,1
NC_037335.1,NC_032657.1,35472701,35472702,37466739,TA,T,1
NC_037335.1,NC_032657.1,35568016,35568017,37563220,AT,A,1
NC_037335.1,NC_032657.1,35568514,35568515,37563716,CA,C,1
NC_037335.1,NC_032657.1,35633715,35633717,37628969,TCA,T,2
NC_037335.1,NC_032657.1,35757186,35757187,37790436,GT,G,1
NC_037335.1,NC_032657.1,35831956,35831957,37865728,AT,A,1
NC_037335.1,NC_032657.1,35831960,35831961,37865731,AT,A,1
NC_037335.1,NC_032657.1,35870887,35870889,37904671,CAA,C,2
NC_037335.1,NC_032657.1,35871319,35871320,37905101,GC,G,1
NC_037335.1,NC_032657.1,35875991,35875992,37909772,TC,T,1
NC_037335.1,NC_032657.1,35923669,35923670,37957449,AC,A,1
NC_037335.1,NC_032657.1,35971179,35971180,38014458,GA,G,1
NC_037335.1,NC_032657.1,36293585,36293587,38335073,TGA,T,2
NC_037335.1,NC_032657.1,36702183,36702185,38743998,CTG,C,2
NC_037335.1,NC_032657.1,36711365,36711366,38753176,CT,C,1
NC_037335.1,NC_032657.1,36790859,36790863,38833022,TCAGA,T,4
NC_037335.1,NC_032657.1,36795458,36795459,38837626,GA,G,1
NC_037335.1,NC_032657.1,36862591,36862605,38906366,AGGAAGGAAGCTATG,A,14
NC_037335.1,NC_032657.1,36989840,36989841,39033786,AG,A,1
NC_037335.1,NC_032657.1,37329487,37329488,39392003,TG,T,1
NC_037335.1,NC_032657.1,37391847,37391848,39454546,TC,T,1
NC_037335.1,NC_032657.1,37402125,37402126,39473778,GT,G,1
NC_037335.1,NC_032657.1,37832063,37832064,39914707,TA,T,1
NC_037335.1,NC_032657.1,37832093,37832094,39914739,GT,G,1
NC_037335.1,NC_032657.1,37844666,37844667,39927309,AT,A,1
NC_037335.1,NC_032657.1,38320817,38320818,40431834,TG,T,1
NC_037335.1,NC_032657.1,38396637,38396638,40507212,AT,A,1
NC_037335.1,NC_032657.1,38716967,38716968,40884457,CG,C,1
NC_037335.1,NC_032657.1,38786795,38786796,40953948,AC,A,1
NC_037335.1,NC_032657.1,40037447,40037448,42242057,CA,C,1
NC_037335.1,NC_032657.1,40037454,40037455,42242063,AG,A,1
NC_037335.1,NC_032657.1,40337770,40337771,42542562,CT,C,1
NC_037335.1,NC_032657.1,40337813,40337814,42542603,GC,G,1
NC_037335.1,NC_032657.1,40389905,40389909,42594739,CACTA,C,4
NC_037335.1,NC_032657.1,40389905,40389909,42656270,CACTA,C,4
NC_037335.1,NC_032657.1,40498699,40498700,42765065,TG,T,1
NC_037335.1,NC_032657.1,40730794,40730795,42997054,TG,T,1
NC_037335.1,NC_032657.1,40784294,40784297,43050622,CGTG,C,3
NC_037335.1,NC_032657.1,40934867,40934868,43200789,GT,G,1
NC_037335.1,NC_032657.1,41541886,41541888,43809837,TTG,T,2
NC_037335.1,NC_032657.1,41543962,41543986,43811912,CTTGTCACCCTCTGGTTGAGATGTT,C,24
NC_037335.1,NC_032657.1,41790497,41790498,44075300,TC,T,1
NC_037335.1,NC_032657.1,41805732,41805733,44088603,TG,T,1
NC_037335.1,NC_032657.1,41805745,41805746,44088615,CA,C,1
NC_037335.1,NC_032657.1,41805756,41805758,44088625,AAG,A,2
NC_037335.1,NC_032657.1,41822607,41822623,44105502,GACAATGGGTTTAAACC,G,16
NC_037335.1,NC_032657.1,42189090,42189094,44411086,GTCTT,G,4
NC_037335.1,NC_032657.1,42237822,42237824,44475613,CAT,C,2
NC_037335.1,NC_032657.1,42240709,42240710,44479522,TA,T,1
NC_037335.1,NC_032657.1,42944235,42944236,45015237,TA,T,1
NC_037335.1,NC_032657.1,43896698,43896699,46072650,AG,A,1
NC_037335.1,NC_032657.1,44357069,44357070,46607515,AT,A,1
NC_037335.1,NC_032657.1,44357078,44357079,46607523,GT,G,1
NC_037335.1,NC_032657.1,44405638,44405639,46655357,AG,A,1
NC_037335.1,NC_032657.1,44717358,44717359,47031615,TG,T,1
NC_037335.1,NC_032657.1,44733273,44733274,47047586,TC,T,1
NC_037335.1,NC_032657.1,44739992,44739993,47054306,GA,G,1
NC_037335.1,NC_032657.1,44808845,44808846,47123131,GT,G,1
NC_037335.1,NC_032657.1,44887965,44887966,47202254,TA,T,1
NC_037335.1,NC_032657.1,45207978,45207986,47523745,CTGTGTGCA,C,8
NC_037335.1,NC_032657.1,45280531,45280532,47596295,GA,G,1
NC_037335.1,NC_032657.1,45290120,45290123,47605883,ATAG,A,3
NC_037335.1,NC_032657.1,45293658,45293659,47609414,GA,G,1
NC_037335.1,NC_032657.1,45642188,45642189,47959848,GA,G,1
NC_037335.1,NC_032657.1,46508272,46508273,48756429,TA,T,1
NC_037335.1,NC_032657.1,46532703,46532705,48779938,AAG,A,2
NC_037335.1,NC_032657.1,46532709,46532711,48779942,AAT,A,2
NC_037335.1,NC_032657.1,46644910,46644911,48879837,AT,A,1
NC_037335.1,NC_032657.1,46796182,46796183,49118793,AC,A,1
NC_037335.1,NC_032657.1,46875672,46875678,49191988,TGGCGCG,T,6
NC_037335.1,NC_032657.1,46953646,46953647,49270912,GA,G,1
NC_037335.1,NC_032657.1,46980943,46980944,49298207,GT,G,1
NC_037335.1,NC_032657.1,46980948,46980949,49298211,AG,A,1
NC_037335.1,NC_032657.1,47060543,47060544,49377549,TA,T,1
NC_037335.1,NC_032657.1,47179920,47179921,49497168,CA,C,1
NC_037335.1,NC_032657.1,47182749,47182755,49500005,TGAGTGG,T,6
NC_037335.1,NC_032657.1,47298054,47298058,49615312,AATTC,A,4
NC_037335.1,NC_032657.1,47510403,47510404,49843341,CA,C,1
NC_037335.1,NC_032657.1,47900991,47900992,50230136,AT,A,1
NC_037335.1,NC_032657.1,48258778,48258779,50588958,TC,T,1
NC_037335.1,NC_032657.1,48306375,48306376,50651047,GC,G,1
NC_037335.1,NC_032657.1,48483410,48483411,50834756,TA,T,1
NC_037335.1,NC_032657.1,48517531,48517532,50868878,TA,T,1
NC_037335.1,NC_032657.1,48581594,48581595,50933814,AT,A,1
NC_037335.1,NC_032657.1,48581602,48581603,50933821,AT,A,1
NC_037335.1,NC_032657.1,48656743,48656744,51007039,GA,G,1
NC_037335.1,NC_032657.1,48858552,48858553,51213221,TA,T,1
NC_037335.1,NC_032657.1,49022264,49022276,51376330,GTGGACTACTACA,G,12
NC_037335.1,NC_032657.1,49026951,49026952,51380756,AT,A,1
NC_037335.1,NC_032657.1,49033256,49033257,51387090,CA,C,1
NC_037335.1,NC_032657.1,49084416,49084417,51434544,GC,G,1
NC_037335.1,NC_032657.1,49658689,49658690,52018425,TA,T,1
NC_037335.1,NC_032657.1,49696717,49696718,52056411,TG,T,1
NC_037335.1,NC_032657.1,49799180,49799181,52159890,AG,A,1
NC_037335.1,NC_032657.1,49885492,49885493,52246033,AC,A,1
NC_037335.1,NC_032657.1,49951874,49951875,52313275,TG,T,1
NC_037335.1,NC_032657.1,49953228,49953229,52314624,GT,G,1
NC_037335.1,NC_032657.1,49953241,49953242,52314636,CA,C,1
NC_037335.1,NC_032657.1,50012328,50012329,52374216,TA,T,1
NC_037335.1,NC_032657.1,50195914,50195915,52556607,GT,G,1
NC_037335.1,NC_032657.1,50229947,50229948,52590647,AT,A,1
NC_037335.1,NC_032657.1,50690172,50690173,53051739,AT,A,1
NC_037335.1,NC_032657.1,50808721,50808722,53170186,CT,C,1
NC_037335.1,NC_032657.1,50854521,50854522,53215989,TG,T,1
NC_037335.1,NC_032657.1,50854663,50854664,53216131,GC,G,1
NC_037335.1,NC_032657.1,50854761,50854762,53216228,AC,A,1
NC_037335.1,NC_032657.1,50855176,50855177,53216642,GT,G,1
NC_037335.1,NC_032657.1,50855244,50855245,53216709,TA,T,1
NC_037335.1,NC_032657.1,50855545,50855546,53217009,AG,A,1
NC_037335.1,NC_032657.1,50855574,50855575,53217037,CG,C,1
NC_037335.1,NC_032657.1,51129205,51129206,53454641,CA,C,1
NC_037335.1,NC_032657.1,51141808,51141809,53467231,AT,A,1
NC_037335.1,NC_032657.1,51236809,51236810,53562251,AT,A,1
NC_037335.1,NC_032657.1,51268773,51268774,53594224,TG,T,1
NC_037335.1,NC_032657.1,51294748,51294749,53619843,TG,T,1
NC_037335.1,NC_032657.1,51775238,51775239,54105214,TC,T,1
NC_037335.1,NC_032657.1,52035336,52035337,54365136,AG,A,1
NC_037335.1,NC_032657.1,52245496,52245497,54585081,CA,C,1
NC_037335.1,NC_032657.1,52651248,52651253,54992239,ATGAAT,A,5
NC_037335.1,NC_032657.1,52746937,52746938,55087986,TG,T,1
NC_037335.1,NC_032657.1,52746965,52746966,55088014,TC,T,1
NC_037335.1,NC_032657.1,52772614,52772615,55113661,GA,G,1
NC_037335.1,NC_032657.1,52785030,52785031,55126078,AG,A,1
NC_037335.1,NC_032657.1,52786604,52786605,55127646,TG,T,1
NC_037335.1,NC_032657.1,52854316,52854319,55195385,ACTG,A,3
NC_037335.1,NC_032657.1,52858678,52858683,55199377,CTGTGG,C,5
NC_037335.1,NC_032657.1,52858691,52858695,55199385,TCTTA,T,4
NC_037335.1,NC_032657.1,53061127,53061128,55400783,CA,C,1
NC_037335.1,NC_032657.1,53062945,53062946,55402600,AC,A,1
NC_037335.1,NC_032657.1,53063840,53063841,55403494,CG,C,1
NC_037335.1,NC_032657.1,53071869,53071870,55411471,GA,G,1
NC_037335.1,NC_032657.1,53360871,53360872,55759651,AT,A,1
NC_037335.1,NC_032657.1,53422330,53422331,55820963,TG,T,1
NC_037335.1,NC_032657.1,53615672,53615673,56013674,CT,C,1
NC_037335.1,NC_032657.1,53885015,53885016,56283492,TG,T,1
NC_037335.1,NC_032657.1,54198682,54198683,56597594,AC,A,1
NC_037335.1,NC_032657.1,54484412,54484413,56884462,AC,A,1
NC_037335.1,NC_032657.1,54487908,54487912,56887956,AAGAT,A,4
NC_037335.1,NC_032657.1,54498150,54498151,56898200,AC,A,1
NC_037335.1,NC_032657.1,54549200,54549201,56949345,GT,G,1
NC_037335.1,NC_032657.1,54783981,54783982,57199115,AT,A,1
NC_037335.1,NC_032657.1,54809686,54809687,57224930,AT,A,1
NC_037335.1,NC_032657.1,54825135,54825136,57240386,GA,G,1
NC_037335.1,NC_032657.1,54906342,54906343,57331282,TG,T,1
NC_037335.1,NC_032657.1,54917869,54917870,57343775,GT,G,1
NC_037335.1,NC_032657.1,55072390,55072392,57499523,TTC,T,2
NC_037335.1,NC_032657.1,55180349,55180350,57624280,TA,T,1
NC_037335.1,NC_032657.1,55376896,55376897,57821241,TG,T,1
NC_037335.1,NC_032657.1,55377129,55377130,57821473,GC,G,1
NC_037335.1,NC_032657.1,55377945,55377946,57822295,GC,G,1
NC_037335.1,NC_032657.1,55378264,55378265,57822613,TG,T,1
NC_037335.1,NC_032657.1,55381269,55381270,57825623,AT,A,1
NC_037335.1,NC_032657.1,55382047,55382048,57826403,CA,C,1
NC_037335.1,NC_032657.1,55387486,55387487,57805719,GT,G,1
NC_037335.1,NC_032657.1,55387492,55387493,57805724,CA,C,1
NC_037335.1,NC_032657.1,55387584,55387585,57805815,GC,G,1
NC_037335.1,NC_032657.1,55387987,55387988,57806220,AC,A,1
NC_037335.1,NC_032657.1,55388035,55388036,57806267,TG,T,1
NC_037335.1,NC_032657.1,55388208,55388209,57806439,TG,T,1
NC_037335.1,NC_032657.1,55388625,55388626,57806857,AT,A,1
NC_037335.1,NC_032657.1,55388648,55388649,57806879,AT,A,1
NC_037335.1,NC_032657.1,55388705,55388706,57806936,GA,G,1
NC_037335.1,NC_032657.1,55388935,55388936,57807169,CT,C,1
NC_037335.1,NC_032657.1,55389524,55389525,57807758,CA,C,1
NC_037335.1,NC_032657.1,55390153,55390154,57808387,CA,C,1
NC_037335.1,NC_032657.1,55390403,55390404,57808636,GC,G,1
NC_037335.1,NC_032657.1,55396212,55396213,57814450,CA,C,1
NC_037335.1,NC_032657.1,55436453,55436454,57854704,CT,C,1
NC_037335.1,NC_032657.1,55481893,55481894,57900160,CA,C,1
NC_037335.1,NC_032657.1,55488602,55488603,57906869,CG,C,1
NC_037335.1,NC_032657.1,55519471,55519472,57937745,AG,A,1
NC_037335.1,NC_032657.1,55519488,55519489,57937761,AG,A,1
NC_037335.1,NC_032657.1,55519502,55519503,57937774,GT,G,1
NC_037335.1,NC_032657.1,55519514,55519515,57937785,CT,C,1
NC_037335.1,NC_032657.1,55519518,55519519,57937788,TA,T,1
NC_037335.1,NC_032657.1,55710036,55710037,58128367,AT,A,1
NC_037335.1,NC_032657.1,55875872,55875874,58300393,TTG,T,2
NC_037335.1,NC_032657.1,55875921,55875923,58300440,AAT,A,2
NC_037335.1,NC_032657.1,56008290,56008291,58433333,AT,A,1
NC_037335.1,NC_032657.1,56030472,56030473,58455522,AT,A,1
NC_037335.1,NC_032657.1,56043616,56043617,58468690,TC,T,1
NC_037335.1,NC_032657.1,56180900,56180901,58606857,CA,C,1
NC_037335.1,NC_032657.1,56261200,56261202,58687387,AAT,A,2
NC_037335.1,NC_032657.1,56265322,56265323,58691550,AT,A,1
NC_037335.1,NC_032657.1,56988022,56988023,59547572,GA,G,1
NC_037335.1,NC_032657.1,57451713,57451714,60012815,AT,A,1
NC_037335.1,NC_032657.1,57502281,57502287,60063384,AGCCATT,A,6
NC_037335.1,NC_032657.1,57804758,57804759,60367571,AG,A,1
NC_037335.1,NC_032657.1,57805809,57805810,60368332,CT,C,1
NC_037335.1,NC_032657.1,58067381,58067382,60630003,GC,G,1
NC_037335.1,NC_032657.1,58357070,58357072,60917149,GGT,G,2
NC_037335.1,NC_032657.1,58357150,58357151,60917226,TC,T,1
NC_037335.1,NC_032657.1,58357169,58357170,60917244,CT,C,1
NC_037335.1,NC_032657.1,58651921,58651922,61208162,TG,T,1
NC_037335.1,NC_032657.1,58655736,58655737,61211979,GA,G,1
NC_037335.1,NC_032657.1,58820022,58820037,61375096,ATCCTGGATTAAACTT,A,15
NC_037335.1,NC_032657.1,59006463,59006465,61663923,CAT,C,2
NC_037335.1,NC_032657.1,59208755,59208756,61863750,AT,A,1
NC_037335.1,NC_032657.1,59208789,59208790,61863782,AT,A,1
NC_037335.1,NC_032657.1,59272521,59272522,61927617,CA,C,1
NC_037335.1,NC_032657.1,59315878,59315879,61970963,GC,G,1
NC_037335.1,NC_032657.1,59317233,59317234,61972314,TC,T,1
NC_037335.1,NC_032657.1,59351835,59351836,62006917,AG,A,1
NC_037335.1,NC_032657.1,59433809,59433810,62088899,TA,T,1
NC_037335.1,NC_032657.1,59433815,59433816,62088904,AT,A,1
NC_037335.1,NC_032657.1,59651312,59651317,62306978,GCTATT,G,5
NC_037335.1,NC_032657.1,60063759,60063760,62912499,CT,C,1
NC_037335.1,NC_032657.1,60071680,60071681,62920691,AC,A,1
NC_037335.1,NC_032657.1,60071688,60071689,62920698,GT,G,1
NC_037335.1,NC_032657.1,60093214,60093215,62942224,AC,A,1
NC_037335.1,NC_032657.1,60093537,60093538,62942549,AC,A,1
NC_037335.1,NC_032657.1,60095038,60095040,62944052,ACT,A,2
NC_037335.1,NC_032657.1,60095178,60095179,62944190,AT,A,1
NC_037335.1,NC_032657.1,60096379,60096381,62945400,ACT,A,2
NC_037335.1,NC_032657.1,60179523,60179524,62895863,TG,T,1
NC_037335.1,NC_032657.1,60180990,60181004,62897330,TCAGCAGAGCTACGG,T,14
NC_037335.1,NC_032657.1,60335968,60335972,63089033,TAGAG,T,4
NC_037335.1,NC_032657.1,60336808,60336809,63089869,CG,C,1
NC_037335.1,NC_032657.1,60422415,60422416,63175498,CT,C,1
NC_037335.1,NC_032657.1,60425914,60425915,63178998,CT,C,1
NC_037335.1,NC_032657.1,60493396,60493397,63253867,GT,G,1
NC_037335.1,NC_032657.1,60685349,60685350,63446595,AT,A,1
NC_037335.1,NC_032657.1,60947501,60947502,63727386,AG,A,1
NC_037335.1,NC_032657.1,61119451,61119452,63900008,CA,C,1
NC_037335.1,NC_032657.1,61233376,61233377,64027277,CA,C,1
NC_037335.1,NC_032657.1,61436419,61436420,64209196,TG,T,1
NC_037335.1,NC_032657.1,61436430,61436431,64209206,AC,A,1
NC_037335.1,NC_032657.1,61514992,61514993,64283981,TA,T,1
NC_037335.1,NC_032657.1,61993922,61993923,64778105,AG,A,1
NC_037335.1,NC_032657.1,61994027,61994029,64778209,CCA,C,2
NC_037335.1,NC_032657.1,62039895,62039897,64824078,TTA,T,2
NC_037335.1,NC_032657.1,62039904,62039905,64824085,GA,G,1
NC_037335.1,NC_032657.1,62082569,62082571,64867557,GGC,G,2
NC_037335.1,NC_032657.1,62302966,62302967,65092089,GT,G,1
NC_037335.1,NC_032657.1,62836382,62836383,65642922,CA,C,1
NC_037335.1,NC_032657.1,62981754,62981755,65788324,TC,T,1
NC_037335.1,NC_032657.1,63055187,63055188,65863798,CA,C,1
NC_037335.1,NC_032657.1,63157513,63157514,65965617,AC,A,1
NC_037335.1,NC_032657.1,63160373,63160376,65968235,TAAC,T,3
NC_037335.1,NC_032657.1,63171672,63171675,65979384,AAAT,A,3
NC_037335.1,NC_032657.1,63528163,63528164,66415316,TA,T,1
NC_037335.1,NC_032657.1,63738772,63738773,66656945,CG,C,1
NC_037335.1,NC_032657.1,63775719,63775720,66691789,TG,T,1
NC_037335.1,NC_032657.1,63836721,63836722,66752992,TC,T,1
NC_037335.1,NC_032657.1,64133410,64133411,66930866,AG,A,1
NC_037335.1,NC_032657.1,64361352,64361355,67163487,TATC,T,3
NC_037335.1,NC_032657.1,64639213,64639214,67439044,CA,C,1
NC_037335.1,NC_032657.1,65249673,65249674,68127611,AC,A,1
NC_037335.1,NC_032657.1,65249740,65249741,68127677,TC,T,1
NC_037335.1,NC_032657.1,65263145,65263155,68142777,ATCAGCCAGCC,A,10
NC_037335.1,NC_032657.1,65295832,65295835,68175455,AATG,A,3
NC_037335.1,NC_032657.1,65299659,65299662,68179280,GTTC,G,3
NC_037335.1,NC_032657.1,65299838,65299840,68179456,TTC,T,2
NC_037335.1,NC_032657.1,65300450,65300459,68180077,TCGTAAATAA,T,9
NC_037335.1,NC_032657.1,65301678,65301679,68181309,AG,A,1
NC_037335.1,NC_032657.1,65301686,65301687,68181316,GA,G,1
NC_037335.1,NC_032657.1,65301717,65301718,68181345,CA,C,1
NC_037335.1,NC_032657.1,65444162,65444163,68328514,TG,T,1
NC_037335.1,NC_032657.1,65502273,65502274,68386515,AT,A,1
NC_037335.1,NC_032657.1,65507622,65507623,68391861,GT,G,1
NC_037335.1,NC_032657.1,65509223,65509224,68393465,CA,C,1
NC_037335.1,NC_032657.1,65513756,65513757,68398419,GC,G,1
NC_037335.1,NC_032657.1,65518880,65518881,68403543,TC,T,1
NC_037335.1,NC_032657.1,65531386,65531390,68416011,CCACA,C,4
NC_037335.1,NC_032657.1,65531561,65531562,68416180,GC,G,1
NC_037335.1,NC_032657.1,65532522,65532523,68417141,CT,C,1
NC_037335.1,NC_032657.1,65541273,65541274,68425888,CG,C,1
NC_037335.1,NC_032657.1,65552123,65552136,68436738,AGAGGCTAGACCCT,A,13
NC_037335.1,NC_032657.1,65563176,65563177,68532585,TA,T,1
NC_037335.1,NC_032657.1,65576859,65576860,68546312,GA,G,1
NC_037335.1,NC_032657.1,65588312,65588315,68557793,AAGT,A,3
NC_037335.1,NC_032657.1,65592730,65592731,68562213,GT,G,1
NC_037335.1,NC_032657.1,65596201,65596204,68565671,ATTC,A,3
NC_037335.1,NC_032657.1,65606581,65606582,68576057,CA,C,1
NC_037335.1,NC_032657.1,65777682,65777684,68759814,AGG,A,2
NC_037335.1,NC_032657.1,65864175,65864176,68846827,GT,G,1
NC_037335.1,NC_032657.1,65936677,65936699,69074592,TCTAGATTTATTTGTTAAAAGGA,T,22
NC_037335.1,NC_032657.1,66153056,66153057,69328328,TC,T,1
NC_037335.1,NC_032657.1,66211693,66211694,69388524,TG,T,1
NC_037335.1,NC_032657.1,66329029,66329031,69505496,CAG,C,2
NC_037335.1,NC_032657.1,66340280,66340281,69516732,AC,A,1
NC_037335.1,NC_032657.1,66880046,66880047,70072746,TA,T,1
NC_037335.1,NC_032657.1,66962169,66962170,70158153,GA,G,1
NC_037335.1,NC_032657.1,66978906,66978907,70174889,GT,G,1
NC_037335.1,NC_032657.1,67041898,67041899,70238050,CA,C,1
NC_037335.1,NC_032657.1,67046591,67046592,70242974,GT,G,1
NC_037335.1,NC_032657.1,67120107,67120108,70318592,GT,G,1
NC_037335.1,NC_032657.1,67120134,67120135,70318618,TC,T,1
NC_037335.1,NC_032657.1,67315462,67315463,70561977,TC,T,1
NC_037335.1,NC_032657.1,67324906,67324936,70571421,GGCAATCACCAGAACACTAAGGGGTACATAT,G,30
NC_037335.1,NC_032657.1,67671784,67671785,70908701,TC,T,1
NC_037335.1,NC_032657.1,67683643,67683644,70920556,GT,G,1
NC_037335.1,NC_032657.1,67731233,67731234,70974043,CT,C,1
NC_037335.1,NC_032657.1,67742828,67742829,70985647,CT,C,1
NC_037335.1,NC_032657.1,67851773,67851774,71094648,CA,C,1
NC_037335.1,NC_032657.1,67925166,67925167,71168618,TG,T,1
NC_037335.1,NC_032657.1,68037951,68037952,71281421,GA,G,1
NC_037335.1,NC_032657.1,68147054,68147055,71391116,TA,T,1
NC_037335.1,NC_032657.1,68391818,68391819,71581306,TA,T,1
NC_037335.1,NC_032657.1,68647116,68647117,71823753,TG,T,1
NC_037335.1,NC_032657.1,68647141,68647142,71823776,CT,C,1
NC_037335.1,NC_032657.1,68649451,68649453,71826084,TTA,T,2
NC_037335.1,NC_032657.1,69052397,69052398,72260215,GT,G,1
NC_037335.1,NC_032657.1,69082906,69082907,72286585,CT,C,1
NC_037335.1,NC_032657.1,69089543,69089544,72293238,CA,C,1
NC_037335.1,NC_032657.1,69153106,69153107,72356797,CT,C,1
NC_037335.1,NC_032657.1,69216173,69216175,72419840,AAG,A,2
NC_037335.1,NC_032657.1,69235351,69235352,72437971,GA,G,1
NC_037335.1,NC_032657.1,69421184,69421221,72485768,GGTCTTCCTCCACCACCTTCCACCAAAAAAAGTTCTCA,G,37
NC_037335.1,NC_032657.1,69477155,69477156,72541714,GA,G,1
NC_037335.1,NC_032657.1,69477163,69477164,72541721,TC,T,1
NC_037335.1,NC_032657.1,69496067,69496085,72565300,GATTACAGACACTGATCAC,G,18
NC_037335.1,NC_032657.1,69629085,69629086,72812887,TC,T,1
NC_037335.1,NC_032657.1,69637450,69637451,72821263,AC,A,1
NC_037335.1,NC_032657.1,69742024,69742025,72861819,AC,A,1
NC_037335.1,NC_032657.1,69782932,69782933,72881857,TG,T,1
NC_037335.1,NC_032657.1,69900510,69900511,72999556,GA,G,1
NC_037335.1,NC_032657.1,69906674,69906675,73005719,GC,G,1
NC_037335.1,NC_032657.1,69910997,69910998,73010041,AT,A,1
NC_037335.1,NC_032657.1,69926380,69926381,73025419,GC,G,1
NC_037335.1,NC_032657.1,70079406,70079419,73178428,TGCAGCTCTGGATG,T,13
NC_037335.1,NC_032657.1,70303383,70303384,73264181,TG,T,1
NC_037335.1,NC_032657.1,70331176,70331177,73290898,CA,C,1
NC_037335.1,NC_032657.1,70345104,70345105,73425755,GT,G,1
NC_037335.1,NC_032657.1,70345154,70345157,73425807,TATA,T,3
NC_037335.1,NC_032657.1,70345237,70345238,73425887,AT,A,1
NC_037335.1,NC_032657.1,70345449,70345450,73426098,GA,G,1
NC_037335.1,NC_032657.1,70363322,70363325,73443929,GTAA,G,3
NC_037335.1,NC_032657.1,70546195,70546196,74090258,TA,T,1
NC_037335.1,NC_032657.1,70745100,70745101,74289770,AG,A,1
NC_037335.1,NC_032657.1,70758562,70758563,74303265,TC,T,1
NC_037335.1,NC_032657.1,70834720,70834721,74379206,CT,C,1
NC_037335.1,NC_032657.1,70864280,70864281,74408530,AC,A,1
NC_037335.1,NC_032657.1,70904352,70904353,74448471,GA,G,1
NC_037335.1,NC_032657.1,71232550,71232552,74824794,CTT,C,2
NC_037335.1,NC_032657.1,71294300,71294301,74886547,AT,A,1
NC_037335.1,NC_032657.1,71294314,71294315,74886560,AT,A,1
NC_037335.1,NC_032657.1,71505901,71505902,75082091,AG,A,1
NC_037335.1,NC_032657.1,71632477,71632480,75213381,AGCC,A,3
NC_037335.1,NC_032657.1,71840526,71840527,75441175,CG,C,1
NC_037335.1,NC_032657.1,71878512,71878513,75480778,AC,A,1
NC_037335.1,NC_032657.1,71882833,71882834,75485099,TG,T,1
NC_037335.1,NC_032657.1,71909449,71909450,75511760,AG,A,1
NC_037335.1,NC_032657.1,72004123,72004130,75606316,ACTATAAT,A,7
NC_037335.1,NC_032657.1,72007551,72007555,75609737,AACAG,A,4
NC_037335.1,NC_032657.1,72159189,72159190,75763170,AC,A,1
NC_037335.1,NC_032657.1,72159189,72159190,75955810,AC,A,1
NC_037335.1,NC_032657.1,72172504,72172505,75776488,TG,T,1
NC_037335.1,NC_032657.1,72232507,72232508,76029389,GT,G,1
NC_037335.1,NC_032657.1,72232532,72232533,76029413,AT,A,1
NC_037335.1,NC_032657.1,72448633,72448634,76257090,TC,T,1
NC_037335.1,NC_032657.1,72483346,72483347,76292986,TG,T,1
NC_037335.1,NC_032657.1,72826466,72826467,76638388,CT,C,1
NC_037335.1,NC_032657.1,73620870,73620871,77545213,GT,G,1
NC_037335.1,NC_032657.1,73795760,73795761,77720058,GC,G,1
NC_037335.1,NC_032657.1,73795794,73795795,77720091,GA,G,1
NC_037335.1,NC_032657.1,73844133,73844134,77768574,GA,G,1
NC_037335.1,NC_032657.1,73860757,73860811,77785234,GGGATAAGGCTGTGGTAAGGGGCGGTGGTCTCGTGGTGGTGGTCTCTGAGCGGTA,G,54
NC_037335.1,NC_032657.1,73949587,73949610,77873662,AGACAGTGGGTACCAGGAAAGGGG,A,23
NC_037335.1,NC_032657.1,73985255,73985256,77909328,CT,C,1
NC_037335.1,NC_032657.1,74099938,74099939,78013117,TG,T,1
NC_037335.1,NC_032657.1,74379901,74379902,78501693,TG,T,1
NC_037335.1,NC_032657.1,74379927,74379928,78501718,TG,T,1
NC_037335.1,NC_032657.1,74379940,74379941,78501730,AG,A,1
NC_037335.1,NC_032657.1,74465986,74465987,78587793,GT,G,1
NC_037335.1,NC_032657.1,74499104,74499106,78620955,CCT,C,2
NC_037335.1,NC_032657.1,74502880,74502910,78624729,GTTATAAAGTCAACAGTTATAAAGTCAACAA,G,30
NC_037335.1,NC_032657.1,74502914,74502915,78624733,CA,C,1
NC_037335.1,NC_032657.1,74554855,74554856,78676685,CT,C,1
NC_037335.1,NC_032657.1,74586074,74586075,78707650,AG,A,1
NC_037335.1,NC_032657.1,74662356,74662357,78781555,AT,A,1
NC_037335.1,NC_032657.1,74692505,74692512,78811906,TCAACTAA,T,7
NC_037335.1,NC_032657.1,74821048,74821050,78940535,AAG,A,2
NC_037335.1,NC_032657.1,74853700,74853701,78973822,TC,T,1
NC_037335.1,NC_032657.1,74926824,74926825,79047061,AG,A,1
NC_037335.1,NC_032657.1,75164015,75164017,79299583,AAT,A,2
NC_037335.1,NC_032657.1,75201326,75201327,79342608,TG,T,1
NC_037335.1,NC_032657.1,75272074,75272075,79415786,AG,A,1
NC_037335.1,NC_032657.1,75272162,75272163,79415873,AG,A,1
NC_037335.1,NC_032657.1,75272237,75272238,79415945,GT,G,1
NC_037335.1,NC_032657.1,75485811,75485812,79708096,CA,C,1
NC_037335.1,NC_032657.1,75581004,75581005,79800920,AG,A,1
NC_037335.1,NC_032657.1,75595211,75595212,79815125,AG,A,1
NC_037335.1,NC_032657.1,75595216,75595217,79815129,TA,T,1
NC_037335.1,NC_032657.1,75595222,75595223,79815134,CT,C,1
NC_037335.1,NC_032657.1,75595229,75595230,79815140,GT,G,1
NC_037335.1,NC_032657.1,75595238,75595239,79815148,GT,G,1
NC_037335.1,NC_032657.1,75595276,75595277,79815184,TC,T,1
NC_037335.1,NC_032657.1,75889611,75889612,80110010,GA,G,1
NC_037335.1,NC_032657.1,75943618,75943619,80164234,GC,G,1
NC_037335.1,NC_032657.1,75981749,75981750,80202169,TA,T,1
NC_037335.1,NC_032657.1,75992362,75992364,80212791,CCA,C,2
NC_037335.1,NC_032657.1,76509555,76509556,80730568,AG,A,1
NC_037335.1,NC_032657.1,76526882,76526883,80747894,AG,A,1
NC_037335.1,NC_032657.1,76526886,76526887,80747897,TC,T,1
NC_037335.1,NC_032657.1,76543827,76543828,80764838,TC,T,1
NC_037335.1,NC_032657.1,76546414,76546415,80767412,GC,G,1
NC_037335.1,NC_032657.1,76547908,76547915,80768902,TGAAAATA,T,7
NC_037335.1,NC_032657.1,76556967,76556968,80777926,AG,A,1
NC_037335.1,NC_032657.1,76557017,76557019,80777974,CCT,C,2
NC_037335.1,NC_032657.1,76557063,76557065,80778017,AAG,A,2
NC_037335.1,NC_032657.1,76665273,76665276,80886565,CCTT,C,3
NC_037335.1,NC_032657.1,76665655,76665656,80886944,TG,T,1
NC_037335.1,NC_032657.1,76666171,76666175,80887461,AGTTC,A,4
NC_037335.1,NC_032657.1,77279819,77279821,81471614,TTA,T,2
NC_037335.1,NC_032657.1,77452634,77452635,81643700,GC,G,1
NC_037335.1,NC_032657.1,77492748,77492749,81683686,GT,G,1
NC_037335.1,NC_032657.1,77886348,77886355,82033024,ACTGTTTT,A,7
NC_037335.1,NC_032657.1,77886359,77886366,82033028,AAAATCCT,A,7
NC_037335.1,NC_032657.1,78109516,78109517,82315466,AT,A,1
NC_037335.1,NC_032657.1,78109528,78109529,82315477,TC,T,1
NC_037335.1,NC_032657.1,78109540,78109541,82315488,TC,T,1
NC_037335.1,NC_032657.1,78156378,78156381,82375192,TCCC,T,3
NC_037335.1,NC_032657.1,78224268,78224270,82443144,TTC,T,2
NC_037335.1,NC_032657.1,78285119,78285120,82503994,GC,G,1
NC_037335.1,NC_032657.1,78447759,78447768,82669481,TGAGGGCCGG,T,9
NC_037335.1,NC_032657.1,78602078,78602083,82762828,TATTTG,T,5
NC_037335.1,NC_032657.1,78763745,78763746,82888334,CT,C,1
NC_037335.1,NC_032657.1,78795248,78795249,82919891,CT,C,1
NC_037335.1,NC_032657.1,78857196,78857198,82982757,TTA,T,2
NC_037335.1,NC_032657.1,78857219,78857220,82982778,GT,G,1
NC_037335.1,NC_032657.1,79025671,79025672,83152799,AG,A,1
NC_037335.1,NC_032657.1,79743737,79743743,83917402,GCTCCTT,G,6
NC_037335.1,NC_032657.1,80248103,80248104,84474639,CA,C,1
NC_037335.1,NC_032657.1,80349009,80349010,84638820,CT,C,1
NC_037335.1,NC_032657.1,80591780,80591782,84899499,AGG,A,2
NC_037335.1,NC_032657.1,80859089,80859105,85198492,GCGGCAGAAATGCCCTC,G,16
NC_037335.1,NC_032657.1,80888998,80888999,85228400,AG,A,1
NC_037335.1,NC_032657.1,80892686,80892687,85232088,CA,C,1
NC_037335.1,NC_032657.1,81112583,81112586,85452698,TATC,T,3
NC_037335.1,NC_032657.1,81116758,81116759,85456881,AG,A,1
NC_037335.1,NC_032657.1,81454473,81454474,85794522,GC,G,1
NC_037335.1,NC_032657.1,81593951,81593952,85937446,TG,T,1
NC_037335.1,NC_032657.1,81722160,81722161,86065617,TC,T,1
NC_037335.1,NC_032657.1,81747148,81747149,86092540,TC,T,1
NC_037335.1,NC_032657.1,82078598,82078599,86526463,AG,A,1
NC_037335.1,NC_032657.1,82078617,82078618,86526481,TA,T,1
NC_037335.1,NC_032657.1,82235584,82235585,86693623,TA,T,1
NC_037335.1,NC_032657.1,82235594,82235595,86693632,AG,A,1
NC_037335.1,NC_032657.1,82235627,82235628,86693663,GT,G,1
NC_037335.1,NC_032657.1,82654520,82654522,86828089,AAG,A,2
NC_037335.1,NC_032657.1,82668830,82668831,86842398,AT,A,1
NC_037335.1,NC_032657.1,82747699,82747700,86921299,TA,T,1
NC_037335.1,NC_032657.1,82925593,82925594,87102320,CT,C,1
NC_037335.1,NC_032657.1,82929262,82929263,87105995,CT,C,1
NC_037335.1,NC_032657.1,83036955,83036956,87213306,AT,A,1
NC_037335.1,NC_032657.1,83041312,83041313,87217662,GA,G,1
NC_037335.1,NC_032657.1,83178817,83178818,87355909,AC,A,1
NC_037335.1,NC_032657.1,83308786,83308787,87485872,GT,G,1
NC_037335.1,NC_032657.1,83836973,83836974,88003838,TA,T,1
NC_037335.1,NC_032657.1,84510563,84510564,88681487,GC,G,1
NC_037335.1,NC_032657.1,84693119,84693120,88864162,CT,C,1
NC_037335.1,NC_032657.1,84776667,84776668,88961132,CT,C,1
NC_037335.1,NC_032657.1,85255395,85255396,89545697,TG,T,1
NC_037335.1,NC_032657.1,85292770,85292771,89583038,TG,T,1
NC_037335.1,NC_032657.1,85308901,85308902,89599315,GA,G,1
NC_037335.1,NC_032657.1,85580740,85580741,89852181,CA,C,1
NC_037335.1,NC_032657.1,85631564,85631566,89903616,ATT,A,2
NC_037335.1,NC_032657.1,86006929,86006933,90291375,ACTGT,A,4
NC_037335.1,NC_032657.1,86013488,86013489,90297931,CA,C,1
NC_037335.1,NC_032657.1,86015502,86015504,90299946,ACG,A,2
NC_037335.1,NC_032657.1,86500963,86500966,90804357,ATTG,A,3
NC_037335.1,NC_032657.1,86617861,86617862,90933859,TC,T,1
NC_037335.1,NC_032657.1,86792075,86792076,91098231,CT,C,1
NC_037335.1,NC_032657.1,86864936,86864941,91171058,CAATAT,C,5
NC_037335.1,NC_032657.1,86927438,86927439,91233503,GC,G,1
NC_037335.1,NC_032657.1,86931897,86931898,91237961,CA,C,1
NC_037335.1,NC_032657.1,86955662,86955663,91261886,AT,A,1
NC_037335.1,NC_032657.1,87067935,87067970,91374163,CAAACTATATTGCAGTGGGGATACTAGTTCTACTCT,C,35
NC_037335.1,NC_032657.1,87261780,87261781,91585417,GT,G,1
NC_037335.1,NC_032657.1,87268186,87268187,91591833,GA,G,1
NC_037335.1,NC_032657.1,87268217,87268218,91591861,AT,A,1
NC_037335.1,NC_032657.1,87515534,87515535,91876975,TC,T,1
NC_037335.1,NC_032657.1,87517445,87517446,91878885,TG,T,1
NC_037335.1,NC_032657.1,87591821,87591822,91973600,TA,T,1
NC_037335.1,NC_032657.1,87674162,87674163,92056452,GC,G,1
NC_037335.1,NC_032657.1,87811334,87811336,92485004,TTG,T,2
NC_037335.1,NC_032657.1,87825034,87825035,92498701,CT,C,1
NC_037335.1,NC_032657.1,88051543,88051546,92640403,AGTC,A,3
NC_037335.1,NC_032657.1,88053151,88053152,92642010,CT,C,1
NC_037335.1,NC_032657.1,88079032,88079033,92669466,AG,A,1
NC_037335.1,NC_032657.1,88079267,88079268,92669700,CA,C,1
NC_037335.1,NC_032657.1,88136713,88136714,92727104,GA,G,1
NC_037335.1,NC_032657.1,88137307,88137308,92727697,TA,T,1
NC_037335.1,NC_032657.1,88137926,88137932,92728320,TCCCCAC,T,6
NC_037335.1,NC_032657.1,88138113,88138114,92728502,CA,C,1
NC_037335.1,NC_032657.1,88221173,88221174,92865537,TC,T,1
NC_037335.1,NC_032657.1,88228460,88228461,92872825,CT,C,1
NC_037335.1,NC_032657.1,88422365,88422366,93014530,AT,A,1
NC_037335.1,NC_032657.1,89072626,89072627,93847820,AT,A,1
NC_037335.1,NC_032657.1,89774190,89774191,94571742,TG,T,1
NC_037335.1,NC_032657.1,90055882,90055883,94861225,AG,A,1
NC_037335.1,NC_032657.1,90055896,90055897,94861238,AT,A,1
NC_037335.1,NC_032657.1,90896959,90896963,95723111,TACTA,T,4
NC_037335.1,NC_032657.1,90975430,90975431,95802522,CT,C,1
NC_037335.1,NC_032657.1,90994616,90994617,95821716,CG,C,1
NC_037335.1,NC_032657.1,91308738,91308739,96131597,AC,A,1
NC_037335.1,NC_032657.1,91308744,91308745,96131602,GA,G,1
NC_037335.1,NC_032657.1,91384636,91384641,96207513,TGTGGA,T,5
NC_037335.1,NC_032657.1,91438029,91438030,96260852,CA,C,1
NC_037335.1,NC_032657.1,91725496,91725497,96527154,TA,T,1
NC_037335.1,NC_032657.1,91725581,91725582,96527238,TC,T,1
NC_037335.1,NC_032657.1,91818725,91818727,96624026,CTT,C,2
NC_037335.1,NC_032657.1,91827125,91827127,96632425,CTT,C,2
NC_037335.1,NC_032657.1,91831606,91831608,96636907,ATG,A,2
NC_037335.1,NC_032657.1,91832690,91832692,96637989,TTA,T,2
NC_037335.1,NC_032657.1,91983961,91983963,96789390,TAA,T,2
NC_037335.1,NC_032657.1,92003559,92003560,96808996,TG,T,1
NC_037335.1,NC_032657.1,92011889,92011890,96816669,AG,A,1
NC_037335.1,NC_032657.1,92014436,92014437,96819216,TA,T,1
NC_037335.1,NC_032657.1,92034379,92034425,96839154,ATACCAAAGTTTTCTTAGGTTATTCTATCATTTTCTGACACAAATTG,A,46
NC_037335.1,NC_032657.1,92040357,92040359,96845091,TAA,T,2
NC_037335.1,NC_032657.1,92168677,92168678,97010662,GC,G,1
NC_037335.1,NC_032657.1,92170517,92170519,97012501,ACT,A,2
NC_037335.1,NC_032657.1,92186774,92186775,97028770,CA,C,1
NC_037335.1,NC_032657.1,92338128,92338129,97179971,AG,A,1
NC_037335.1,NC_032657.1,92520021,92520023,97373102,TTG,T,2
NC_037335.1,NC_032657.1,92918865,92918866,97818174,TC,T,1
NC_037335.1,NC_032657.1,92927415,92927416,97826851,GT,G,1
NC_037335.1,NC_032657.1,92927428,92927429,97826863,AC,A,1
NC_037335.1,NC_032657.1,93034004,93034006,97935767,CTT,C,2
NC_037335.1,NC_032657.1,93156226,93156227,98061871,AC,A,1
NC_037335.1,NC_032657.1,93188621,93188648,98118407,AAAAAATTAGTTGAAGATGGTTTTAAGG,A,27
NC_037335.1,NC_032657.1,93293100,93293101,98225413,AT,A,1
NC_037335.1,NC_032657.1,93293114,93293115,98225426,CT,C,1
NC_037335.1,NC_032657.1,93293120,93293121,98225431,GC,G,1
NC_037335.1,NC_032657.1,93293189,93293190,98225498,CT,C,1
NC_037335.1,NC_032657.1,93302014,93302015,98234327,TA,T,1
NC_037335.1,NC_032657.1,93477033,93477034,98409505,CT,C,1
NC_037335.1,NC_032657.1,93566626,93566637,98500619,GCTGCCTACTCT,G,11
NC_037335.1,NC_032657.1,93566639,93566645,98500621,AACCACT,A,6
NC_037335.1,NC_032657.1,93584666,93584667,98518677,TG,T,1
NC_037335.1,NC_032657.1,94704750,94704751,99479410,TG,T,1
NC_037335.1,NC_032657.1,94731290,94731291,99505958,AC,A,1
NC_037335.1,NC_032657.1,94788776,94788777,99563196,TA,T,1
NC_037335.1,NC_032657.1,94788830,94788831,99563248,AT,A,1
NC_037335.1,NC_032657.1,94788838,94788840,99563255,TTA,T,2
NC_037335.1,NC_032657.1,94788868,94788869,99563281,TA,T,1
NC_037335.1,NC_032657.1,94788915,94788916,99563325,AT,A,1
NC_037335.1,NC_032657.1,94888395,94888399,99663485,CAACG,C,4
NC_037335.1,NC_032657.1,95172939,95172940,99953449,GA,G,1
NC_037335.1,NC_032657.1,95172950,95172951,99953459,CA,C,1
NC_037335.1,NC_032657.1,95356272,95356273,100159760,TG,T,1
NC_037335.1,NC_032657.1,95787649,95787650,100793256,CT,C,1
NC_037335.1,NC_032657.1,95797463,95797464,100803062,AC,A,1
NC_037335.1,NC_032657.1,95798850,95798851,100804448,GA,G,1
NC_037335.1,NC_032657.1,95811558,95811559,100817160,TG,T,1
NC_037335.1,NC_032657.1,96241966,96241967,101346208,AC,A,1
NC_037335.1,NC_032657.1,96997414,96997415,102097573,TG,T,1
NC_037335.1,NC_032657.1,96997430,96997431,102097588,AT,A,1
NC_037335.1,NC_032657.1,97770378,97770380,102869706,GTA,G,2
NC_037335.1,NC_032657.1,97854979,97854980,102952176,AT,A,1
NC_037335.1,NC_032657.1,97932007,97932008,103030391,TG,T,1
NC_037335.1,NC_032657.1,98090027,98090028,103164389,TA,T,1
NC_037335.1,NC_032657.1,98140786,98140787,103195058,AG,A,1
NC_037335.1,NC_032657.1,98315592,98315593,103369743,CT,C,1
NC_037335.1,NC_032657.1,98503005,98503006,103556931,AG,A,1
NC_037335.1,NC_032657.1,98839227,98839228,103892953,TC,T,1
NC_037335.1,NC_032657.1,98842877,98842879,103896601,CCT,C,2
NC_037335.1,NC_032657.1,99118209,99118210,104185740,CG,C,1
NC_037335.1,NC_032657.1,99294230,99294231,104328061,TG,T,1
NC_037335.1,NC_032657.1,99324562,99324563,104358397,GT,G,1
NC_037335.1,NC_032657.1,99329526,99329530,104363230,AGTAT,A,4
NC_037335.1,NC_032657.1,99366300,99366301,104399994,CT,C,1
NC_037335.1,NC_032657.1,99374833,99374834,104408526,GT,G,1
NC_037335.1,NC_032657.1,99438887,99438888,104472389,TC,T,1
NC_037335.1,NC_032657.1,99524026,99524027,104558021,AC,A,1
NC_037335.1,NC_032657.1,99586352,99586354,104627188,TTC,T,2
NC_037335.1,NC_032657.1,99694213,99694214,104735157,TC,T,1
NC_037335.1,NC_032657.1,99699945,99699946,104740880,AG,A,1
NC_037335.1,NC_032657.1,99939185,99939188,104978761,ATGT,A,3
NC_037335.1,NC_032657.1,100048777,100048778,105085598,CG,C,1
NC_037335.1,NC_032657.1,100175529,100175539,105206488,CAAATGACAGA,C,10
NC_037335.1,NC_032657.1,100325698,100325699,105356509,GT,G,1
NC_037335.1,NC_032657.1,100328997,100328998,105359820,AC,A,1
NC_037335.1,NC_032657.1,100333780,100333781,105364603,TC,T,1
NC_037335.1,NC_032657.1,100601281,100601285,105767828,CAGTT,C,4
NC_037335.1,NC_032657.1,100601287,100601293,105767830,ACTTCTT,A,6
NC_037335.1,NC_032657.1,100685751,100685752,105900663,GT,G,1
NC_037335.1,NC_032657.1,100685772,100685773,105900683,CT,C,1
NC_037335.1,NC_032657.1,100703315,100703316,105917785,AG,A,1
NC_037335.1,NC_032657.1,100715109,100715110,105929595,TG,T,1
NC_037335.1,NC_032657.1,100715709,100715711,105930208,GCC,G,2
NC_037335.1,NC_032657.1,100718976,100718977,105933480,AC,A,1
NC_037335.1,NC_032657.1,100719041,100719046,105933544,TCACAG,T,5
NC_037335.1,NC_032657.1,100725657,100725659,105940177,CTA,C,2
NC_037335.1,NC_032657.1,100811618,100811619,106026664,CT,C,1
NC_037335.1,NC_032657.1,100812826,100812828,106027871,GGA,G,2
NC_037335.1,NC_032657.1,100812856,100812858,106027898,AAC,A,2
NC_037335.1,NC_032657.1,101285764,101285765,106467050,GC,G,1
NC_037335.1,NC_032657.1,101300175,101300180,106481440,TGGGAA,T,5
NC_037335.1,NC_032657.1,101300302,101300303,106481562,TG,T,1
NC_037335.1,NC_032657.1,101608089,101608090,106779429,GC,G,1
NC_037335.1,NC_032657.1,101717269,101717270,106889218,CA,C,1
NC_037335.1,NC_032657.1,101717316,101717317,106889263,TC,T,1
NC_037335.1,NC_032657.1,101836364,101836365,107009922,AG,A,1
NC_037335.1,NC_032657.1,101999199,101999200,107172713,GC,G,1
NC_037335.1,NC_032657.1,102286394,102286395,107577595,AT,A,1
NC_037335.1,NC_032657.1,102306571,102306572,107597862,AG,A,1
NC_037335.1,NC_032657.1,102312134,102312135,107603442,TC,T,1
NC_037335.1,NC_032657.1,102412016,102412017,107732551,TG,T,1
NC_037335.1,NC_032657.1,102449681,102449682,107770239,GC,G,1
NC_037335.1,NC_032657.1,102547176,102547177,107867757,CT,C,1
NC_037335.1,NC_032657.1,102620957,102620963,107939015,TGATGTC,T,6
NC_037335.1,NC_032657.1,102632274,102632275,107950342,GA,G,1
NC_037335.1,NC_032657.1,102749677,102749698,108067874,CTTTGGCAGGCTGCCTCCCCCT,C,21
NC_037335.1,NC_032657.1,102769443,102769444,108087612,CA,C,1
NC_037335.1,NC_032657.1,102921864,102921865,108240426,TC,T,1
NC_037335.1,NC_032657.1,102921877,102921879,108240438,CCA,C,2
NC_037335.1,NC_032657.1,102921885,102921886,108240444,TC,T,1
NC_037335.1,NC_032657.1,103252288,103252289,108574740,CA,C,1
NC_037335.1,NC_032657.1,103418366,103418367,108743750,GC,G,1
NC_037335.1,NC_032657.1,103736593,103736594,109061427,TA,T,1
NC_037335.1,NC_032657.1,103736727,103736732,109061560,GGGTGT,G,5
NC_037335.1,NC_032657.1,103742811,103742812,109067641,CT,C,1
NC_037335.1,NC_032657.1,104005280,104005281,109332382,TC,T,1
NC_037335.1,NC_032657.1,104235297,104235298,109615337,CA,C,1
NC_037335.1,NC_032657.1,104401136,104401141,109795314,TTTAGG,T,5
NC_037335.1,NC_032657.1,104428986,104428987,109823166,TA,T,1
NC_037335.1,NC_032657.1,104642751,104642752,110037530,AC,A,1
NC_037335.1,NC_032657.1,105088770,105088771,110477319,AT,A,1
NC_037335.1,NC_032657.1,105088788,105088789,110477336,CT,C,1
NC_037335.1,NC_032657.1,105088795,105088796,110477342,CT,C,1
NC_037335.1,NC_032657.1,105235839,105235840,110624823,TA,T,1
NC_037335.1,NC_032657.1,105235888,105235889,110624870,TC,T,1
NC_037335.1,NC_032657.1,105335883,105335894,110705512,TTGATTGAAGAA,T,11
NC_037335.1,NC_032657.1,105491929,105491930,110861433,GA,G,1
NC_037335.1,NC_032657.1,105604041,105604042,110973087,CA,C,1
NC_037335.1,NC_032657.1,105617228,105617230,110985495,TTA,T,2
NC_037335.1,NC_032657.1,105617312,105617313,110985576,TC,T,1
NC_037335.1,NC_032657.1,106249996,106249997,111610134,AT,A,1
NC_037335.1,NC_032657.1,106976456,106976457,112343872,AC,A,1
NC_037335.1,NC_032657.1,107040588,107040589,112408050,TC,T,1
NC_037335.1,NC_032657.1,107240830,107240831,112608042,GC,G,1
NC_037335.1,NC_032657.1,107468579,107468580,112838224,TG,T,1
NC_037335.1,NC_032657.1,107500058,107500059,112869783,CT,C,1
NC_037335.1,NC_032657.1,107810585,107810586,113185363,GA,G,1
NC_037335.1,NC_032657.1,108208362,108208363,113589575,TG,T,1
NC_037335.1,NC_032657.1,108514120,108514121,113921052,AG,A,1
NC_037335.1,NC_032657.1,108514132,108514133,113921063,CA,C,1
NC_037335.1,NC_032657.1,108651890,108651891,114065972,AC,A,1
NC_037335.1,NC_032657.1,108663664,108663665,114077780,AC,A,1
NC_037335.1,NC_032657.1,108794392,108794393,114207588,CA,C,1
NC_037335.1,NC_032657.1,108794400,108794401,114207595,GC,G,1
NC_037335.1,NC_032657.1,108981069,108981070,114437164,CT,C,1
NC_037335.1,NC_032657.1,109396889,109396890,114885882,CG,C,1
NC_037335.1,NC_032657.1,109501718,109501719,114991627,AT,A,1
NC_037335.1,NC_032657.1,109501741,109501742,114991649,TG,T,1
NC_037335.1,NC_032657.1,109817048,109817049,115151502,TA,T,1
NC_037335.1,NC_032657.1,109838810,109838811,115173119,CG,C,1
NC_037335.1,NC_032657.1,109849756,109849757,115183942,CG,C,1
NC_037335.1,NC_032657.1,109862203,109862204,115195774,AC,A,1
NC_037335.1,NC_032657.1,109868662,109868663,115202260,CA,C,1
NC_037335.1,NC_032657.1,109883713,109883714,115217312,CG,C,1
NC_037335.1,NC_032657.1,109883725,109883726,115217323,CG,C,1
NC_037335.1,NC_032657.1,110028118,110028119,115361416,AC,A,1
NC_037335.1,NC_032657.1,110063420,110063421,115396721,TC,T,1
NC_037335.1,NC_032657.1,110095703,110095704,115429021,GA,G,1
NC_037335.1,NC_032657.1,110130952,110130953,115464155,TG,T,1
NC_037335.1,NC_032657.1,110190841,110190842,115571473,GA,G,1
NC_037335.1,NC_032657.1,110190880,110190881,115571511,GA,G,1
NC_037335.1,NC_032657.1,110407499,110407500,115792236,AG,A,1
NC_037335.1,NC_032657.1,110505528,110505531,115890336,CCAG,C,3
NC_037335.1,NC_032657.1,110735305,110735306,116131280,TG,T,1
NC_037335.1,NC_032657.1,110828922,110828923,116196240,AC,A,1
NC_037335.1,NC_032657.1,110923004,110923006,116335029,AAG,A,2
NC_037335.1,NC_032657.1,110950520,110950521,116362547,GA,G,1
NC_037335.1,NC_032657.1,111028275,111028276,116479727,AT,A,1
NC_037335.1,NC_032657.1,111028281,111028282,116479732,AG,A,1
NC_037335.1,NC_032657.1,111103778,111103779,116555631,CG,C,1
NC_037335.1,NC_032657.1,111118048,111118049,116569900,AG,A,1
NC_037335.1,NC_032657.1,111129001,111129002,116580864,TC,T,1
NC_037335.1,NC_032657.1,111134534,111134539,116586390,CACTGG,C,5
NC_037335.1,NC_032657.1,111222073,111222089,116673239,CCTTACACAGCATCACT,C,16
NC_037335.1,NC_032657.1,111299443,111299444,116750514,AG,A,1
NC_037335.1,NC_032657.1,111304766,111304767,116755838,TA,T,1
NC_037335.1,NC_032657.1,111306071,111306072,116757167,AG,A,1
NC_037335.1,NC_032657.1,111307917,111307919,116759013,ACG,A,2
NC_037335.1,NC_032657.1,111317107,111317108,116767665,CG,C,1
NC_037335.1,NC_032657.1,111322477,111322479,116773068,CAA,C,2
NC_037335.1,NC_032657.1,111323332,111323333,116773921,AC,A,1
NC_037335.1,NC_032657.1,111429748,111429749,116906358,TG,T,1
