Reference ID,Query ID,Reference POS,Reference END,Query POS,REF,ALT,SVLEN
NC_037354.1,NC_032676.1,1007162,1007163,671212,CT,C,1
NC_037354.1,NC_032676.1,1050003,1050029,714043,AATCTCTCCCCATGCTCTGTGTCCACG,A,26
NC_037354.1,NC_032676.1,1076325,1076326,740307,AG,A,1
NC_037354.1,NC_032676.1,1111333,1111334,775342,AC,A,1
NC_037354.1,NC_032676.1,1113154,1113155,777158,TC,T,1
NC_037354.1,NC_032676.1,1114031,1114032,778034,AT,A,1
NC_037354.1,NC_032676.1,1119038,1119039,783043,CT,C,1
NC_037354.1,NC_032676.1,1119214,1119215,783221,CT,C,1
NC_037354.1,NC_032676.1,1119226,1119227,783232,TG,T,1
NC_037354.1,NC_032676.1,1123420,1123421,787443,GC,G,1
NC_037354.1,NC_032676.1,1123574,1123575,787599,AC,A,1
NC_037354.1,NC_032676.1,1123587,1123588,787611,TG,T,1
NC_037354.1,NC_032676.1,1153792,1153793,817841,CT,C,1
NC_037354.1,NC_032676.1,1158643,1158645,822694,TGA,T,2
NC_037354.1,NC_032676.1,1189728,1189729,853764,GC,G,1
NC_037354.1,NC_032676.1,1239313,1239314,1095357,GC,G,1
NC_037354.1,NC_032676.1,1239540,1239541,1095583,CG,C,1
NC_037354.1,NC_032676.1,1289920,1289921,1146059,AG,A,1
NC_037354.1,NC_032676.1,1305815,1305816,937732,TG,T,1
NC_037354.1,NC_032676.1,1317618,1317624,948797,TGAGACA,T,6
NC_037354.1,NC_032676.1,1317910,1317911,949083,CA,C,1
NC_037354.1,NC_032676.1,1318027,1318028,949199,CT,C,1
NC_037354.1,NC_032676.1,1318070,1318071,949241,AT,A,1
NC_037354.1,NC_032676.1,1320679,1320680,951849,TA,T,1
NC_037354.1,NC_032676.1,1330740,1330741,964781,CA,C,1
NC_037354.1,NC_032676.1,1498409,1498410,1442331,AC,A,1
NC_037354.1,NC_032676.1,1502783,1502784,1446704,TG,T,1
NC_037354.1,NC_032676.1,1569359,1569360,1512818,AG,A,1
NC_037354.1,NC_032676.1,1569430,1569432,1512886,GGA,G,2
NC_037354.1,NC_032676.1,1856068,1856069,1814884,CA,C,1
NC_037354.1,NC_032676.1,2123713,2123714,2082149,GT,G,1
NC_037354.1,NC_032676.1,2151515,2151516,2109955,CT,C,1
NC_037354.1,NC_032676.1,2205226,2205236,2163804,AATGAAGCAAC,A,10
NC_037354.1,NC_032676.1,2389656,2389663,2348950,GCAGTCAA,G,7
NC_037354.1,NC_032676.1,2390899,2390900,2350186,TG,T,1
NC_037354.1,NC_032676.1,2711974,2711975,2665999,CT,C,1
NC_037354.1,NC_032676.1,2711984,2711985,2666008,CT,C,1
NC_037354.1,NC_032676.1,2724491,2724505,2678675,CCTGCGCAAATGAGT,C,14
NC_037354.1,NC_032676.1,2841818,2841819,2795412,TA,T,1
NC_037354.1,NC_032676.1,2841848,2841849,2795441,CT,C,1
NC_037354.1,NC_032676.1,2841871,2841872,2795462,GA,G,1
NC_037354.1,NC_032676.1,3241003,3241004,3230420,GT,G,1
NC_037354.1,NC_032676.1,3801217,3801218,3758036,AG,A,1
NC_037354.1,NC_032676.1,3908541,3908545,3886502,AGGCT,A,4
NC_037354.1,NC_032676.1,3908550,3908560,3886507,CCAACTAACTG,C,10
NC_037354.1,NC_032676.1,3908615,3908616,3886562,AC,A,1
NC_037354.1,NC_032676.1,4531304,4531305,4575370,CG,C,1
NC_037354.1,NC_032676.1,5364266,5364267,5406211,GT,G,1
NC_037354.1,NC_032676.1,5364293,5364294,5406236,CA,C,1
NC_037354.1,NC_032676.1,5968636,5968643,6083091,GCTCCTCC,G,7
NC_037354.1,NC_032676.1,5968981,5968982,6083434,CT,C,1
NC_037354.1,NC_032676.1,6296655,6296656,6477392,TC,T,1
NC_037354.1,NC_032676.1,6314257,6314258,6495061,CT,C,1
NC_037354.1,NC_032676.1,6315476,6315477,6496274,GC,G,1
NC_037354.1,NC_032676.1,6316262,6316263,6497059,CA,C,1
NC_037354.1,NC_032676.1,6316279,6316284,6497075,TTAAAG,T,5
NC_037354.1,NC_032676.1,6316877,6316879,6497667,GGA,G,2
NC_037354.1,NC_032676.1,6351432,6351434,6532205,CTG,C,2
NC_037354.1,NC_032676.1,6352483,6352484,6533255,GC,G,1
NC_037354.1,NC_032676.1,6354980,6354981,6535721,AG,A,1
NC_037354.1,NC_032676.1,6382850,6382851,6641071,CA,C,1
NC_037354.1,NC_032676.1,6502382,6502383,6718964,CA,C,1
NC_037354.1,NC_032676.1,6517308,6517309,6733890,GT,G,1
NC_037354.1,NC_032676.1,6517782,6517783,6734363,AG,A,1
NC_037354.1,NC_032676.1,6518107,6518109,6734689,GAT,G,2
NC_037354.1,NC_032676.1,6519691,6519693,6736272,TGG,T,2
NC_037354.1,NC_032676.1,6525916,6525917,6742496,CA,C,1
NC_037354.1,NC_032676.1,6529457,6529458,6746036,AG,A,1
NC_037354.1,NC_032676.1,6590410,6590411,6776520,CT,C,1
NC_037354.1,NC_032676.1,6591203,6591204,6777312,AG,A,1
NC_037354.1,NC_032676.1,6591506,6591507,6777614,GT,G,1
NC_037354.1,NC_032676.1,6594289,6594293,6780425,CTACA,C,4
NC_037354.1,NC_032676.1,6752437,6752439,7300756,TAA,T,2
NC_037354.1,NC_032676.1,6752870,6752871,7300324,GC,G,1
NC_037354.1,NC_032676.1,6769013,6769014,7284218,AC,A,1
NC_037354.1,NC_032676.1,6769056,6769057,7284176,TG,T,1
NC_037354.1,NC_032676.1,7232928,7232936,7947144,TGAGTCTCC,T,8
NC_037354.1,NC_032676.1,7722248,7722249,8439389,AG,A,1
NC_037354.1,NC_032676.1,7880757,7880758,8610350,GA,G,1
NC_037354.1,NC_032676.1,7945085,7945086,8674548,TA,T,1
NC_037354.1,NC_032676.1,8654706,8654707,9433200,AG,A,1
NC_037354.1,NC_032676.1,8774884,8774892,9553407,TAATAACCA,T,8
NC_037354.1,NC_032676.1,9117264,9117265,9895714,CA,C,1
NC_037354.1,NC_032676.1,9148218,9148219,9926698,GA,G,1
NC_037354.1,NC_032676.1,9148237,9148238,9926715,TA,T,1
NC_037354.1,NC_032676.1,9148247,9148248,9926724,AG,A,1
NC_037354.1,NC_032676.1,9285944,9285947,10063686,TTCC,T,3
NC_037354.1,NC_032676.1,9495195,9495238,10272542,CCATCCCATATGATTAGAATTTTACCCTTAGGCCTTCATCCAAT,C,43
NC_037354.1,NC_032676.1,9520212,9520213,10298441,GC,G,1
NC_037354.1,NC_032676.1,9697784,9697785,10464917,CT,C,1
NC_037354.1,NC_032676.1,9785632,9785633,10556147,GT,G,1
NC_037354.1,NC_032676.1,9834749,9834751,10605297,TAA,T,2
NC_037354.1,NC_032676.1,9860403,9860412,10631012,AATGCACTGG,A,9
NC_037354.1,NC_032676.1,9927872,9927873,10701856,TA,T,1
NC_037354.1,NC_032676.1,9942418,9942428,10716373,ATGGAATCTTG,A,10
NC_037354.1,NC_032676.1,9972877,9972878,10746854,GA,G,1
NC_037354.1,NC_032676.1,10048344,10048346,10821313,GAA,G,2
NC_037354.1,NC_032676.1,10101783,10101784,10953363,CT,C,1
NC_037354.1,NC_032676.1,10503397,10503400,11335047,ATAG,A,3
NC_037354.1,NC_032676.1,10573139,10573140,11404783,AC,A,1
NC_037354.1,NC_032676.1,10678516,10678517,11510165,CT,C,1
NC_037354.1,NC_032676.1,10752319,10752320,11683368,GC,G,1
NC_037354.1,NC_032676.1,10903537,10903539,11847583,CAT,C,2
NC_037354.1,NC_032676.1,10906278,10906284,11850321,TCATGGA,T,6
NC_037354.1,NC_032676.1,10920918,10920919,11864981,TG,T,1
NC_037354.1,NC_032676.1,10928980,10928982,11873048,TAA,T,2
NC_037354.1,NC_032676.1,11175731,11175732,12267974,CT,C,1
NC_037354.1,NC_032676.1,11177127,11177128,12269226,TC,T,1
NC_037354.1,NC_032676.1,11177167,11177168,12269265,AG,A,1
NC_037354.1,NC_032676.1,11232244,11232245,12324357,GA,G,1
NC_037354.1,NC_032676.1,11572950,11572951,12666065,GT,G,1
NC_037354.1,NC_032676.1,11589368,11589369,12682445,AG,A,1
NC_037354.1,NC_032676.1,11589373,11589374,12682449,CT,C,1
NC_037354.1,NC_032676.1,11774085,11774086,12867046,TA,T,1
NC_037354.1,NC_032676.1,11776979,11776980,12870382,TG,T,1
NC_037354.1,NC_032676.1,11779101,11779102,12872502,CT,C,1
NC_037354.1,NC_032676.1,11779111,11779112,12872511,CT,C,1
NC_037354.1,NC_032676.1,11779119,11779120,12872518,CT,C,1
NC_037354.1,NC_032676.1,11779124,11779126,12872522,TTA,T,2
NC_037354.1,NC_032676.1,11779139,11779140,12872535,CA,C,1
NC_037354.1,NC_032676.1,11863886,11863887,12957909,AT,A,1
NC_037354.1,NC_032676.1,11863928,11863929,12957950,CA,C,1
NC_037354.1,NC_032676.1,11863971,11863972,12957991,AT,A,1
NC_037354.1,NC_032676.1,11997420,11997422,13091889,TTA,T,2
NC_037354.1,NC_032676.1,12101537,12101538,13196039,CG,C,1
NC_037354.1,NC_032676.1,12194912,12194913,13289523,CT,C,1
NC_037354.1,NC_032676.1,12347691,12347692,13478695,TC,T,1
NC_037354.1,NC_032676.1,12433355,12433356,13565520,CA,C,1
NC_037354.1,NC_032676.1,12759117,12759118,13955480,AG,A,1
NC_037354.1,NC_032676.1,12961656,12961657,14157964,AT,A,1
NC_037354.1,NC_032676.1,13079798,13079799,14332637,AC,A,1
NC_037354.1,NC_032676.1,13244081,13244082,14496881,CT,C,1
NC_037354.1,NC_032676.1,13244098,13244099,14496897,GT,G,1
NC_037354.1,NC_032676.1,13364620,13364621,14617426,GA,G,1
NC_037354.1,NC_032676.1,13443906,13443907,14749349,AT,A,1
NC_037354.1,NC_032676.1,13444003,13444004,14749445,AC,A,1
NC_037354.1,NC_032676.1,13479261,13479263,14784661,CTG,C,2
NC_037354.1,NC_032676.1,13502525,13502526,14807927,AT,A,1
NC_037354.1,NC_032676.1,13533395,13533396,14841405,TC,T,1
NC_037354.1,NC_032676.1,13546362,13546363,14854381,TG,T,1
NC_037354.1,NC_032676.1,13556669,13556670,14864705,CA,C,1
NC_037354.1,NC_032676.1,13609612,13609613,14918868,TC,T,1
NC_037354.1,NC_032676.1,13647543,13647544,14960542,GT,G,1
NC_037354.1,NC_032676.1,13782144,13782146,15095249,CAG,C,2
NC_037354.1,NC_032676.1,14097580,14097581,15406944,CA,C,1
NC_037354.1,NC_032676.1,14097707,14097710,15407066,TCTC,T,3
NC_037354.1,NC_032676.1,14299307,14299308,15603725,AT,A,1
NC_037354.1,NC_032676.1,14458869,14458870,15765842,GT,G,1
NC_037354.1,NC_032676.1,15039990,15039996,16341288,GTTCTAT,G,6
NC_037354.1,NC_032676.1,15291629,15291630,16604536,AT,A,1
NC_037354.1,NC_032676.1,15310630,15310631,16623536,AG,A,1
NC_037354.1,NC_032676.1,15417039,15417041,16730321,TTC,T,2
NC_037354.1,NC_032676.1,15466983,15466984,16781929,AC,A,1
NC_037354.1,NC_032676.1,15479404,15479405,16794354,CG,C,1
NC_037354.1,NC_032676.1,15479424,15479425,16794373,TA,T,1
NC_037354.1,NC_032676.1,15805502,15805503,17118088,TA,T,1
NC_037354.1,NC_032676.1,16080332,16080333,17392817,GA,G,1
NC_037354.1,NC_032676.1,16090212,16090215,17402697,CTAT,C,3
NC_037354.1,NC_032676.1,16145191,16145192,17458504,CA,C,1
NC_037354.1,NC_032676.1,16145201,16145202,17458513,AG,A,1
NC_037354.1,NC_032676.1,16145213,16145214,17458524,AG,A,1
NC_037354.1,NC_032676.1,16147483,16147484,17460789,TA,T,1
NC_037354.1,NC_032676.1,16148561,16148562,17461866,CA,C,1
NC_037354.1,NC_032676.1,16191654,16191656,17504973,AAC,A,2
NC_037354.1,NC_032676.1,16192244,16192245,17505560,CG,C,1
NC_037354.1,NC_032676.1,16201970,16201971,17515274,TG,T,1
NC_037354.1,NC_032676.1,16202312,16202313,17515614,AT,A,1
NC_037354.1,NC_032676.1,16222104,16222105,17535415,TA,T,1
NC_037354.1,NC_032676.1,16268117,16268118,17581410,AT,A,1
NC_037354.1,NC_032676.1,16334728,16334729,17648245,GT,G,1
NC_037354.1,NC_032676.1,16335280,16335282,17648794,CCA,C,2
NC_037354.1,NC_032676.1,16430186,16430188,17778312,AAG,A,2
NC_037354.1,NC_032676.1,16430199,16430200,17778323,GA,G,1
NC_037354.1,NC_032676.1,16430252,16430253,17778374,AT,A,1
NC_037354.1,NC_032676.1,16508580,16508582,17856652,CTT,C,2
NC_037354.1,NC_032676.1,16508970,16508971,17857040,CG,C,1
NC_037354.1,NC_032676.1,16519696,16519697,17867761,CA,C,1
NC_037354.1,NC_032676.1,16608948,16608949,17957452,AG,A,1
NC_037354.1,NC_032676.1,16626784,16626785,17980782,AT,A,1
NC_037354.1,NC_032676.1,16665640,16665641,18025092,AC,A,1
NC_037354.1,NC_032676.1,16665648,16665649,18025099,GT,G,1
NC_037354.1,NC_032676.1,16665655,16665656,18025105,GT,G,1
NC_037354.1,NC_032676.1,16665710,16665711,18025158,CT,C,1
NC_037354.1,NC_032676.1,16665734,16665735,18025181,AC,A,1
NC_037354.1,NC_032676.1,16722188,16722189,18081507,CA,C,1
NC_037354.1,NC_032676.1,16854065,16854066,18230213,TG,T,1
NC_037354.1,NC_032676.1,16951687,16951688,18327855,GC,G,1
NC_037354.1,NC_032676.1,17103903,17103904,18485351,CA,C,1
NC_037354.1,NC_032676.1,17111370,17111372,18492815,TCA,T,2
NC_037354.1,NC_032676.1,17111987,17111988,18493430,AG,A,1
NC_037354.1,NC_032676.1,17114019,17114020,18495463,CA,C,1
NC_037354.1,NC_032676.1,17223552,17223553,18608894,CG,C,1
NC_037354.1,NC_032676.1,17332577,17332582,18717788,AGTTTT,A,5
NC_037354.1,NC_032676.1,17579605,17579606,18988183,GA,G,1
NC_037354.1,NC_032676.1,17749957,17749959,19160334,ATC,A,2
NC_037354.1,NC_032676.1,18065950,18065951,20700735,AG,A,1
NC_037354.1,NC_032676.1,18268466,18268467,19642327,AG,A,1
NC_037354.1,NC_032676.1,18628974,18628978,20001972,TAGAC,T,4
NC_037354.1,NC_032676.1,18629240,18629243,20002233,AAGG,A,3
NC_037354.1,NC_032676.1,18629259,18629260,20002249,GC,G,1
NC_037354.1,NC_032676.1,18664408,18664409,20037575,AT,A,1
NC_037354.1,NC_032676.1,18730140,18730142,20103223,CTG,C,2
NC_037354.1,NC_032676.1,18975759,18975763,20365651,GCTGT,G,4
NC_037354.1,NC_032676.1,19261565,19261566,20873844,CA,C,1
NC_037354.1,NC_032676.1,19261605,19261607,20873883,CAT,C,2
NC_037354.1,NC_032676.1,19423117,19423118,21067835,TG,T,1
NC_037354.1,NC_032676.1,19445609,19445610,21090494,GT,G,1
NC_037354.1,NC_032676.1,19539604,19539605,21184469,AG,A,1
NC_037354.1,NC_032676.1,19566199,19566200,21277035,GT,G,1
NC_037354.1,NC_032676.1,19736586,19736587,21447470,TC,T,1
NC_037354.1,NC_032676.1,19816871,19816872,21529323,AC,A,1
NC_037354.1,NC_032676.1,19859857,19859858,21572051,TA,T,1
NC_037354.1,NC_032676.1,20251846,20251847,22108042,CT,C,1
NC_037354.1,NC_032676.1,20719128,20719129,22662126,TA,T,1
NC_037354.1,NC_032676.1,21019939,21019941,22970226,TTC,T,2
NC_037354.1,NC_032676.1,21160841,21160842,23112250,AT,A,1
NC_037354.1,NC_032676.1,21394928,21394929,23188875,AC,A,1
NC_037354.1,NC_032676.1,22163833,22163834,24178625,AG,A,1
NC_037354.1,NC_032676.1,22215610,22215611,24230104,TC,T,1
NC_037354.1,NC_032676.1,22410782,22410784,24330672,AAG,A,2
NC_037354.1,NC_032676.1,22410791,22410792,24330679,GA,G,1
NC_037354.1,NC_032676.1,22410803,22410804,24330690,GA,G,1
NC_037354.1,NC_032676.1,22578938,22578942,24499400,ACACT,A,4
NC_037354.1,NC_032676.1,22623166,22623167,24543643,CT,C,1
NC_037354.1,NC_032676.1,22756907,22756908,24719926,CA,C,1
NC_037354.1,NC_032676.1,22888526,22888528,24831126,CAA,C,2
NC_037354.1,NC_032676.1,22889548,22889549,24832145,GA,G,1
NC_037354.1,NC_032676.1,22898611,22898613,24841481,CCT,C,2
NC_037354.1,NC_032676.1,22898640,22898641,24841508,CT,C,1
NC_037354.1,NC_032676.1,22898652,22898653,24841519,CT,C,1
NC_037354.1,NC_032676.1,23010719,23010724,24970797,TGTAAA,T,5
NC_037354.1,NC_032676.1,23048682,23048684,25018222,AAG,A,2
NC_037354.1,NC_032676.1,23048733,23048735,25018270,AAG,A,2
NC_037354.1,NC_032676.1,23103347,23103348,25072888,TA,T,1
NC_037354.1,NC_032676.1,23212414,23212415,25182075,AT,A,1
NC_037354.1,NC_032676.1,23212426,23212429,25182086,CTGA,C,3
NC_037354.1,NC_032676.1,23302779,23302780,25272304,GA,G,1
NC_037354.1,NC_032676.1,23345642,23345643,25315142,AG,A,1
NC_037354.1,NC_032676.1,23420560,23420561,25389779,CA,C,1
NC_037354.1,NC_032676.1,23521097,23521098,25493065,GC,G,1
NC_037354.1,NC_032676.1,23636928,23636930,25608930,AAC,A,2
NC_037354.1,NC_032676.1,23661216,23661217,25633355,GA,G,1
NC_037354.1,NC_032676.1,23771282,23771283,25747152,AC,A,1
NC_037354.1,NC_032676.1,23949672,23949673,25950825,AC,A,1
NC_037354.1,NC_032676.1,23959252,23959253,25960404,CG,C,1
NC_037354.1,NC_032676.1,23963249,23963251,25964423,AAC,A,2
NC_037354.1,NC_032676.1,24125257,24125258,26122811,CG,C,1
NC_037354.1,NC_032676.1,24128966,24128968,26126521,ACT,A,2
NC_037354.1,NC_032676.1,24132105,24132115,26129658,AATTTCTAGCC,A,10
NC_037354.1,NC_032676.1,24165687,24165688,26164164,AG,A,1
NC_037354.1,NC_032676.1,24236489,24236490,26212252,TG,T,1
NC_037354.1,NC_032676.1,24694024,24694025,26696019,CT,C,1
NC_037354.1,NC_032676.1,24694030,24694031,26696024,GT,G,1
NC_037354.1,NC_032676.1,24694037,24694038,26696030,AG,A,1
NC_037354.1,NC_032676.1,24710212,24710213,26712201,CT,C,1
NC_037354.1,NC_032676.1,24710253,24710254,26712240,AC,A,1
NC_037354.1,NC_032676.1,24839205,24839215,26841118,CCCCAGCCTTG,C,10
NC_037354.1,NC_032676.1,24898024,24898026,26899051,TTC,T,2
NC_037354.1,NC_032676.1,24940832,24940833,26941324,CA,C,1
NC_037354.1,NC_032676.1,24992872,24992873,26993364,TA,T,1
NC_037354.1,NC_032676.1,25081173,25081174,27081596,TG,T,1
NC_037354.1,NC_032676.1,25181487,25181488,27182084,TA,T,1
NC_037354.1,NC_032676.1,25181511,25181512,27182107,TG,T,1
NC_037354.1,NC_032676.1,25181531,25181532,27182126,AC,A,1
NC_037354.1,NC_032676.1,25249567,25249568,27250178,AG,A,1
NC_037354.1,NC_032676.1,25266559,25266613,27267169,CCATCTTGTGCTCAGAGACTGAACCTCGGCAAAGCTCTGGTTTCTGATTGACCGT,C,54
NC_037354.1,NC_032676.1,25325538,25325539,27324724,TG,T,1
NC_037354.1,NC_032676.1,25327430,25327431,27326615,AC,A,1
NC_037354.1,NC_032676.1,25477553,25477554,27476919,CA,C,1
NC_037354.1,NC_032676.1,25599858,25599860,27599291,CTT,C,2
NC_037354.1,NC_032676.1,25740730,25740731,27737116,AT,A,1
NC_037354.1,NC_032676.1,25740738,25740739,27737123,AT,A,1
NC_037354.1,NC_032676.1,26322252,26322255,28407364,AGTT,A,3
NC_037354.1,NC_032676.1,26323161,26323162,28408270,AT,A,1
NC_037354.1,NC_032676.1,26326988,26326990,28412024,CAT,C,2
NC_037354.1,NC_032676.1,26369598,26369599,28454150,TA,T,1
NC_037354.1,NC_032676.1,26652698,26652699,28737430,TC,T,1
NC_037354.1,NC_032676.1,26735210,26735211,28820748,GA,G,1
NC_037354.1,NC_032676.1,27119121,27119122,29204987,AG,A,1
NC_037354.1,NC_032676.1,27119125,27119126,29204990,TA,T,1
NC_037354.1,NC_032676.1,27121047,27121048,29206789,GA,G,1
NC_037354.1,NC_032676.1,27215023,27215024,29302988,AG,A,1
NC_037354.1,NC_032676.1,27221058,27221063,29309026,AGGGTT,A,5
NC_037354.1,NC_032676.1,27224645,27224646,29312624,TA,T,1
NC_037354.1,NC_032676.1,27446210,27446211,29534362,TG,T,1
NC_037354.1,NC_032676.1,27547683,27547686,29635873,ACTG,A,3
NC_037354.1,NC_032676.1,27668715,27668718,29759497,TCAA,T,3
NC_037354.1,NC_032676.1,28652661,28652662,30747706,AG,A,1
NC_037354.1,NC_032676.1,28800215,28800216,30895270,AG,A,1
NC_037354.1,NC_032676.1,28907766,28907768,31013860,AAG,A,2
NC_037354.1,NC_032676.1,28914042,28914061,31020156,CTTCACGCAGGGAGTTAGAT,C,19
NC_037354.1,NC_032676.1,28914099,28914100,31020194,TG,T,1
NC_037354.1,NC_032676.1,29006037,29006038,31112482,CA,C,1
NC_037354.1,NC_032676.1,29064141,29064144,31171092,ATAG,A,3
NC_037354.1,NC_032676.1,29160604,29160605,31266609,TG,T,1
NC_037354.1,NC_032676.1,29261596,29261597,31426285,GT,G,1
NC_037354.1,NC_032676.1,29720342,29720343,31886553,AC,A,1
NC_037354.1,NC_032676.1,29883289,29883290,32035136,AG,A,1
NC_037354.1,NC_032676.1,30404566,30404587,32559585,GACTCAACAGCAGTGAGACTGT,G,21
NC_037354.1,NC_032676.1,30732014,30732015,32883618,AG,A,1
NC_037354.1,NC_032676.1,30925707,30925708,33127734,TG,T,1
NC_037354.1,NC_032676.1,30934523,30934524,33136622,AC,A,1
NC_037354.1,NC_032676.1,30936721,30936722,33138819,GA,G,1
NC_037354.1,NC_032676.1,30952805,30952806,33154902,GT,G,1
NC_037354.1,NC_032676.1,30972490,30972491,33174518,AC,A,1
NC_037354.1,NC_032676.1,30972497,30972498,33174524,CT,C,1
NC_037354.1,NC_032676.1,30972520,30972521,33174547,CA,C,1
NC_037354.1,NC_032676.1,31010573,31010574,33212645,GT,G,1
NC_037354.1,NC_032676.1,31051579,31051582,33253021,CAGG,C,3
NC_037354.1,NC_032676.1,31059700,31059702,33261312,GCT,G,2
NC_037354.1,NC_032676.1,31239243,31239244,33439354,AT,A,1
NC_037354.1,NC_032676.1,31274035,31274039,33474168,TTAGA,T,4
NC_037354.1,NC_032676.1,31354055,31354056,33552650,GT,G,1
NC_037354.1,NC_032676.1,31506040,31506041,33704546,AT,A,1
NC_037354.1,NC_032676.1,31513325,31513329,33711829,AAAGG,A,4
NC_037354.1,NC_032676.1,31554336,31554337,33752856,TC,T,1
NC_037354.1,NC_032676.1,31628100,31628101,33826378,AG,A,1
NC_037354.1,NC_032676.1,31871540,31871541,34072048,CT,C,1
NC_037354.1,NC_032676.1,32175216,32175217,34384270,TG,T,1
NC_037354.1,NC_032676.1,32175248,32175249,34384301,AG,A,1
NC_037354.1,NC_032676.1,32221397,32221398,34430923,TC,T,1
NC_037354.1,NC_032676.1,32295219,32295220,34504870,CA,C,1
NC_037354.1,NC_032676.1,32332831,32332832,34542223,TA,T,1
NC_037354.1,NC_032676.1,32684936,32684937,34905284,CA,C,1
NC_037354.1,NC_032676.1,32690417,32690421,34910769,GCTGT,G,4
NC_037354.1,NC_032676.1,32725756,32725764,34946103,CAGATACCA,C,8
NC_037354.1,NC_032676.1,33194129,33194130,35417369,AG,A,1
NC_037354.1,NC_032676.1,33194169,33194170,35417407,AG,A,1
NC_037354.1,NC_032676.1,33194178,33194179,35417415,GA,G,1
NC_037354.1,NC_032676.1,33194236,33194237,35417471,TC,T,1
NC_037354.1,NC_032676.1,33512159,33512160,35738707,AT,A,1
NC_037354.1,NC_032676.1,33701937,33701938,35971493,GC,G,1
NC_037354.1,NC_032676.1,33784909,33784910,36054334,AC,A,1
NC_037354.1,NC_032676.1,33785487,33785488,36054911,GC,G,1
NC_037354.1,NC_032676.1,33787606,33787607,36057030,GA,G,1
NC_037354.1,NC_032676.1,33788353,33788354,36057781,GT,G,1
NC_037354.1,NC_032676.1,33788379,33788380,36057806,TC,T,1
NC_037354.1,NC_032676.1,33788787,33788788,36058218,AT,A,1
NC_037354.1,NC_032676.1,33789012,33789013,36058442,CT,C,1
NC_037354.1,NC_032676.1,33789027,33789028,36058456,GC,G,1
NC_037354.1,NC_032676.1,33789569,33789570,36059002,GT,G,1
NC_037354.1,NC_032676.1,33789833,33789834,36059268,AT,A,1
NC_037354.1,NC_032676.1,33789957,33789958,36059392,GA,G,1
NC_037354.1,NC_032676.1,33790034,33790035,36059468,GC,G,1
NC_037354.1,NC_032676.1,33790059,33790061,36059492,CCG,C,2
NC_037354.1,NC_032676.1,33790067,33790068,36059498,TC,T,1
NC_037354.1,NC_032676.1,33790086,33790087,36059516,CG,C,1
NC_037354.1,NC_032676.1,33790177,33790178,36059607,AT,A,1
NC_037354.1,NC_032676.1,34170952,34170955,36458198,GTTT,G,3
NC_037354.1,NC_032676.1,34358089,34358122,36645501,GACAGTGCTTCTGTGATTTATGCTTTTGTGCGAA,G,33
NC_037354.1,NC_032676.1,34503426,34503427,36774299,TA,T,1
NC_037354.1,NC_032676.1,34512268,34512270,36783151,GGC,G,2
NC_037354.1,NC_032676.1,34665893,34665894,36943691,AG,A,1
NC_037354.1,NC_032676.1,34679369,34679370,36957194,TC,T,1
NC_037354.1,NC_032676.1,34982517,34982518,37328055,TG,T,1
NC_037354.1,NC_032676.1,34986453,34986458,37331991,GCCAAC,G,5
NC_037354.1,NC_032676.1,34994015,34994017,37344761,ATT,A,2
NC_037354.1,NC_032676.1,34995217,34995218,37345960,AG,A,1
NC_037354.1,NC_032676.1,35017115,35017117,37367868,CAT,C,2
NC_037354.1,NC_032676.1,35034707,35034708,37385466,GC,G,1
NC_037354.1,NC_032676.1,35048663,35048664,37399431,TA,T,1
NC_037354.1,NC_032676.1,35113019,35113020,37459807,CG,C,1
NC_037354.1,NC_032676.1,35118069,35118070,37464853,CA,C,1
NC_037354.1,NC_032676.1,35367190,35367191,37713961,CT,C,1
NC_037354.1,NC_032676.1,35376704,35376705,37723477,TC,T,1
NC_037354.1,NC_032676.1,35426124,35426125,37772844,AG,A,1
NC_037354.1,NC_032676.1,36329489,36329490,38741887,CG,C,1
NC_037354.1,NC_032676.1,36329502,36329503,38741899,AT,A,1
NC_037354.1,NC_032676.1,36343856,36343857,38756220,GT,G,1
NC_037354.1,NC_032676.1,36527974,36527975,38940349,CA,C,1
NC_037354.1,NC_032676.1,36599941,36599942,39018038,AC,A,1
NC_037354.1,NC_032676.1,36652152,36652153,39068744,CT,C,1
NC_037354.1,NC_032676.1,36652188,36652189,39068778,GT,G,1
NC_037354.1,NC_032676.1,36652229,36652230,39068818,GC,G,1
NC_037354.1,NC_032676.1,36658289,36658290,39074875,AT,A,1
NC_037354.1,NC_032676.1,37329836,37329837,39744960,AT,A,1
NC_037354.1,NC_032676.1,37329854,37329855,39744977,AT,A,1
NC_037354.1,NC_032676.1,37329861,37329862,39744983,CA,C,1
NC_037354.1,NC_032676.1,37596214,37596215,40010989,AT,A,1
NC_037354.1,NC_032676.1,37610328,37610329,40025101,AG,A,1
NC_037354.1,NC_032676.1,37637730,37637731,40052508,GT,G,1
NC_037354.1,NC_032676.1,39563800,39563801,42100125,GT,G,1
