Reference ID,Query ID,Reference POS,Reference END,Query POS,REF,ALT,SVLEN
NC_037347.1,NC_032669.1,217539,217541,2967257,CGG,C,2
NC_037347.1,NC_032669.1,224577,224578,2960090,TG,T,1
NC_037347.1,NC_032669.1,3226324,3226325,3248227,GC,G,1
NC_037347.1,NC_032669.1,3911210,3911211,3937450,GC,G,1
NC_037347.1,NC_032669.1,3911219,3911220,3937458,TC,T,1
NC_037347.1,NC_032669.1,4179350,4179351,4213273,GC,G,1
NC_037347.1,NC_032669.1,4203304,4203305,4237423,CA,C,1
NC_037347.1,NC_032669.1,4319183,4319184,4354357,GA,G,1
NC_037347.1,NC_032669.1,4319190,4319191,4354363,TC,T,1
NC_037347.1,NC_032669.1,4319242,4319243,4354414,AC,A,1
NC_037347.1,NC_032669.1,4321480,4321481,4356651,CA,C,1
NC_037347.1,NC_032669.1,4585247,4585248,4620494,GC,G,1
NC_037347.1,NC_032669.1,4677526,4677527,4712840,AC,A,1
NC_037347.1,NC_032669.1,4679184,4679185,4714595,GT,G,1
NC_037347.1,NC_032669.1,4679188,4679193,4714598,TTGTCC,T,5
NC_037347.1,NC_032669.1,4874735,4874736,4909693,CG,C,1
NC_037347.1,NC_032669.1,5035399,5035410,5070317,ATTATTCCTAAT,A,11
NC_037347.1,NC_032669.1,5539810,5539819,5615835,AACCTTTGAG,A,9
NC_037347.1,NC_032669.1,5660603,5660604,5735849,CG,C,1
NC_037347.1,NC_032669.1,5756458,5756460,5834503,GCA,G,2
NC_037347.1,NC_032669.1,5756499,5756500,5834542,CT,C,1
NC_037347.1,NC_032669.1,5791684,5791685,5869692,GT,G,1
NC_037347.1,NC_032669.1,5799603,5799604,5877646,TG,T,1
NC_037347.1,NC_032669.1,5838875,5838876,5916732,GT,G,1
NC_037347.1,NC_032669.1,5899192,5899199,5977037,GGCAGATC,G,7
NC_037347.1,NC_032669.1,5904482,5904483,5982320,AT,A,1
NC_037347.1,NC_032669.1,5922227,5922235,6000083,CACCCCCCA,C,8
NC_037347.1,NC_032669.1,6128171,6128172,6224850,GC,G,1
NC_037347.1,NC_032669.1,6128917,6128919,6225594,TTG,T,2
NC_037347.1,NC_032669.1,6129053,6129054,6225728,GT,G,1
NC_037347.1,NC_032669.1,6129188,6129189,6225862,CT,C,1
NC_037347.1,NC_032669.1,6311390,6311391,6408901,AT,A,1
NC_037347.1,NC_032669.1,6311431,6311432,6408940,CT,C,1
NC_037347.1,NC_032669.1,6325329,6325330,6422836,CA,C,1
NC_037347.1,NC_032669.1,6423559,6423566,6583351,TGAATCTC,T,7
NC_037347.1,NC_032669.1,6543890,6543891,6703221,GC,G,1
NC_037347.1,NC_032669.1,6702296,6702299,6856771,TTAC,T,3
NC_037347.1,NC_032669.1,6724873,6724876,6879365,CATT,C,3
NC_037347.1,NC_032669.1,6734946,6734947,6890216,TA,T,1
NC_037347.1,NC_032669.1,6768630,6768631,6923919,CA,C,1
NC_037347.1,NC_032669.1,6768641,6768642,6923929,GA,G,1
NC_037347.1,NC_032669.1,6789103,6789104,6944395,AT,A,1
NC_037347.1,NC_032669.1,6840403,6840405,7012767,AAG,A,2
NC_037347.1,NC_032669.1,6858672,6858673,7031071,CT,C,1
NC_037347.1,NC_032669.1,6890928,6890929,7062648,GT,G,1
NC_037347.1,NC_032669.1,6991586,6991587,7230163,TA,T,1
NC_037347.1,NC_032669.1,7029721,7029722,7268262,CT,C,1
NC_037347.1,NC_032669.1,7765734,7765735,8057781,TA,T,1
NC_037347.1,NC_032669.1,7768412,7768413,8060456,GA,G,1
NC_037347.1,NC_032669.1,7768416,7768417,8060459,CA,C,1
NC_037347.1,NC_032669.1,7834915,7834916,8147053,GA,G,1
NC_037347.1,NC_032669.1,7834962,7834963,8147099,TA,T,1
NC_037347.1,NC_032669.1,7993371,7993372,8308426,CA,C,1
NC_037347.1,NC_032669.1,8120157,8120158,8483921,AC,A,1
NC_037347.1,NC_032669.1,8177302,8177303,8541082,TG,T,1
NC_037347.1,NC_032669.1,8182013,8182014,8545651,GA,G,1
NC_037347.1,NC_032669.1,8298151,8298152,8659635,TA,T,1
NC_037347.1,NC_032669.1,8456061,8456062,8822277,CG,C,1
NC_037347.1,NC_032669.1,9019580,9019581,9657290,AG,A,1
NC_037347.1,NC_032669.1,9273319,9273320,9991492,AG,A,1
NC_037347.1,NC_032669.1,9300861,9300862,10018963,AT,A,1
NC_037347.1,NC_032669.1,9359750,9359751,10077614,TA,T,1
NC_037347.1,NC_032669.1,9373264,9373265,10091125,AC,A,1
NC_037347.1,NC_032669.1,9398696,9398697,10116556,TG,T,1
NC_037347.1,NC_032669.1,9460111,9460112,10177999,GC,G,1
NC_037347.1,NC_032669.1,9575308,9575312,10301885,ACACT,A,4
NC_037347.1,NC_032669.1,9606684,9606685,10333293,TC,T,1
NC_037347.1,NC_032669.1,9609121,9609123,10335730,GGA,G,2
NC_037347.1,NC_032669.1,9679441,9679442,10405928,CA,C,1
NC_037347.1,NC_032669.1,9684971,9684972,10411454,TC,T,1
NC_037347.1,NC_032669.1,9714786,9714787,10441023,TA,T,1
NC_037347.1,NC_032669.1,9775691,9775692,10508265,AT,A,1
NC_037347.1,NC_032669.1,9798749,9798750,10530930,GA,G,1
NC_037347.1,NC_032669.1,9802532,9802533,10534712,CT,C,1
NC_037347.1,NC_032669.1,10058694,10058695,10643650,GA,G,1
NC_037347.1,NC_032669.1,10354857,10354858,10962893,CA,C,1
NC_037347.1,NC_032669.1,10357886,10357887,10965919,CA,C,1
NC_037347.1,NC_032669.1,10359664,10359666,10967692,AAT,A,2
NC_037347.1,NC_032669.1,10441533,10441534,11049480,TG,T,1
NC_037347.1,NC_032669.1,10441555,10441556,11049501,GT,G,1
NC_037347.1,NC_032669.1,10441575,10441576,11049520,AT,A,1
NC_037347.1,NC_032669.1,10441584,10441585,11049528,AT,A,1
NC_037347.1,NC_032669.1,10457358,10457359,11056068,CA,C,1
NC_037347.1,NC_032669.1,10461506,10461507,11060178,CT,C,1
NC_037347.1,NC_032669.1,10576707,10576708,11175395,GC,G,1
NC_037347.1,NC_032669.1,10616895,10616899,11215601,CTGTT,C,4
NC_037347.1,NC_032669.1,10623661,10623663,11222361,GGA,G,2
NC_037347.1,NC_032669.1,10802339,10802340,11481306,CT,C,1
NC_037347.1,NC_032669.1,10803893,10803894,11482861,AG,A,1
NC_037347.1,NC_032669.1,10816817,10816826,11495795,CGTGGCGGTG,C,9
NC_037347.1,NC_032669.1,10821114,10821115,11500092,CT,C,1
NC_037347.1,NC_032669.1,10827211,10827212,11506184,TC,T,1
NC_037347.1,NC_032669.1,11077620,11077621,11769073,GC,G,1
NC_037347.1,NC_032669.1,11079548,11079549,11771000,GA,G,1
NC_037347.1,NC_032669.1,11252393,11252395,11944773,CTG,C,2
NC_037347.1,NC_032669.1,11272733,11272734,11965112,CA,C,1
NC_037347.1,NC_032669.1,11317617,11317618,12010017,AT,A,1
NC_037347.1,NC_032669.1,11330804,11330805,12023204,CA,C,1
NC_037347.1,NC_032669.1,11352403,11352406,12044805,AAGT,A,3
NC_037347.1,NC_032669.1,11402835,11402836,12095269,TC,T,1
NC_037347.1,NC_032669.1,11420760,11420761,12113213,CT,C,1
NC_037347.1,NC_032669.1,11479478,11479479,12171863,CA,C,1
NC_037347.1,NC_032669.1,11651454,11651455,12376587,TG,T,1
NC_037347.1,NC_032669.1,11675202,11675203,12400350,TC,T,1
NC_037347.1,NC_032669.1,11677783,11677784,12402923,GC,G,1
NC_037347.1,NC_032669.1,11888290,11888291,12613038,CA,C,1
NC_037347.1,NC_032669.1,11927799,11927801,12652543,TAA,T,2
NC_037347.1,NC_032669.1,12247723,12247724,12972129,AT,A,1
NC_037347.1,NC_032669.1,12285243,12285244,13009647,TC,T,1
NC_037347.1,NC_032669.1,12476728,12476729,13204061,AT,A,1
NC_037347.1,NC_032669.1,12479287,12479288,13206618,CA,C,1
NC_037347.1,NC_032669.1,12529216,12529217,13256552,TA,T,1
NC_037347.1,NC_032669.1,12656459,12656460,13383879,AG,A,1
NC_037347.1,NC_032669.1,12681426,12681427,13408832,CT,C,1
NC_037347.1,NC_032669.1,12742423,12742424,13478919,AG,A,1
NC_037347.1,NC_032669.1,12892642,12892644,13627934,CCA,C,2
NC_037347.1,NC_032669.1,12898793,12898795,13634420,CTT,C,2
NC_037347.1,NC_032669.1,12946113,12946114,13680572,GC,G,1
NC_037347.1,NC_032669.1,12959394,12959395,13693855,AG,A,1
NC_037347.1,NC_032669.1,12965110,12965111,13699571,TC,T,1
NC_037347.1,NC_032669.1,12976227,12976228,13710689,CA,C,1
NC_037347.1,NC_032669.1,13097600,13097602,13844790,CTA,C,2
NC_037347.1,NC_032669.1,13118810,13118812,13866005,TAA,T,2
NC_037347.1,NC_032669.1,13291961,13291962,14043167,AC,A,1
NC_037347.1,NC_032669.1,13292995,13292996,14044199,TA,T,1
NC_037347.1,NC_032669.1,13644183,13644184,14393161,GA,G,1
NC_037347.1,NC_032669.1,13644187,13644188,14393164,AC,A,1
NC_037347.1,NC_032669.1,13669401,13669402,14417284,AT,A,1
NC_037347.1,NC_032669.1,13671769,13671771,14419650,TTA,T,2
NC_037347.1,NC_032669.1,13671779,13671780,14419658,GC,G,1
NC_037347.1,NC_032669.1,13671786,13671787,14419664,CA,C,1
NC_037347.1,NC_032669.1,14403367,14403368,15284824,TC,T,1
NC_037347.1,NC_032669.1,14460822,14460823,15342550,GT,G,1
NC_037347.1,NC_032669.1,14581179,14581180,15462213,AG,A,1
NC_037347.1,NC_032669.1,15434981,15434985,16644314,AACTG,A,4
NC_037347.1,NC_032669.1,15638434,15638435,16863782,AG,A,1
NC_037347.1,NC_032669.1,15679768,15679769,16904932,CT,C,1
NC_037347.1,NC_032669.1,15689793,15689795,16915019,CAG,C,2
NC_037347.1,NC_032669.1,15694973,15694974,16920191,TG,T,1
NC_037347.1,NC_032669.1,15730001,15730002,16975758,CA,C,1
NC_037347.1,NC_032669.1,15760001,15760013,17008885,GAGGCAAAAGCAA,G,12
NC_037347.1,NC_032669.1,15771876,15771877,17020880,TG,T,1
NC_037347.1,NC_032669.1,15772309,15772310,17021312,GT,G,1
NC_037347.1,NC_032669.1,15788177,15788178,17037727,AC,A,1
NC_037347.1,NC_032669.1,15830137,15830138,17077869,AG,A,1
NC_037347.1,NC_032669.1,15865052,15865053,17112837,AT,A,1
NC_037347.1,NC_032669.1,15933911,15933912,17181775,GA,G,1
NC_037347.1,NC_032669.1,15933953,15933954,17181815,GA,G,1
NC_037347.1,NC_032669.1,15933975,15933976,17181836,TA,T,1
NC_037347.1,NC_032669.1,15933986,15933987,17181846,AG,A,1
NC_037347.1,NC_032669.1,15934010,15934011,17181869,TC,T,1
NC_037347.1,NC_032669.1,15982214,15982215,17230083,AT,A,1
NC_037347.1,NC_032669.1,16127960,16127961,17376393,TG,T,1
NC_037347.1,NC_032669.1,16245387,16245391,17493864,AAATT,A,4
NC_037347.1,NC_032669.1,16294263,16294264,17542863,AC,A,1
NC_037347.1,NC_032669.1,16310357,16310358,17559000,TG,T,1
NC_037347.1,NC_032669.1,16392201,16392202,17646842,TA,T,1
NC_037347.1,NC_032669.1,16445845,16445846,17699168,AG,A,1
NC_037347.1,NC_032669.1,16448351,16448355,17702196,CAGGT,C,4
NC_037347.1,NC_032669.1,16480493,16480494,17733868,CG,C,1
NC_037347.1,NC_032669.1,16509517,16509518,17762905,CA,C,1
NC_037347.1,NC_032669.1,16566821,16566822,17820221,GA,G,1
NC_037347.1,NC_032669.1,16567737,16567744,17821142,CCACAGGA,C,7
NC_037347.1,NC_032669.1,16640286,16640289,17894196,CATT,C,3
NC_037347.1,NC_032669.1,16642643,16642645,17896550,TCA,T,2
NC_037347.1,NC_032669.1,16642649,16642653,17896554,CATCA,C,4
NC_037347.1,NC_032669.1,16696732,16696733,17966795,GA,G,1
NC_037347.1,NC_032669.1,16869074,16869096,18138900,GCCATAAATCTCTGGAAAGGAGA,G,22
NC_037347.1,NC_032669.1,17019158,17019159,18289743,AG,A,1
NC_037347.1,NC_032669.1,17019177,17019178,18289761,GA,G,1
NC_037347.1,NC_032669.1,17019200,17019201,18289783,GT,G,1
NC_037347.1,NC_032669.1,17019214,17019215,18289796,AT,A,1
NC_037347.1,NC_032669.1,17019228,17019229,18289809,TG,T,1
NC_037347.1,NC_032669.1,17121149,17121151,18392030,CAG,C,2
NC_037347.1,NC_032669.1,17234188,17234189,18524836,TA,T,1
NC_037347.1,NC_032669.1,17309307,17309308,18599968,AG,A,1
NC_037347.1,NC_032669.1,17619953,17619954,18943388,CT,C,1
NC_037347.1,NC_032669.1,17725206,17725207,19049088,CT,C,1
NC_037347.1,NC_032669.1,18040871,18040872,19363688,CA,C,1
NC_037347.1,NC_032669.1,18454130,18454131,19813296,AG,A,1
NC_037347.1,NC_032669.1,18513613,18513614,19924092,GC,G,1
NC_037347.1,NC_032669.1,18514310,18514311,19924788,TG,T,1
NC_037347.1,NC_032669.1,18586654,18586657,19997129,TCTC,T,3
NC_037347.1,NC_032669.1,18601745,18601746,20013852,TG,T,1
NC_037347.1,NC_032669.1,18631263,18631264,20045906,TC,T,1
NC_037347.1,NC_032669.1,18633640,18633641,20048282,GT,G,1
NC_037347.1,NC_032669.1,18849620,18849621,20264347,GT,G,1
NC_037347.1,NC_032669.1,18849624,18849625,20264350,AG,A,1
NC_037347.1,NC_032669.1,18852688,18852689,20267415,AC,A,1
NC_037347.1,NC_032669.1,18863268,18863269,20277990,AT,A,1
NC_037347.1,NC_032669.1,19138095,19138096,20638622,GA,G,1
NC_037347.1,NC_032669.1,19179368,19179369,20679893,CT,C,1
NC_037347.1,NC_032669.1,19187768,19187769,20688289,TG,T,1
NC_037347.1,NC_032669.1,19251152,19251153,20751993,TC,T,1
NC_037347.1,NC_032669.1,19259973,19259974,20760807,TG,T,1
NC_037347.1,NC_032669.1,19314115,19314116,20814547,GT,G,1
NC_037347.1,NC_032669.1,20367044,20367046,21878557,AAT,A,2
NC_037347.1,NC_032669.1,20367101,20367102,21878611,CA,C,1
NC_037347.1,NC_032669.1,20885089,20885090,22447846,AC,A,1
NC_037347.1,NC_032669.1,20885096,20885097,22447852,GA,G,1
NC_037347.1,NC_032669.1,20885121,20885122,22447876,GA,G,1
NC_037347.1,NC_032669.1,21107216,21107217,22676354,AG,A,1
NC_037347.1,NC_032669.1,21759776,21759777,23366176,TC,T,1
NC_037347.1,NC_032669.1,21759817,21759818,23366215,AT,A,1
NC_037347.1,NC_032669.1,22807980,22807981,24397222,TA,T,1
NC_037347.1,NC_032669.1,22992670,22992671,24595425,AC,A,1
NC_037347.1,NC_032669.1,22992678,22992679,24595432,TG,T,1
NC_037347.1,NC_032669.1,23022325,23022326,24625172,CA,C,1
NC_037347.1,NC_032669.1,23059855,23059856,24662701,GC,G,1
NC_037347.1,NC_032669.1,23061242,23061244,24664084,CCA,C,2
NC_037347.1,NC_032669.1,23061266,23061268,24664106,AAT,A,2
NC_037347.1,NC_032669.1,23100647,23100649,24703073,GGA,G,2
NC_037347.1,NC_032669.1,23100667,23100669,24703091,TTC,T,2
NC_037347.1,NC_032669.1,24734912,24734913,26430893,AT,A,1
NC_037347.1,NC_032669.1,25030325,25030326,26757276,AG,A,1
NC_037347.1,NC_032669.1,25030369,25030370,26757319,TG,T,1
NC_037347.1,NC_032669.1,25030412,25030413,26757362,GA,G,1
NC_037347.1,NC_032669.1,25030422,25030423,26757371,GT,G,1
NC_037347.1,NC_032669.1,25030431,25030432,26757379,CT,C,1
NC_037347.1,NC_032669.1,26115291,26115293,27843843,TTG,T,2
NC_037347.1,NC_032669.1,26115302,26115303,27843852,TA,T,1
NC_037347.1,NC_032669.1,26115327,26115328,27843875,TA,T,1
NC_037347.1,NC_032669.1,26370221,26370222,28112593,CA,C,1
NC_037347.1,NC_032669.1,26490436,26490437,28233070,GT,G,1
NC_037347.1,NC_032669.1,26963222,26963223,28714982,AT,A,1
NC_037347.1,NC_032669.1,26963275,26963276,28715033,GC,G,1
NC_037347.1,NC_032669.1,27344767,27344768,29069913,GT,G,1
NC_037347.1,NC_032669.1,27770184,27770185,29550745,GA,G,1
NC_037347.1,NC_032669.1,27782951,27782966,29563508,AAGAAGAGTTTTGAAG,A,15
NC_037347.1,NC_032669.1,27896307,27896308,29676850,GT,G,1
NC_037347.1,NC_032669.1,27896315,27896316,29676857,CT,C,1
NC_037347.1,NC_032669.1,27964370,27964374,29743965,GTAAC,G,4
NC_037347.1,NC_032669.1,28086464,28086465,29865536,GT,G,1
NC_037347.1,NC_032669.1,28086478,28086479,29865549,CT,C,1
NC_037347.1,NC_032669.1,28277506,28277508,30057597,CCA,C,2
NC_037347.1,NC_032669.1,28277512,28277513,30057601,GA,G,1
NC_037347.1,NC_032669.1,28305963,28305964,30086049,GA,G,1
NC_037347.1,NC_032669.1,28604139,28604160,30384694,AAGCAACATTTCTTATGAAGGT,A,21
NC_037347.1,NC_032669.1,28763923,28763938,30544686,CTGACTTCTGGTCTAA,C,15
NC_037347.1,NC_032669.1,28833973,28833975,30614735,TAA,T,2
NC_037347.1,NC_032669.1,29109516,29109517,30953183,TA,T,1
NC_037347.1,NC_032669.1,29111679,29111680,30955345,CA,C,1
NC_037347.1,NC_032669.1,29114164,29114165,30957830,CG,C,1
NC_037347.1,NC_032669.1,29175276,29175277,31018948,AT,A,1
NC_037347.1,NC_032669.1,29218465,29218466,31062200,GA,G,1
NC_037347.1,NC_032669.1,29275442,29275445,31119219,CTAA,C,3
NC_037347.1,NC_032669.1,29300751,29300752,31144569,TA,T,1
NC_037347.1,NC_032669.1,29369996,29369997,31213881,TG,T,1
NC_037347.1,NC_032669.1,29374530,29374531,31218458,AC,A,1
NC_037347.1,NC_032669.1,29410897,29410898,31255076,GA,G,1
NC_037347.1,NC_032669.1,29452096,29452097,31296280,GA,G,1
NC_037347.1,NC_032669.1,29519081,29519082,31363048,TA,T,1
NC_037347.1,NC_032669.1,29572009,29572010,31415801,AC,A,1
NC_037347.1,NC_032669.1,29669736,29669737,31553438,AC,A,1
NC_037347.1,NC_032669.1,29960435,29960447,31859009,AAAGCCTCCAAGT,A,12
NC_037347.1,NC_032669.1,30257450,30257451,32156227,AC,A,1
NC_037347.1,NC_032669.1,31175825,31175827,33123915,CCT,C,2
NC_037347.1,NC_032669.1,31175834,31175835,33123922,TC,T,1
NC_037347.1,NC_032669.1,31175841,31175842,33123928,CG,C,1
NC_037347.1,NC_032669.1,31238892,31238894,33186976,AAG,A,2
NC_037347.1,NC_032669.1,31738820,31738821,33769223,GT,G,1
NC_037347.1,NC_032669.1,31988089,31988091,34018525,AAG,A,2
NC_037347.1,NC_032669.1,32376091,32376092,34408568,AT,A,1
NC_037347.1,NC_032669.1,32376102,32376103,34408578,AT,A,1
NC_037347.1,NC_032669.1,32376111,32376112,34408586,GA,G,1
NC_037347.1,NC_032669.1,32377990,32377992,34410464,TTC,T,2
NC_037347.1,NC_032669.1,32973163,32973164,35095500,CG,C,1
NC_037347.1,NC_032669.1,33288174,33288175,35424481,CT,C,1
NC_037347.1,NC_032669.1,33522146,33522148,35658510,CCA,C,2
NC_037347.1,NC_032669.1,33525998,33526000,35662362,ATC,A,2
NC_037347.1,NC_032669.1,33721915,33721916,35892286,CA,C,1
NC_037347.1,NC_032669.1,33749897,33749900,35920498,TTAG,T,3
NC_037347.1,NC_032669.1,33750011,33750012,35920609,GA,G,1
NC_037347.1,NC_032669.1,33751125,33751126,35921793,CA,C,1
NC_037347.1,NC_032669.1,33988155,33988156,36157957,AC,A,1
NC_037347.1,NC_032669.1,33988162,33988163,36157963,GT,G,1
NC_037347.1,NC_032669.1,34028855,34028856,36198683,TG,T,1
NC_037347.1,NC_032669.1,34337080,34337081,36506369,AG,A,1
NC_037347.1,NC_032669.1,34434927,34434928,36668816,AC,A,1
NC_037347.1,NC_032669.1,34436519,34436520,36670409,AT,A,1
NC_037347.1,NC_032669.1,34709374,34709376,36899931,ACT,A,2
NC_037347.1,NC_032669.1,34764460,34764461,36923931,AG,A,1
NC_037347.1,NC_032669.1,34930711,34930712,37152833,AG,A,1
NC_037347.1,NC_032669.1,34961669,34961670,37183794,CG,C,1
NC_037347.1,NC_032669.1,35257993,35257995,37506636,GGA,G,2
NC_037347.1,NC_032669.1,35539091,35539096,37786251,TCTCAG,T,5
NC_037347.1,NC_032669.1,35539115,35539121,37786270,CCAGCTT,C,6
NC_037347.1,NC_032669.1,35597168,35597169,37844390,CT,C,1
NC_037347.1,NC_032669.1,35743126,35743127,37990411,GC,G,1
NC_037347.1,NC_032669.1,36013163,36013164,38261962,GC,G,1
NC_037347.1,NC_032669.1,36060868,36060870,38309680,AAC,A,2
NC_037347.1,NC_032669.1,36062552,36062554,38311360,ACT,A,2
NC_037347.1,NC_032669.1,36070515,36070516,38319310,AT,A,1
NC_037347.1,NC_032669.1,36070522,36070523,38319316,CA,C,1
NC_037347.1,NC_032669.1,36070530,36070532,38319323,TTA,T,2
NC_037347.1,NC_032669.1,36070545,36070546,38319336,CA,C,1
NC_037347.1,NC_032669.1,36103987,36103988,38352776,GA,G,1
NC_037347.1,NC_032669.1,36106471,36106472,38355249,CT,C,1
NC_037347.1,NC_032669.1,36209186,36209187,38457584,CA,C,1
NC_037347.1,NC_032669.1,36291311,36291312,38539708,AG,A,1
NC_037347.1,NC_032669.1,36332629,36332630,38578117,TC,T,1
NC_037347.1,NC_032669.1,36673452,36673455,38918914,GGAA,G,3
NC_037347.1,NC_032669.1,36837263,36837264,39083781,AT,A,1
NC_037347.1,NC_032669.1,37041838,37041839,39289142,GT,G,1
NC_037347.1,NC_032669.1,37146847,37146848,39394402,CT,C,1
NC_037347.1,NC_032669.1,37218190,37218191,39467208,CG,C,1
NC_037347.1,NC_032669.1,37341014,37341015,39592324,GC,G,1
NC_037347.1,NC_032669.1,37368476,37368490,39622437,TAATTTAATGAGATG,T,14
NC_037347.1,NC_032669.1,37393645,37393646,39647596,AT,A,1
NC_037347.1,NC_032669.1,37395818,37395820,39649786,CCT,C,2
NC_037347.1,NC_032669.1,37824379,37824380,40083422,CA,C,1
NC_037347.1,NC_032669.1,37923248,37923249,40182223,AG,A,1
NC_037347.1,NC_032669.1,37923284,37923285,40182257,AG,A,1
NC_037347.1,NC_032669.1,37923313,37923314,40182285,CT,C,1
NC_037347.1,NC_032669.1,38251916,38251918,40516957,TTC,T,2
NC_037347.1,NC_032669.1,38254315,38254324,40519352,TGCTTGGCGC,T,9
NC_037347.1,NC_032669.1,38310811,38310812,40582637,CA,C,1
NC_037347.1,NC_032669.1,38748489,38748490,41035394,TC,T,1
NC_037347.1,NC_032669.1,38761558,38761559,41048458,AG,A,1
NC_037347.1,NC_032669.1,38837255,38837256,41172690,AG,A,1
NC_037347.1,NC_032669.1,38839662,38839664,41175095,ACT,A,2
NC_037347.1,NC_032669.1,38840812,38840814,41176258,CCG,C,2
NC_037347.1,NC_032669.1,38892278,38892279,41227714,CA,C,1
NC_037347.1,NC_032669.1,38892282,38892283,41227717,TG,T,1
NC_037347.1,NC_032669.1,38894802,38894803,41230237,CA,C,1
NC_037347.1,NC_032669.1,39245732,39245733,41644171,CT,C,1
NC_037347.1,NC_032669.1,39503227,39503228,41984319,TG,T,1
NC_037347.1,NC_032669.1,39512378,39512382,41796047,TGGAA,T,4
NC_037347.1,NC_032669.1,39573452,39573453,41856627,CT,C,1
NC_037347.1,NC_032669.1,39625882,39625884,42099960,AAC,A,2
NC_037347.1,NC_032669.1,39859284,39859285,42338096,GC,G,1
NC_037347.1,NC_032669.1,40921897,40921898,43401565,AG,A,1
NC_037347.1,NC_032669.1,41037155,41037157,43515807,TAA,T,2
NC_037347.1,NC_032669.1,41059087,41059089,43542958,TTC,T,2
NC_037347.1,NC_032669.1,41059802,41059803,43543698,AC,A,1
NC_037347.1,NC_032669.1,41060208,41060209,43544185,AC,A,1
NC_037347.1,NC_032669.1,41060544,41060545,43544764,AC,A,1
NC_037347.1,NC_032669.1,41352836,41352837,43870729,AT,A,1
NC_037347.1,NC_032669.1,41395761,41395762,43913669,TA,T,1
NC_037347.1,NC_032669.1,41925545,41925546,44443482,TG,T,1
NC_037347.1,NC_032669.1,41973978,41973979,44492261,TG,T,1
NC_037347.1,NC_032669.1,41973985,41973986,44492267,AC,A,1
NC_037347.1,NC_032669.1,41985039,41985040,44526651,TA,T,1
NC_037347.1,NC_032669.1,42206061,42206062,44747465,AC,A,1
NC_037347.1,NC_032669.1,42208393,42208394,44749797,GC,G,1
NC_037347.1,NC_032669.1,42342552,42342561,44889856,TTGTGGGAAC,T,9
NC_037347.1,NC_032669.1,43060856,43060857,45701063,CA,C,1
NC_037347.1,NC_032669.1,43085182,43085183,45724634,CA,C,1
NC_037347.1,NC_032669.1,43180341,43180343,45934693,GGA,G,2
NC_037347.1,NC_032669.1,43180393,43180394,45934742,AC,A,1
NC_037347.1,NC_032669.1,43485693,43485694,46174961,AC,A,1
NC_037347.1,NC_032669.1,43508493,43508499,46197776,AGATGTG,A,6
NC_037347.1,NC_032669.1,43517961,43517962,46212846,AT,A,1
NC_037347.1,NC_032669.1,43644735,43644736,46339552,AT,A,1
NC_037347.1,NC_032669.1,43696798,43696799,46391788,TG,T,1
NC_037347.1,NC_032669.1,43810688,43810689,46546114,GT,G,1
NC_037347.1,NC_032669.1,44008151,44008152,46713416,TA,T,1
NC_037347.1,NC_032669.1,44155885,44155895,46831059,TGGTTCCCCTA,T,10
NC_037347.1,NC_032669.1,44187793,44187794,46863371,AG,A,1
NC_037347.1,NC_032669.1,44241312,44241313,46914935,TA,T,1
NC_037347.1,NC_032669.1,44262446,44262462,46936071,TCTAATAATTTTCTCTC,T,16
NC_037347.1,NC_032669.1,44265586,44265587,46939197,AC,A,1
NC_037347.1,NC_032669.1,44439967,44439968,47107035,AT,A,1
NC_037347.1,NC_032669.1,44453664,44453665,47124440,TC,T,1
NC_037347.1,NC_032669.1,44457012,44457013,47127789,TG,T,1
NC_037347.1,NC_032669.1,44479659,44479661,47158090,AAG,A,2
NC_037347.1,NC_032669.1,44479700,44479707,47158128,GAAAATAT,G,7
NC_037347.1,NC_032669.1,44479755,44479756,47158175,TG,T,1
NC_037347.1,NC_032669.1,44489281,44489298,47168266,GGATTGTTCTTACAAGTT,G,17
NC_037347.1,NC_032669.1,44549728,44549732,47228978,TGATA,T,4
NC_037347.1,NC_032669.1,44550055,44550057,47229316,TTA,T,2
NC_037347.1,NC_032669.1,44641802,44641803,47321914,CA,C,1
NC_037347.1,NC_032669.1,44642991,44642992,47327124,AC,A,1
NC_037347.1,NC_032669.1,44647304,44647312,47331444,AAGTTCTTC,A,8
NC_037347.1,NC_032669.1,44648264,44648271,47332412,ACCATCAT,A,7
NC_037347.1,NC_032669.1,44649689,44649691,47333831,CAT,C,2
NC_037347.1,NC_032669.1,44788883,44788884,47473229,CA,C,1
NC_037347.1,NC_032669.1,44826600,44826601,47510963,TA,T,1
NC_037347.1,NC_032669.1,44958005,44958006,47654738,GT,G,1
NC_037347.1,NC_032669.1,44958011,44958012,47654743,TA,T,1
NC_037347.1,NC_032669.1,44958022,44958023,47654753,GT,G,1
NC_037347.1,NC_032669.1,44958028,44958029,47654758,AC,A,1
NC_037347.1,NC_032669.1,44958073,44958074,47654801,TC,T,1
NC_037347.1,NC_032669.1,44962529,44962530,47659257,CT,C,1
NC_037347.1,NC_032669.1,44975650,44975651,47672384,TA,T,1
NC_037347.1,NC_032669.1,44981116,44981117,47677849,TG,T,1
NC_037347.1,NC_032669.1,44983721,44983722,47680453,CT,C,1
NC_037347.1,NC_032669.1,45128010,45128012,47791527,CTT,C,2
NC_037347.1,NC_032669.1,45207351,45207352,47870914,AT,A,1
NC_037347.1,NC_032669.1,45528197,45528198,48270274,CA,C,1
NC_037347.1,NC_032669.1,45528212,45528213,48270288,TA,T,1
NC_037347.1,NC_032669.1,45615107,45615111,48308723,GGGCT,G,4
NC_037347.1,NC_032669.1,45667582,45667583,48361239,TC,T,1
NC_037347.1,NC_032669.1,45729775,45729776,48429656,TA,T,1
NC_037347.1,NC_032669.1,45733617,45733627,48433522,ACTTAAATTGC,A,10
NC_037347.1,NC_032669.1,45752118,45752120,48452028,AAT,A,2
NC_037347.1,NC_032669.1,45895991,45895992,48588057,GA,G,1
NC_037347.1,NC_032669.1,45896000,45896001,48588065,GA,G,1
NC_037347.1,NC_032669.1,45900917,45900918,48592862,TC,T,1
NC_037347.1,NC_032669.1,45921024,45921025,48612902,GA,G,1
NC_037347.1,NC_032669.1,45945391,45945392,48637649,GT,G,1
NC_037347.1,NC_032669.1,45966561,45966564,48660950,ACTG,A,3
NC_037347.1,NC_032669.1,45967524,45967525,48661894,TC,T,1
NC_037347.1,NC_032669.1,46097544,46097545,48792530,GA,G,1
NC_037347.1,NC_032669.1,46130740,46130741,48834362,CA,C,1
NC_037347.1,NC_032669.1,46163008,46163009,48866619,AG,A,1
NC_037347.1,NC_032669.1,46223350,46223352,48928070,CCT,C,2
NC_037347.1,NC_032669.1,46230138,46230139,48934868,CT,C,1
NC_037347.1,NC_032669.1,46274453,46274470,49026089,CTGTCCACCTTCTCAGGG,C,17
NC_037347.1,NC_032669.1,46309144,46309146,49065338,AAG,A,2
NC_037347.1,NC_032669.1,46384879,46384880,49141559,GA,G,1
NC_037347.1,NC_032669.1,46401716,46401717,49158396,TC,T,1
NC_037347.1,NC_032669.1,46459848,46459849,49216143,AG,A,1
NC_037347.1,NC_032669.1,46480116,46480118,49236428,CTT,C,2
NC_037347.1,NC_032669.1,46636218,46636219,49392400,GA,G,1
NC_037347.1,NC_032669.1,46734856,46734859,49490760,TTAC,T,3
NC_037347.1,NC_032669.1,46736175,46736176,49492078,TA,T,1
NC_037347.1,NC_032669.1,46764700,46764701,49520618,GT,G,1
NC_037347.1,NC_032669.1,46764712,46764713,49520629,CT,C,1
NC_037347.1,NC_032669.1,46936767,46936768,49691986,GT,G,1
NC_037347.1,NC_032669.1,47059942,47059943,49815134,AG,A,1
NC_037347.1,NC_032669.1,47062226,47062227,49817419,AG,A,1
NC_037347.1,NC_032669.1,47150547,47150548,49905818,TC,T,1
NC_037347.1,NC_032669.1,47290685,47290686,50045232,CA,C,1
NC_037347.1,NC_032669.1,47290694,47290695,50045240,TA,T,1
NC_037347.1,NC_032669.1,47554911,47554912,50309898,TC,T,1
NC_037347.1,NC_032669.1,47614372,47614373,50369288,AT,A,1
NC_037347.1,NC_032669.1,47615276,47615277,50370190,GT,G,1
NC_037347.1,NC_032669.1,47615285,47615286,50370198,GC,G,1
NC_037347.1,NC_032669.1,47615296,47615297,50370208,GC,G,1
NC_037347.1,NC_032669.1,47674245,47674246,50429142,AT,A,1
NC_037347.1,NC_032669.1,47873741,47873742,50635811,GC,G,1
NC_037347.1,NC_032669.1,47874691,47874715,50636770,TGAGTGGTTAGTGAGGGTATATTGG,T,24
NC_037347.1,NC_032669.1,47876739,47876740,50638795,AC,A,1
NC_037347.1,NC_032669.1,47919310,47919323,50701314,AAGTAAACTATCTT,A,13
NC_037347.1,NC_032669.1,47930811,47930813,50713429,CTT,C,2
NC_037347.1,NC_032669.1,48102459,48102460,50883085,AT,A,1
NC_037347.1,NC_032669.1,48159622,48159623,50941089,CT,C,1
NC_037347.1,NC_032669.1,48159637,48159638,50941103,CA,C,1
NC_037347.1,NC_032669.1,48495146,48495147,51248384,GT,G,1
NC_037347.1,NC_032669.1,48804191,48804192,51557119,AT,A,1
NC_037347.1,NC_032669.1,49356186,49356187,52112992,AC,A,1
NC_037347.1,NC_032669.1,49356514,49356515,52113321,GA,G,1
NC_037347.1,NC_032669.1,49356654,49356658,52113460,GATGT,G,4
NC_037347.1,NC_032669.1,49361169,49361173,52117975,AGTCT,A,4
NC_037347.1,NC_032669.1,49370978,49370979,52127877,TA,T,1
NC_037347.1,NC_032669.1,49442252,49442253,52250198,TC,T,1
NC_037347.1,NC_032669.1,49458481,49458482,52266493,TG,T,1
NC_037347.1,NC_032669.1,49459855,49459870,52267861,ATAATCTTAGGAGTAC,A,15
NC_037347.1,NC_032669.1,49544971,49544973,52352986,TTC,T,2
NC_037347.1,NC_032669.1,49554765,49554766,52362786,CT,C,1
NC_037347.1,NC_032669.1,49680831,49680845,52488526,CTGGAGTGGCTCAGT,C,14
NC_037347.1,NC_032669.1,49683000,49683001,52491055,CT,C,1
NC_037347.1,NC_032669.1,49744520,49744521,52575704,CA,C,1
NC_037347.1,NC_032669.1,50086544,50086545,53154595,TG,T,1
NC_037347.1,NC_032669.1,50273960,50273961,53310319,GA,G,1
NC_037347.1,NC_032669.1,50277644,50277645,53314004,CA,C,1
NC_037347.1,NC_032669.1,50280082,50280083,53316442,AG,A,1
NC_037347.1,NC_032669.1,50433472,50433473,53469853,AT,A,1
NC_037347.1,NC_032669.1,50512260,50512262,53549984,TTG,T,2
NC_037347.1,NC_032669.1,50653636,50653637,53723358,TG,T,1
NC_037347.1,NC_032669.1,50655424,50655425,53725144,GT,G,1
NC_037347.1,NC_032669.1,51037842,51037843,54109045,AT,A,1
NC_037347.1,NC_032669.1,51037849,51037850,54109051,AT,A,1
NC_037347.1,NC_032669.1,51045672,51045673,54116869,AC,A,1
NC_037347.1,NC_032669.1,51114119,51114120,54185887,CA,C,1
NC_037347.1,NC_032669.1,51203001,51203003,54274543,ACT,A,2
NC_037347.1,NC_032669.1,51376084,51376085,54423885,AT,A,1
NC_037347.1,NC_032669.1,51446591,51446592,54529333,AC,A,1
NC_037347.1,NC_032669.1,51456913,51456915,54539642,TTA,T,2
NC_037347.1,NC_032669.1,51488152,51488161,54570894,TTATTAAGTA,T,9
NC_037347.1,NC_032669.1,51488167,51488168,54570900,TG,T,1
NC_037347.1,NC_032669.1,51496387,51496388,54579021,TA,T,1
NC_037347.1,NC_032669.1,51516732,51516733,54599365,AT,A,1
NC_037347.1,NC_032669.1,51516741,51516742,54599373,AT,A,1
NC_037347.1,NC_032669.1,51569675,51569676,54652269,AT,A,1
NC_037347.1,NC_032669.1,51789554,51789555,54870331,CT,C,1
NC_037347.1,NC_032669.1,52058879,52058880,55138916,TC,T,1
NC_037347.1,NC_032669.1,52086730,52086731,55166779,CT,C,1
NC_037347.1,NC_032669.1,52125534,52125535,55205586,TC,T,1
NC_037347.1,NC_032669.1,52226833,52226835,55363626,TTC,T,2
NC_037347.1,NC_032669.1,52398290,52398291,55531828,TA,T,1
NC_037347.1,NC_032669.1,52587805,52587806,55735340,CT,C,1
NC_037347.1,NC_032669.1,52701275,52701276,55939732,AT,A,1
NC_037347.1,NC_032669.1,52970566,52970567,56205236,AG,A,1
NC_037347.1,NC_032669.1,52971415,52971416,56206084,TC,T,1
NC_037347.1,NC_032669.1,53009749,53009750,56250880,CT,C,1
NC_037347.1,NC_032669.1,53031857,53031863,56272981,TCTTAAC,T,6
NC_037347.1,NC_032669.1,53217456,53217457,56458266,TG,T,1
NC_037347.1,NC_032669.1,53255124,53255125,56495962,CA,C,1
NC_037347.1,NC_032669.1,53351319,53351320,56720001,CT,C,1
NC_037347.1,NC_032669.1,53351319,53351320,56594324,CT,C,1
NC_037347.1,NC_032669.1,53393748,53393749,56764884,AT,A,1
NC_037347.1,NC_032669.1,53393748,53393749,56637074,AT,A,1
NC_037347.1,NC_032669.1,53397086,53397087,56768433,AC,A,1
NC_037347.1,NC_032669.1,53397086,53397087,56640416,AC,A,1
NC_037347.1,NC_032669.1,53476554,53476555,56847975,TG,T,1
NC_037347.1,NC_032669.1,53581080,53581081,56952555,GA,G,1
NC_037347.1,NC_032669.1,53581786,53581787,56953260,CA,C,1
NC_037347.1,NC_032669.1,54026835,54026836,57405822,TC,T,1
NC_037347.1,NC_032669.1,54027628,54027629,57406614,TG,T,1
NC_037347.1,NC_032669.1,54064235,54064237,57443378,CTT,C,2
NC_037347.1,NC_032669.1,54068588,54068589,57447721,AT,A,1
NC_037347.1,NC_032669.1,54155207,54155208,57534858,GC,G,1
NC_037347.1,NC_032669.1,54155251,54155252,57534900,AT,A,1
NC_037347.1,NC_032669.1,54155261,54155262,57534909,CT,C,1
NC_037347.1,NC_032669.1,54254235,54254236,57633312,TG,T,1
NC_037347.1,NC_032669.1,54254239,54254240,57633315,GT,G,1
NC_037347.1,NC_032669.1,54254248,54254249,57633323,TA,T,1
NC_037347.1,NC_032669.1,54432983,54432984,57866790,AC,A,1
NC_037347.1,NC_032669.1,54449718,54449719,57883526,TC,T,1
NC_037347.1,NC_032669.1,55371634,55371635,58874466,TA,T,1
NC_037347.1,NC_032669.1,55414489,55414490,58978966,GA,G,1
NC_037347.1,NC_032669.1,55426977,55426978,58991680,GA,G,1
NC_037347.1,NC_032669.1,55428677,55428684,58993405,GGTATACT,G,7
NC_037347.1,NC_032669.1,55532554,55532555,59136817,CA,C,1
NC_037347.1,NC_032669.1,55748970,55748971,59341467,GC,G,1
NC_037347.1,NC_032669.1,55980491,55980492,59430609,TG,T,1
NC_037347.1,NC_032669.1,56203786,56203787,59655019,GA,G,1
NC_037347.1,NC_032669.1,56488155,56488156,59962702,GA,G,1
NC_037347.1,NC_032669.1,56505097,56505100,59979645,TGTC,T,3
NC_037347.1,NC_032669.1,56507316,56507317,59981775,GC,G,1
NC_037347.1,NC_032669.1,56515915,56515916,59990372,CT,C,1
NC_037347.1,NC_032669.1,56528055,56528056,60002118,CA,C,1
NC_037347.1,NC_032669.1,56686934,56686953,60230671,ACCTCACTCTAAGTATTTCT,A,19
NC_037347.1,NC_032669.1,56751948,56751949,60295907,TG,T,1
NC_037347.1,NC_032669.1,57104314,57104315,60648535,TA,T,1
NC_037347.1,NC_032669.1,57169758,57169760,60714397,CAT,C,2
NC_037347.1,NC_032669.1,57346839,57346840,60891830,GA,G,1
NC_037347.1,NC_032669.1,57483014,57483015,61026904,TA,T,1
NC_037347.1,NC_032669.1,57484843,57484844,61028735,AT,A,1
NC_037347.1,NC_032669.1,57494566,57494568,61038822,AAT,A,2
NC_037347.1,NC_032669.1,57505867,57505868,61049831,CT,C,1
NC_037347.1,NC_032669.1,57656349,57656350,61209555,CA,C,1
NC_037347.1,NC_032669.1,57802838,57802839,61357046,GC,G,1
NC_037347.1,NC_032669.1,58073584,58073585,61641818,CG,C,1
NC_037347.1,NC_032669.1,58085010,58085011,61653261,TG,T,1
NC_037347.1,NC_032669.1,58089927,58089930,61658199,AACC,A,3
NC_037347.1,NC_032669.1,58094235,58094236,61662495,AC,A,1
NC_037347.1,NC_032669.1,58100706,58100707,61668964,CA,C,1
NC_037347.1,NC_032669.1,58147668,58147669,61715649,AC,A,1
NC_037347.1,NC_032669.1,58231441,58231442,61800559,AC,A,1
NC_037347.1,NC_032669.1,58591987,58591988,62161445,CA,C,1
NC_037347.1,NC_032669.1,58594138,58594139,62163594,AT,A,1
NC_037347.1,NC_032669.1,58780467,58780468,62349532,TG,T,1
NC_037347.1,NC_032669.1,59036289,59036291,62607083,TTG,T,2
NC_037347.1,NC_032669.1,59067445,59067446,62637987,CT,C,1
NC_037347.1,NC_032669.1,59101308,59101309,62674391,CT,C,1
NC_037347.1,NC_032669.1,59101319,59101320,62674401,CT,C,1
NC_037347.1,NC_032669.1,59101333,59101334,62674414,AT,A,1
NC_037347.1,NC_032669.1,59383912,59383913,62957302,AT,A,1
NC_037347.1,NC_032669.1,59384340,59384343,62957729,CGTT,C,3
NC_037347.1,NC_032669.1,59394638,59394639,62968077,AG,A,1
NC_037347.1,NC_032669.1,59405130,59405131,62978579,AG,A,1
NC_037347.1,NC_032669.1,59414893,59414894,62988363,AC,A,1
NC_037347.1,NC_032669.1,59862517,59862518,63462701,CA,C,1
NC_037347.1,NC_032669.1,59904540,59904541,63504589,GA,G,1
NC_037347.1,NC_032669.1,59910844,59910845,63510781,TG,T,1
NC_037347.1,NC_032669.1,59921077,59921078,63522452,TA,T,1
NC_037347.1,NC_032669.1,59988087,59988088,63591225,AT,A,1
NC_037347.1,NC_032669.1,60232424,60232425,63935587,AT,A,1
NC_037347.1,NC_032669.1,60273180,60273181,63976367,TC,T,1
NC_037347.1,NC_032669.1,60521067,60521068,64199885,AG,A,1
NC_037347.1,NC_032669.1,60723506,60723507,64390707,GT,G,1
NC_037347.1,NC_032669.1,60724358,60724359,64391556,AG,A,1
NC_037347.1,NC_032669.1,60724689,60724691,64391885,CTT,C,2
NC_037347.1,NC_032669.1,60725383,60725384,64392574,AG,A,1
NC_037347.1,NC_032669.1,60726702,60726703,64393894,TG,T,1
NC_037347.1,NC_032669.1,60865096,60865097,64537510,GA,G,1
NC_037347.1,NC_032669.1,61332838,61332900,65006109,GACAACCAATCTAAGATTCTGTAGTATCCAACTCTATTACTCTAGTCTGTTGCTCCCTGAAAT,G,62
NC_037347.1,NC_032669.1,61364159,61364160,65037375,TG,T,1
NC_037347.1,NC_032669.1,61457588,61457589,65130439,AG,A,1
NC_037347.1,NC_032669.1,61517952,61517954,65190703,GAT,G,2
NC_037347.1,NC_032669.1,61817960,61817966,65490964,CTGGGTG,C,6
NC_037347.1,NC_032669.1,61833693,61833694,65515808,TG,T,1
NC_037347.1,NC_032669.1,61871491,61871492,65553644,CA,C,1
NC_037347.1,NC_032669.1,61873369,61873370,65555523,CT,C,1
NC_037347.1,NC_032669.1,62000876,62000877,65678378,TG,T,1
NC_037347.1,NC_032669.1,62028298,62028299,65705798,TG,T,1
NC_037347.1,NC_032669.1,62071679,62071680,65749474,TG,T,1
NC_037347.1,NC_032669.1,62160904,62160905,65836224,TG,T,1
NC_037347.1,NC_032669.1,62178296,62178297,65854682,AC,A,1
NC_037347.1,NC_032669.1,62206221,62206222,65901182,GT,G,1
NC_037347.1,NC_032669.1,62364925,62364928,66066709,CGTG,C,3
NC_037347.1,NC_032669.1,62735394,62735395,66467977,AG,A,1
NC_037347.1,NC_032669.1,62737587,62737588,66470194,CG,C,1
NC_037347.1,NC_032669.1,62739082,62739083,66471689,GT,G,1
NC_037347.1,NC_032669.1,62740330,62740331,66472936,GT,G,1
NC_037347.1,NC_032669.1,62744068,62744069,66476670,CA,C,1
NC_037347.1,NC_032669.1,62745818,62745820,66478419,CCA,C,2
NC_037347.1,NC_032669.1,62748852,62748853,66481453,AC,A,1
NC_037347.1,NC_032669.1,62749648,62749651,66491887,CCTT,C,3
NC_037347.1,NC_032669.1,62759448,62759449,66501698,CA,C,1
NC_037347.1,NC_032669.1,62899993,62899994,66642101,GT,G,1
NC_037347.1,NC_032669.1,62953146,62953147,66695042,GT,G,1
NC_037347.1,NC_032669.1,62993497,62993498,66735648,GA,G,1
NC_037347.1,NC_032669.1,62995373,62995378,66737521,AGTATC,A,5
NC_037347.1,NC_032669.1,63786540,63786541,67672265,TC,T,1
NC_037347.1,NC_032669.1,63786555,63786557,67672279,CCA,C,2
NC_037347.1,NC_032669.1,63786565,63786566,67672287,GT,G,1
NC_037347.1,NC_032669.1,63821611,63821613,67707438,GGT,G,2
NC_037347.1,NC_032669.1,63834837,63834839,67720666,GCA,G,2
NC_037347.1,NC_032669.1,63883408,63883409,67769437,CT,C,1
NC_037347.1,NC_032669.1,63883420,63883421,67769448,AT,A,1
NC_037347.1,NC_032669.1,63883455,63883456,67769480,TG,T,1
NC_037347.1,NC_032669.1,63894126,63894127,67780119,AG,A,1
NC_037347.1,NC_032669.1,63940152,63940153,67826329,TG,T,1
NC_037347.1,NC_032669.1,63952861,63952862,67839356,TC,T,1
NC_037347.1,NC_032669.1,63953068,63953069,67839562,CT,C,1
NC_037347.1,NC_032669.1,63956846,63956847,67843530,AG,A,1
NC_037347.1,NC_032669.1,63972976,63972977,67859662,AC,A,1
NC_037347.1,NC_032669.1,63976478,63976479,67863118,TC,T,1
NC_037347.1,NC_032669.1,64052970,64052971,67939286,GT,G,1
NC_037347.1,NC_032669.1,64052996,64052997,67939311,GC,G,1
NC_037347.1,NC_032669.1,64057516,64057517,67943832,GA,G,1
NC_037347.1,NC_032669.1,64125474,64125475,68029761,AC,A,1
NC_037347.1,NC_032669.1,64184495,64184496,68089641,CT,C,1
NC_037347.1,NC_032669.1,64214592,64214593,68120008,TC,T,1
NC_037347.1,NC_032669.1,64246102,64246103,68144007,AG,A,1
NC_037347.1,NC_032669.1,64251747,64251748,68149652,TA,T,1
NC_037347.1,NC_032669.1,64264169,64264170,68162068,TC,T,1
NC_037347.1,NC_032669.1,64283170,64283171,68181063,AT,A,1
NC_037347.1,NC_032669.1,64283860,64283864,68181752,GGTTT,G,4
NC_037347.1,NC_032669.1,64307096,64307098,68204989,TTC,T,2
NC_037347.1,NC_032669.1,64307152,64307153,68205042,AT,A,1
NC_037347.1,NC_032669.1,64393468,64393469,68290993,TA,T,1
NC_037347.1,NC_032669.1,64393483,64393484,68291007,CA,C,1
NC_037347.1,NC_032669.1,64393493,64393494,68291016,CA,C,1
NC_037347.1,NC_032669.1,64451618,64451619,68349080,AG,A,1
NC_037347.1,NC_032669.1,64487287,64487288,68384746,AC,A,1
NC_037347.1,NC_032669.1,64529065,64529066,68426520,AC,A,1
NC_037347.1,NC_032669.1,64842271,64842272,68697554,GC,G,1
NC_037347.1,NC_032669.1,64842289,64842297,68697571,TTCCTCTGC,T,8
NC_037347.1,NC_032669.1,64972651,64972652,68831944,CA,C,1
NC_037347.1,NC_032669.1,64972666,64972668,68831958,GGT,G,2
NC_037347.1,NC_032669.1,65112573,65112574,68974433,CA,C,1
NC_037347.1,NC_032669.1,65112986,65112992,68974846,AAGGAAG,A,6
NC_037347.1,NC_032669.1,65115254,65115255,68977114,CG,C,1
NC_037347.1,NC_032669.1,65152506,65152507,69016223,CT,C,1
NC_037347.1,NC_032669.1,65161718,65161720,69025439,ATC,A,2
NC_037347.1,NC_032669.1,65161725,65161732,69025444,TTTTTCAG,T,7
NC_037347.1,NC_032669.1,65161747,65161748,69025459,CA,C,1
NC_037347.1,NC_032669.1,65166514,65166515,69030237,CT,C,1
NC_037347.1,NC_032669.1,65166833,65166834,69030555,AC,A,1
NC_037347.1,NC_032669.1,65259836,65259837,69240073,AG,A,1
NC_037347.1,NC_032669.1,65262277,65262278,69242522,AC,A,1
NC_037347.1,NC_032669.1,65265475,65265476,69245717,CT,C,1
NC_037347.1,NC_032669.1,65274830,65274831,69084367,TG,T,1
NC_037347.1,NC_032669.1,66216206,66216212,70111340,TCTGGTA,T,6
NC_037347.1,NC_032669.1,66313624,66313625,70208752,GA,G,1
NC_037347.1,NC_032669.1,66337124,66337125,70232260,AT,A,1
NC_037347.1,NC_032669.1,66439005,66439006,70335248,GA,G,1
NC_037347.1,NC_032669.1,66598604,66598605,70495728,CA,C,1
NC_037347.1,NC_032669.1,66599239,66599243,70496361,CGGCG,C,4
NC_037347.1,NC_032669.1,66664668,66664669,70561858,CA,C,1
NC_037347.1,NC_032669.1,66935311,66935312,70785936,TC,T,1
NC_037347.1,NC_032669.1,67041398,67041399,70893237,GC,G,1
NC_037347.1,NC_032669.1,67041807,67041808,70893645,CT,C,1
NC_037347.1,NC_032669.1,67165837,67165838,71014439,TG,T,1
NC_037347.1,NC_032669.1,67167918,67167919,71016520,GC,G,1
NC_037347.1,NC_032669.1,67168781,67168782,71017381,CT,C,1
NC_037347.1,NC_032669.1,67375750,67375751,71201622,TA,T,1
NC_037347.1,NC_032669.1,67380570,67380572,71206440,AAG,A,2
NC_037347.1,NC_032669.1,67388794,67388796,71214560,GGT,G,2
NC_037347.1,NC_032669.1,67388806,67388807,71214570,CT,C,1
NC_037347.1,NC_032669.1,67667432,67667434,71580666,CAT,C,2
NC_037347.1,NC_032669.1,67675690,67675691,71588923,GT,G,1
NC_037347.1,NC_032669.1,67767238,67767239,71681056,GC,G,1
NC_037347.1,NC_032669.1,67981038,67981039,71915143,AG,A,1
NC_037347.1,NC_032669.1,67981058,67981059,71915162,TG,T,1
NC_037347.1,NC_032669.1,67981105,67981106,71915207,TG,T,1
NC_037347.1,NC_032669.1,67982414,67982415,71916515,AT,A,1
NC_037347.1,NC_032669.1,67982612,67982613,71916712,AG,A,1
NC_037347.1,NC_032669.1,67988322,67988323,71922424,CA,C,1
NC_037347.1,NC_032669.1,68074918,68074919,72009262,CT,C,1
NC_037347.1,NC_032669.1,68242700,68242701,72183711,CA,C,1
NC_037347.1,NC_032669.1,68244830,68244832,72185672,CTT,C,2
NC_037347.1,NC_032669.1,68250030,68250044,72190873,CAGAGTCAAGCTTCA,C,14
NC_037347.1,NC_032669.1,68261362,68261364,72201986,TCC,T,2
NC_037347.1,NC_032669.1,68280994,68280995,72221689,TC,T,1
NC_037347.1,NC_032669.1,68291937,68291939,72232637,CCT,C,2
NC_037347.1,NC_032669.1,68292544,68292643,72233242,AGTGCTGCACACAGAGCACAGTATTCCCACAGGGGTGCTGCATACATAACACAGTACTCCCACAGGGGTTCTGCACACAGAGCACAGTACTCCCACAGGG,A,99
NC_037347.1,NC_032669.1,68320079,68320116,72260749,CGTGGGTAACAGGTATTATCCGTGCAGGGGAGGCGACA,C,37
NC_037347.1,NC_032669.1,68337226,68337227,72278125,AC,A,1
NC_037347.1,NC_032669.1,68338712,68338716,72279651,CTAAG,C,4
NC_037347.1,NC_032669.1,68340213,68340214,72281146,GC,G,1
NC_037347.1,NC_032669.1,68549796,68549797,72491194,AG,A,1
NC_037347.1,NC_032669.1,68632737,68632739,72616533,CAG,C,2
NC_037347.1,NC_032669.1,68652690,68652692,72636901,CTG,C,2
NC_037347.1,NC_032669.1,68904133,68904134,72887119,TG,T,1
NC_037347.1,NC_032669.1,68930811,68930814,72913511,GGCT,G,3
NC_037347.1,NC_032669.1,68961474,68961475,72945211,CA,C,1
NC_037347.1,NC_032669.1,68980233,68980234,72965175,TC,T,1
NC_037347.1,NC_032669.1,68992200,68992201,72984324,TC,T,1
NC_037347.1,NC_032669.1,68992238,68992239,72984361,GT,G,1
NC_037347.1,NC_032669.1,69247694,69247695,73254348,TC,T,1
NC_037347.1,NC_032669.1,69488644,69488645,73468591,CT,C,1
NC_037347.1,NC_032669.1,69488658,69488659,73468604,TC,T,1
NC_037347.1,NC_032669.1,69498253,69498254,73478304,AG,A,1
NC_037347.1,NC_032669.1,69502317,69502319,73482367,CCT,C,2
NC_037347.1,NC_032669.1,69517159,69517160,73497050,TC,T,1
NC_037347.1,NC_032669.1,69541698,69541699,73521586,CG,C,1
NC_037347.1,NC_032669.1,69602714,69602715,73582049,GC,G,1
NC_037347.1,NC_032669.1,69629012,69629013,73608388,AG,A,1
NC_037347.1,NC_032669.1,69688885,69688892,73676881,AGAAGGAC,A,7
NC_037347.1,NC_032669.1,69776671,69776672,73764190,AT,A,1
NC_037347.1,NC_032669.1,69899013,69899014,73885617,CT,C,1
NC_037347.1,NC_032669.1,69936891,69936892,73924127,CA,C,1
NC_037347.1,NC_032669.1,69948323,69948324,73935136,AC,A,1
NC_037347.1,NC_032669.1,70045597,70045598,74081976,GA,G,1
NC_037347.1,NC_032669.1,70060428,70060429,74096730,CT,C,1
NC_037347.1,NC_032669.1,70061263,70061264,74097564,GC,G,1
NC_037347.1,NC_032669.1,70340977,70340979,74379666,CTT,C,2
NC_037347.1,NC_032669.1,70343575,70343576,74382270,GA,G,1
NC_037347.1,NC_032669.1,70345275,70345276,74383969,CT,C,1
NC_037347.1,NC_032669.1,70357227,70357229,74396451,TAC,T,2
NC_037347.1,NC_032669.1,70359135,70359143,74398357,GCTCCCCAC,G,8
NC_037347.1,NC_032669.1,70359895,70359896,74399110,GC,G,1
NC_037347.1,NC_032669.1,70359975,70359976,74399189,CA,C,1
NC_037347.1,NC_032669.1,70363374,70363375,74402590,CT,C,1
NC_037347.1,NC_032669.1,70365542,70365543,74404756,TC,T,1
NC_037347.1,NC_032669.1,70367585,70367586,74406898,TG,T,1
NC_037347.1,NC_032669.1,70418896,70418897,74458080,AG,A,1
NC_037347.1,NC_032669.1,70455111,70455112,74495433,GA,G,1
NC_037347.1,NC_032669.1,70624524,70624525,74684986,TA,T,1
NC_037347.1,NC_032669.1,70731194,70731195,74791733,GC,G,1
NC_037347.1,NC_032669.1,70811869,70811870,74872208,GC,G,1
NC_037347.1,NC_032669.1,70811941,70811945,74872279,GCAGC,G,4
NC_037347.1,NC_032669.1,70953253,70953254,74990127,CT,C,1
NC_037347.1,NC_032669.1,70955257,70955269,74992130,CCCACCCCTAACT,C,12
NC_037347.1,NC_032669.1,71179592,71179593,75215738,CT,C,1
NC_037347.1,NC_032669.1,71257025,71257026,75354308,CG,C,1
NC_037347.1,NC_032669.1,71257030,71257031,75354312,AG,A,1
NC_037347.1,NC_032669.1,71271587,71271588,75368429,CG,C,1
NC_037347.1,NC_032669.1,71281243,71281244,75378928,TA,T,1
