Reference ID,Query ID,Reference POS,Reference END,Query POS,REF,ALT,SVLEN
NC_037338.1,NC_032660.1,209647,209648,207288,CT,C,1
NC_037338.1,NC_032660.1,235730,235732,233371,TTG,T,2
NC_037338.1,NC_032660.1,240453,240454,238094,AG,A,1
NC_037338.1,NC_032660.1,307488,307489,305176,AC,A,1
NC_037338.1,NC_032660.1,410782,410795,408454,GTGGTTCCTGGTAA,G,13
NC_037338.1,NC_032660.1,517148,517151,517697,TGGG,T,3
NC_037338.1,NC_032660.1,671454,671455,672022,CT,C,1
NC_037338.1,NC_032660.1,709325,709326,766741,CT,C,1
NC_037338.1,NC_032660.1,831165,831176,889712,TACTCCCTTTCC,T,11
NC_037338.1,NC_032660.1,1209220,1209221,1271020,CA,C,1
NC_037338.1,NC_032660.1,1244377,1244382,1306245,AGGCTG,A,5
NC_037338.1,NC_032660.1,1312257,1312264,1374555,ATGTGCAC,A,7
NC_037338.1,NC_032660.1,1372949,1372951,1434817,CTG,C,2
NC_037338.1,NC_032660.1,1441797,1441800,1506428,AAAC,A,3
NC_037338.1,NC_032660.1,1443116,1443122,1507748,ACCCTGT,A,6
NC_037338.1,NC_032660.1,1619907,1619908,1685382,TG,T,1
NC_037338.1,NC_032660.1,1866208,1866209,1985199,CA,C,1
NC_037338.1,NC_032660.1,1867133,1867134,1986123,TG,T,1
NC_037338.1,NC_032660.1,1867133,1867134,2176239,TG,T,1
NC_037338.1,NC_032660.1,1867958,1867959,1986939,AT,A,1
NC_037338.1,NC_032660.1,1867958,1867959,2175423,AT,A,1
NC_037338.1,NC_032660.1,1868334,1868335,1987314,CG,C,1
NC_037338.1,NC_032660.1,1870905,1870907,1989936,TGC,T,2
NC_037338.1,NC_032660.1,1870905,1870907,2172426,TGC,T,2
NC_037338.1,NC_032660.1,1999632,1999633,2240533,TC,T,1
NC_037338.1,NC_032660.1,2098714,2098715,2374007,CA,C,1
NC_037338.1,NC_032660.1,2136013,2136014,2411134,AC,A,1
NC_037338.1,NC_032660.1,2136057,2136058,2411177,TA,T,1
NC_037338.1,NC_032660.1,2136837,2136838,2411960,AC,A,1
NC_037338.1,NC_032660.1,2156653,2156654,2431726,GT,G,1
NC_037338.1,NC_032660.1,2168060,2168061,2443951,TC,T,1
NC_037338.1,NC_032660.1,2231711,2231712,2509228,AG,A,1
NC_037338.1,NC_032660.1,2263343,2263344,2540861,AC,A,1
NC_037338.1,NC_032660.1,2306660,2306661,2584214,GA,G,1
NC_037338.1,NC_032660.1,2380819,2380820,2658134,CA,C,1
NC_037338.1,NC_032660.1,2383565,2383566,2660879,AT,A,1
NC_037338.1,NC_032660.1,2430106,2430107,2707451,TC,T,1
NC_037338.1,NC_032660.1,2722915,2722917,2999371,CCA,C,2
NC_037338.1,NC_032660.1,2722928,2722929,2999382,TC,T,1
NC_037338.1,NC_032660.1,2722949,2722950,2999402,TC,T,1
NC_037338.1,NC_032660.1,2728691,2728692,3005145,GA,G,1
NC_037338.1,NC_032660.1,2728712,2728713,3005165,GA,G,1
NC_037338.1,NC_032660.1,2728825,2728827,3005276,TTG,T,2
NC_037338.1,NC_032660.1,2729015,2729016,3005464,AT,A,1
NC_037338.1,NC_032660.1,2786661,2786666,3063183,ATCTTG,A,5
NC_037338.1,NC_032660.1,3085419,3085420,3364030,CT,C,1
NC_037338.1,NC_032660.1,3087143,3087148,3365753,AGTAAC,A,5
NC_037338.1,NC_032660.1,3088814,3088815,3367416,TC,T,1
NC_037338.1,NC_032660.1,3099721,3099722,3378459,CG,C,1
NC_037338.1,NC_032660.1,3219383,3219384,3498164,GT,G,1
NC_037338.1,NC_032660.1,3244105,3244106,3523009,GT,G,1
NC_037338.1,NC_032660.1,3391494,3391496,3662647,TCA,T,2
NC_037338.1,NC_032660.1,3509955,3509958,3781730,ATAT,A,3
NC_037338.1,NC_032660.1,3513517,3513518,3785303,GT,G,1
NC_037338.1,NC_032660.1,3513650,3513652,3785436,TCC,T,2
NC_037338.1,NC_032660.1,3515054,3515055,3786838,CT,C,1
NC_037338.1,NC_032660.1,3541625,3541627,3813376,TAA,T,2
NC_037338.1,NC_032660.1,3542464,3542465,3814212,TC,T,1
NC_037338.1,NC_032660.1,3587441,3587442,3859224,CT,C,1
NC_037338.1,NC_032660.1,3754355,3754356,4025828,CT,C,1
NC_037338.1,NC_032660.1,3826740,3826741,4097993,CG,C,1
NC_037338.1,NC_032660.1,4142108,4142109,4325377,AT,A,1
NC_037338.1,NC_032660.1,4222950,4222951,4406624,GC,G,1
NC_037338.1,NC_032660.1,4278304,4278305,4461972,AT,A,1
NC_037338.1,NC_032660.1,4417828,4417830,4601245,CAT,C,2
NC_037338.1,NC_032660.1,4708969,4708970,4821536,CA,C,1
NC_037338.1,NC_032660.1,4761283,4761284,4873863,TA,T,1
NC_037338.1,NC_032660.1,4781325,4781326,4893904,CA,C,1
NC_037338.1,NC_032660.1,4981412,4981413,5092360,GC,G,1
NC_037338.1,NC_032660.1,5062991,5062992,5173942,GT,G,1
NC_037338.1,NC_032660.1,5103983,5103984,5214713,GA,G,1
NC_037338.1,NC_032660.1,5133346,5133347,5244087,AC,A,1
NC_037338.1,NC_032660.1,5274900,5274901,5385709,GT,G,1
NC_037338.1,NC_032660.1,5373325,5373326,5511559,GA,G,1
NC_037338.1,NC_032660.1,5429068,5429069,5567056,GC,G,1
NC_037338.1,NC_032660.1,5445052,5445054,5583043,TTC,T,2
NC_037338.1,NC_032660.1,5448771,5448772,5586759,TG,T,1
NC_037338.1,NC_032660.1,5456864,5456865,5594853,TA,T,1
NC_037338.1,NC_032660.1,5457294,5457295,5595282,CT,C,1
NC_037338.1,NC_032660.1,5477757,5477758,5615539,AG,A,1
NC_037338.1,NC_032660.1,5713906,5713907,5852339,AG,A,1
NC_037338.1,NC_032660.1,5747728,5747729,5886637,GT,G,1
NC_037338.1,NC_032660.1,5777532,5777533,5915748,AT,A,1
NC_037338.1,NC_032660.1,5861080,5861086,5998215,AGTGGGG,A,6
NC_037338.1,NC_032660.1,5871891,5871892,6009026,AT,A,1
NC_037338.1,NC_032660.1,6101276,6101277,6259754,CG,C,1
NC_037338.1,NC_032660.1,6138572,6138573,6296735,AG,A,1
NC_037338.1,NC_032660.1,6182741,6182742,6340940,GC,G,1
NC_037338.1,NC_032660.1,6208549,6208550,6366751,CG,C,1
NC_037338.1,NC_032660.1,6218146,6218147,6376388,CA,C,1
NC_037338.1,NC_032660.1,6218237,6218238,6376478,TG,T,1
NC_037338.1,NC_032660.1,6218826,6218841,6377073,CAATGGACCCAACCCA,C,15
NC_037338.1,NC_032660.1,6223343,6223344,6381576,TG,T,1
NC_037338.1,NC_032660.1,6234211,6234212,6392441,GA,G,1
NC_037338.1,NC_032660.1,6249075,6249076,6407297,AC,A,1
NC_037338.1,NC_032660.1,6295572,6295573,6453806,TG,T,1
NC_037338.1,NC_032660.1,6295585,6295586,6453818,AC,A,1
NC_037338.1,NC_032660.1,6295893,6295894,6454124,TA,T,1
NC_037338.1,NC_032660.1,6317380,6317381,6474493,CA,C,1
NC_037338.1,NC_032660.1,6357640,6357641,6514703,CA,C,1
NC_037338.1,NC_032660.1,6843599,6843609,7048261,TGGCTTCGTTC,T,10
NC_037338.1,NC_032660.1,6928932,6928933,7144565,TA,T,1
NC_037338.1,NC_032660.1,6931545,6931546,7147177,CA,C,1
NC_037338.1,NC_032660.1,6932174,6932178,7147805,TGAGG,T,4
NC_037338.1,NC_032660.1,7343954,7343955,7550180,CA,C,1
NC_037338.1,NC_032660.1,7551841,7551842,7758077,CT,C,1
NC_037338.1,NC_032660.1,7574148,7574151,7780364,TTAA,T,3
NC_037338.1,NC_032660.1,7615232,7615233,7821480,AT,A,1
NC_037338.1,NC_032660.1,7650075,7650076,7856239,CT,C,1
NC_037338.1,NC_032660.1,7768441,7768443,7974532,CCT,C,2
NC_037338.1,NC_032660.1,7830913,7830917,8036983,CTTCA,C,4
NC_037338.1,NC_032660.1,7884784,7884785,8090862,GT,G,1
NC_037338.1,NC_032660.1,8147324,8147325,8356467,CG,C,1
NC_037338.1,NC_032660.1,8156736,8156737,8365806,GA,G,1
NC_037338.1,NC_032660.1,8231073,8231074,8439860,GT,G,1
NC_037338.1,NC_032660.1,8231088,8231089,8439874,GT,G,1
NC_037338.1,NC_032660.1,8231136,8231138,8439920,CCT,C,2
NC_037338.1,NC_032660.1,8234495,8234496,8443277,AC,A,1
NC_037338.1,NC_032660.1,8420513,8420514,8632533,CG,C,1
NC_037338.1,NC_032660.1,8428042,8428043,8640079,CT,C,1
NC_037338.1,NC_032660.1,8750106,8750109,8964734,CACT,C,3
NC_037338.1,NC_032660.1,8756383,8756387,8970981,TCAAG,T,4
NC_037338.1,NC_032660.1,8756390,8756392,8970984,TAC,T,2
NC_037338.1,NC_032660.1,8757184,8757185,8971775,AG,A,1
NC_037338.1,NC_032660.1,8826615,8826620,9041216,TCTGCC,T,5
NC_037338.1,NC_032660.1,9013277,9013278,9236382,AT,A,1
NC_037338.1,NC_032660.1,9013282,9013283,9236386,AT,A,1
NC_037338.1,NC_032660.1,9077428,9077429,9325238,TG,T,1
NC_037338.1,NC_032660.1,9113001,9113002,9360809,AG,A,1
NC_037338.1,NC_032660.1,9113014,9113015,9360821,AG,A,1
NC_037338.1,NC_032660.1,9263145,9263146,9513022,CT,C,1
NC_037338.1,NC_032660.1,9291355,9291356,9541230,TG,T,1
NC_037338.1,NC_032660.1,9465611,9465612,9718329,AG,A,1
NC_037338.1,NC_032660.1,9807577,9807578,10112761,TA,T,1
NC_037338.1,NC_032660.1,9910866,9910868,10216165,TAG,T,2
NC_037338.1,NC_032660.1,10594275,10594276,10948068,CA,C,1
NC_037338.1,NC_032660.1,10594332,10594333,10948121,TA,T,1
NC_037338.1,NC_032660.1,10594342,10594343,10948130,CA,C,1
NC_037338.1,NC_032660.1,10594354,10594355,10948141,CA,C,1
NC_037338.1,NC_032660.1,10770591,10770592,11171631,TA,T,1
NC_037338.1,NC_032660.1,10903402,10903403,11305726,TA,T,1
NC_037338.1,NC_032660.1,10928299,10928300,11329993,AT,A,1
NC_037338.1,NC_032660.1,10939311,10939312,11341024,AG,A,1
NC_037338.1,NC_032660.1,11244936,11244937,11703407,TC,T,1
NC_037338.1,NC_032660.1,11269781,11269782,11728239,GA,G,1
NC_037338.1,NC_032660.1,11390269,11390270,11848886,AT,A,1
NC_037338.1,NC_032660.1,11405554,11405555,11863827,TA,T,1
NC_037338.1,NC_032660.1,12125205,12125206,12607600,TC,T,1
NC_037338.1,NC_032660.1,12250944,12250945,12732965,AC,A,1
NC_037338.1,NC_032660.1,12250956,12250957,12732976,CT,C,1
NC_037338.1,NC_032660.1,12445491,12445492,12927285,AG,A,1
NC_037338.1,NC_032660.1,12518563,12518564,13002965,CA,C,1
NC_037338.1,NC_032660.1,12889200,12889201,13450363,GA,G,1
NC_037338.1,NC_032660.1,12903655,12903656,13464852,AG,A,1
NC_037338.1,NC_032660.1,13264299,13264300,13881901,AG,A,1
NC_037338.1,NC_032660.1,13562700,13562701,14185313,AC,A,1
NC_037338.1,NC_032660.1,13641064,13641065,14273551,TG,T,1
NC_037338.1,NC_032660.1,13754027,13754028,14386468,TA,T,1
NC_037338.1,NC_032660.1,13760008,13760010,14392478,TAA,T,2
NC_037338.1,NC_032660.1,13995521,13995523,14627869,AAC,A,2
NC_037338.1,NC_032660.1,13995536,13995537,14627882,TA,T,1
NC_037338.1,NC_032660.1,14023684,14023685,14656075,CA,C,1
NC_037338.1,NC_032660.1,14023694,14023695,14656084,AG,A,1
NC_037338.1,NC_032660.1,14145091,14145092,14778346,CT,C,1
NC_037338.1,NC_032660.1,14195538,14195539,14828796,TA,T,1
NC_037338.1,NC_032660.1,14532282,14532283,15146284,TG,T,1
NC_037338.1,NC_032660.1,14550963,14550964,15164711,TA,T,1
NC_037338.1,NC_032660.1,14550982,14550984,15164729,GGA,G,2
NC_037338.1,NC_032660.1,14551014,14551016,15164759,AAG,A,2
NC_037338.1,NC_032660.1,14558642,14558643,15172257,TA,T,1
NC_037338.1,NC_032660.1,15018918,15018919,15649197,CA,C,1
NC_037338.1,NC_032660.1,15174451,15174452,15797378,CA,C,1
NC_037338.1,NC_032660.1,15326457,15326458,15950046,TA,T,1
NC_037338.1,NC_032660.1,15855130,15855131,16529913,GA,G,1
NC_037338.1,NC_032660.1,15882923,15882924,16726338,GT,G,1
NC_037338.1,NC_032660.1,15925966,15925969,16769399,TATG,T,3
NC_037338.1,NC_032660.1,15983874,15983875,16659723,TG,T,1
NC_037338.1,NC_032660.1,16050006,16050007,16798578,TC,T,1
NC_037338.1,NC_032660.1,16247259,16247260,16995737,TG,T,1
NC_037338.1,NC_032660.1,16329331,16329332,17078519,TG,T,1
NC_037338.1,NC_032660.1,16338739,16338740,17087930,GT,G,1
NC_037338.1,NC_032660.1,16360521,16360522,17303251,TA,T,1
NC_037338.1,NC_032660.1,16773850,16773851,17622111,GT,G,1
NC_037338.1,NC_032660.1,16954123,16954125,17821201,GGC,G,2
NC_037338.1,NC_032660.1,16971991,16971999,17838773,CTATAGGAT,C,8
NC_037338.1,NC_032660.1,16998702,16998705,17865753,TAGG,T,3
NC_037338.1,NC_032660.1,17012386,17012387,17879224,AT,A,1
NC_037338.1,NC_032660.1,17231056,17231057,18188509,AC,A,1
NC_037338.1,NC_032660.1,17260682,17260683,18216811,GT,G,1
NC_037338.1,NC_032660.1,17293130,17293165,18117488,AAGGTAAATTATATTTACCTCACAGCCCAGTATAAG,A,35
NC_037338.1,NC_032660.1,17368954,17368955,18401996,GT,G,1
NC_037338.1,NC_032660.1,17372723,17372729,18406587,ATTATCT,A,6
NC_037338.1,NC_032660.1,17741450,17741451,18721869,TG,T,1
NC_037338.1,NC_032660.1,17771614,17771617,18747582,TAAG,T,3
NC_037338.1,NC_032660.1,17771619,17771620,18747584,CA,C,1
NC_037338.1,NC_032660.1,17785094,17785095,18761081,CG,C,1
NC_037338.1,NC_032660.1,17829157,17829158,18805626,CT,C,1
NC_037338.1,NC_032660.1,17881587,17881588,18858824,AG,A,1
NC_037338.1,NC_032660.1,17899550,17899551,18876790,AC,A,1
NC_037338.1,NC_032660.1,17943253,17943254,18920112,TA,T,1
NC_037338.1,NC_032660.1,18018921,18018922,18994445,CA,C,1
NC_037338.1,NC_032660.1,18191348,18191351,19184149,AATC,A,3
NC_037338.1,NC_032660.1,18333664,18333665,19331485,TG,T,1
NC_037338.1,NC_032660.1,18366964,18366965,19364785,AT,A,1
NC_037338.1,NC_032660.1,18368385,18368386,19366203,AG,A,1
NC_037338.1,NC_032660.1,18411852,18411853,19409685,TA,T,1
NC_037338.1,NC_032660.1,18448016,18448017,19445858,AC,A,1
NC_037338.1,NC_032660.1,18454871,18454872,19452713,AT,A,1
NC_037338.1,NC_032660.1,18495556,18495557,19493412,CT,C,1
NC_037338.1,NC_032660.1,18554830,18554831,19567212,GA,G,1
NC_037338.1,NC_032660.1,18554834,18554835,19567215,AC,A,1
NC_037338.1,NC_032660.1,18696602,18696603,19710330,TC,T,1
NC_037338.1,NC_032660.1,19000777,19000779,20014183,TTC,T,2
NC_037338.1,NC_032660.1,19211759,19211760,21266584,CT,C,1
NC_037338.1,NC_032660.1,20229118,20229119,20873922,GT,G,1
NC_037338.1,NC_032660.1,20231392,20231393,20876195,CT,C,1
NC_037338.1,NC_032660.1,20295482,20295483,20940358,GC,G,1
NC_037338.1,NC_032660.1,20389547,20389549,21034568,CTT,C,2
NC_037338.1,NC_032660.1,20394574,20394579,21039593,ATGTTT,A,5
NC_037338.1,NC_032660.1,20534783,20534785,21681012,GGC,G,2
NC_037338.1,NC_032660.1,20708482,20708483,21918833,GA,G,1
NC_037338.1,NC_032660.1,20810659,20810660,22021020,GT,G,1
NC_037338.1,NC_032660.1,21285073,21285074,22493166,AG,A,1
NC_037338.1,NC_032660.1,21357175,21357176,22566715,AC,A,1
NC_037338.1,NC_032660.1,21423694,21423695,22633248,CT,C,1
NC_037338.1,NC_032660.1,21423702,21423704,22633255,GGT,G,2
NC_037338.1,NC_032660.1,21431010,21431011,22640568,TC,T,1
NC_037338.1,NC_032660.1,21487834,21487836,22697431,AAT,A,2
NC_037338.1,NC_032660.1,21487845,21487846,22697440,AT,A,1
NC_037338.1,NC_032660.1,21487855,21487857,22697449,TTG,T,2
NC_037338.1,NC_032660.1,21487873,21487874,22697465,AT,A,1
NC_037338.1,NC_032660.1,21699701,21699702,22910327,CA,C,1
NC_037338.1,NC_032660.1,21732640,21732641,22943475,TA,T,1
NC_037338.1,NC_032660.1,21732648,21732649,22943482,CA,C,1
NC_037338.1,NC_032660.1,21949419,21949420,23160282,CG,C,1
NC_037338.1,NC_032660.1,22061719,22061720,23272847,CT,C,1
NC_037338.1,NC_032660.1,22144437,22144438,23355590,AT,A,1
NC_037338.1,NC_032660.1,22144448,22144449,23355600,GA,G,1
NC_037338.1,NC_032660.1,22177995,22177998,23390008,CTGT,C,3
NC_037338.1,NC_032660.1,22228167,22228168,23441032,GA,G,1
NC_037338.1,NC_032660.1,22328871,22328872,23545226,AT,A,1
NC_037338.1,NC_032660.1,22459536,22459537,23675885,GA,G,1
NC_037338.1,NC_032660.1,22573674,22573675,23789980,GA,G,1
NC_037338.1,NC_032660.1,22578804,22578825,23795108,ACCTGGATTGCTAAGGTCCATT,A,21
NC_037338.1,NC_032660.1,22640611,22640612,23856903,AG,A,1
NC_037338.1,NC_032660.1,22767116,22767117,23983228,TG,T,1
NC_037338.1,NC_032660.1,22962525,22962526,24178413,AT,A,1
NC_037338.1,NC_032660.1,23097008,23097009,24307813,TC,T,1
NC_037338.1,NC_032660.1,23174599,23174600,24383744,CA,C,1
NC_037338.1,NC_032660.1,23312702,23312703,24545946,TG,T,1
NC_037338.1,NC_032660.1,23379237,23379238,24612509,GC,G,1
NC_037338.1,NC_032660.1,23509165,23509171,24754767,TTGTAGG,T,6
NC_037338.1,NC_032660.1,23582629,23582630,24829144,TG,T,1
NC_037338.1,NC_032660.1,23591814,23591815,24838341,CA,C,1
NC_037338.1,NC_032660.1,23641781,23641782,24888237,AT,A,1
NC_037338.1,NC_032660.1,23647161,23647162,24893614,GC,G,1
NC_037338.1,NC_032660.1,23675391,23675392,24939011,CA,C,1
NC_037338.1,NC_032660.1,23698542,23698546,24962143,AATTT,A,4
NC_037338.1,NC_032660.1,23698552,23698556,24962149,TATCA,T,4
NC_037338.1,NC_032660.1,23708154,23708155,24971714,AG,A,1
NC_037338.1,NC_032660.1,23730243,23730244,24993813,AT,A,1
NC_037338.1,NC_032660.1,24003694,24003698,25347741,TATCA,T,4
NC_037338.1,NC_032660.1,24004845,24004846,25348889,AT,A,1
NC_037338.1,NC_032660.1,24038794,24038795,25382843,GA,G,1
NC_037338.1,NC_032660.1,24059732,24059734,25403786,TGG,T,2
NC_037338.1,NC_032660.1,24225931,24225932,25570072,AG,A,1
NC_037338.1,NC_032660.1,24246070,24246074,25590195,CCTGT,C,4
NC_037338.1,NC_032660.1,24315427,24315431,25660578,TGTCC,T,4
NC_037338.1,NC_032660.1,24327495,24327496,25672655,CT,C,1
NC_037338.1,NC_032660.1,24421486,24421487,25766477,AG,A,1
NC_037338.1,NC_032660.1,24515591,24515592,25859918,GC,G,1
NC_037338.1,NC_032660.1,24741632,24741634,26086524,ACT,A,2
NC_037338.1,NC_032660.1,25021636,25021638,26358318,ATG,A,2
NC_037338.1,NC_032660.1,25186656,25186657,26541330,TA,T,1
NC_037338.1,NC_032660.1,25186664,25186665,26541337,CA,C,1
NC_037338.1,NC_032660.1,25186673,25186674,26541345,TA,T,1
NC_037338.1,NC_032660.1,25186686,25186687,26541357,CA,C,1
NC_037338.1,NC_032660.1,25230948,25230949,26585619,CA,C,1
NC_037338.1,NC_032660.1,25230956,25230957,26585626,GA,G,1
NC_037338.1,NC_032660.1,25230981,25230982,26585649,CT,C,1
NC_037338.1,NC_032660.1,25430628,25430651,26785370,TCCTGGAGGGCCTCCTGGAGGGCC,T,23
NC_037338.1,NC_032660.1,25997055,25997056,27334936,GT,G,1
NC_037338.1,NC_032660.1,26046178,26046179,27383927,TA,T,1
NC_037338.1,NC_032660.1,26109757,26109758,27448544,TG,T,1
NC_037338.1,NC_032660.1,26157782,26157783,27496663,TC,T,1
NC_037338.1,NC_032660.1,26175469,26175471,27514359,TAA,T,2
NC_037338.1,NC_032660.1,26196094,26196095,27534122,AC,A,1
NC_037338.1,NC_032660.1,26196172,26196173,27534199,TG,T,1
NC_037338.1,NC_032660.1,26760964,26760965,27852606,GA,G,1
NC_037338.1,NC_032660.1,27268913,27268914,28373671,GA,G,1
NC_037338.1,NC_032660.1,27297529,27297536,28402670,CGGGTCTT,C,7
NC_037338.1,NC_032660.1,27361027,27361031,28466172,GTCTA,G,4
NC_037338.1,NC_032660.1,27361035,27361037,28466176,TTC,T,2
NC_037338.1,NC_032660.1,27362830,27362831,28467971,GA,G,1
NC_037338.1,NC_032660.1,27374212,27374213,28479382,GC,G,1
NC_037338.1,NC_032660.1,27395840,27395855,28501029,ATCTCTCAACGGTAGC,A,15
NC_037338.1,NC_032660.1,27558561,27558562,28628932,CA,C,1
NC_037338.1,NC_032660.1,28222975,28222976,29296013,AT,A,1
NC_037338.1,NC_032660.1,28245946,28245947,29319030,TA,T,1
NC_037338.1,NC_032660.1,28249291,28249297,29322379,GACTCCT,G,6
NC_037338.1,NC_032660.1,28250218,28250221,29323308,CAGA,C,3
NC_037338.1,NC_032660.1,28250299,28250301,29323386,TAC,T,2
NC_037338.1,NC_032660.1,28268877,28268879,29341975,TAC,T,2
NC_037338.1,NC_032660.1,28414880,28414881,29487467,TC,T,1
NC_037338.1,NC_032660.1,28418925,28418926,29491514,GT,G,1
NC_037338.1,NC_032660.1,28439224,28439225,29511742,AT,A,1
NC_037338.1,NC_032660.1,28579811,28579812,29650055,TA,T,1
NC_037338.1,NC_032660.1,28588901,28588902,29659247,TG,T,1
NC_037338.1,NC_032660.1,28588930,28588931,29659275,GC,G,1
NC_037338.1,NC_032660.1,28700237,28700238,29770595,GA,G,1
NC_037338.1,NC_032660.1,28764287,28764288,29836128,GC,G,1
NC_037338.1,NC_032660.1,28962456,28962457,30061153,AC,A,1
NC_037338.1,NC_032660.1,28967547,28967548,30066241,GC,G,1
NC_037338.1,NC_032660.1,29156257,29156258,30254503,AT,A,1
NC_037338.1,NC_032660.1,29316670,29316674,30448236,GGAGA,G,4
NC_037338.1,NC_032660.1,29366616,29366617,30503606,CA,C,1
NC_037338.1,NC_032660.1,29367543,29367544,30507550,GT,G,1
NC_037338.1,NC_032660.1,29545580,29545581,30684982,TC,T,1
NC_037338.1,NC_032660.1,29588978,29588980,30729093,ATT,A,2
NC_037338.1,NC_032660.1,29831085,29831086,30964236,TG,T,1
NC_037338.1,NC_032660.1,30233928,30233929,31365437,CA,C,1
NC_037338.1,NC_032660.1,30353543,30353544,31482420,CG,C,1
NC_037338.1,NC_032660.1,30659606,30659608,31868165,TTA,T,2
NC_037338.1,NC_032660.1,30659619,30659620,31868176,GC,G,1
NC_037338.1,NC_032660.1,30659636,30659637,31868192,AT,A,1
NC_037338.1,NC_032660.1,30680547,30680548,31889093,CT,C,1
NC_037338.1,NC_032660.1,31003060,31003061,32212816,TC,T,1
NC_037338.1,NC_032660.1,31011357,31011358,32221118,CT,C,1
NC_037338.1,NC_032660.1,31340632,31340633,32627039,TC,T,1
NC_037338.1,NC_032660.1,31353626,31353631,32640054,CGTAGT,C,5
NC_037338.1,NC_032660.1,31353634,31353649,32640057,AATTGGTTGTCACATT,A,15
NC_037338.1,NC_032660.1,31399953,31399954,32686216,GA,G,1
NC_037338.1,NC_032660.1,31479206,31479207,32776068,TA,T,1
NC_037338.1,NC_032660.1,32014974,32014975,33320011,AC,A,1
NC_037338.1,NC_032660.1,32072916,32072917,33383057,CA,C,1
NC_037338.1,NC_032660.1,32205805,32205809,33516345,CTGTA,C,4
NC_037338.1,NC_032660.1,32308680,32308681,33619193,CT,C,1
NC_037338.1,NC_032660.1,32308856,32308857,33619368,GT,G,1
NC_037338.1,NC_032660.1,32326746,32326748,33637249,TAG,T,2
NC_037338.1,NC_032660.1,32412191,32412207,33724160,ATAAAAGCTAGACGAAC,A,16
NC_037338.1,NC_032660.1,32487868,32487869,33799824,AC,A,1
NC_037338.1,NC_032660.1,32489690,32489691,33801645,GA,G,1
NC_037338.1,NC_032660.1,32490449,32490450,33802403,AG,A,1
NC_037338.1,NC_032660.1,32500637,32500638,33812584,AG,A,1
NC_037338.1,NC_032660.1,32502938,32502940,33814888,AAT,A,2
NC_037338.1,NC_032660.1,32506865,32506866,33818814,CT,C,1
NC_037338.1,NC_032660.1,32506956,32506957,33818901,TA,T,1
NC_037338.1,NC_032660.1,32607847,32607848,33930378,CA,C,1
NC_037338.1,NC_032660.1,32616719,32616720,33939035,AT,A,1
NC_037338.1,NC_032660.1,32641632,32641633,33963637,CT,C,1
NC_037338.1,NC_032660.1,32658819,32658821,33980972,TCC,T,2
NC_037338.1,NC_032660.1,32661729,32661735,33983878,GTAGTCT,G,6
NC_037338.1,NC_032660.1,32714685,32714686,34036833,CA,C,1
NC_037338.1,NC_032660.1,32715073,32715074,34037223,GA,G,1
NC_037338.1,NC_032660.1,32715335,32715336,34037485,AG,A,1
NC_037338.1,NC_032660.1,32715348,32715349,34037497,CG,C,1
NC_037338.1,NC_032660.1,32715904,32715905,34038055,GC,G,1
NC_037338.1,NC_032660.1,32716030,32716031,34038181,GT,G,1
NC_037338.1,NC_032660.1,32716564,32716565,34038715,TA,T,1
NC_037338.1,NC_032660.1,32716587,32716588,34038737,GT,G,1
NC_037338.1,NC_032660.1,32766721,32766722,34066254,AG,A,1
NC_037338.1,NC_032660.1,32963242,32963243,34261901,AG,A,1
NC_037338.1,NC_032660.1,32968466,32968467,34267123,GC,G,1
NC_037338.1,NC_032660.1,32973599,32973600,34272270,AC,A,1
NC_037338.1,NC_032660.1,32975406,32975407,34274080,TG,T,1
NC_037338.1,NC_032660.1,32976108,32976117,34274785,AACCTATTTG,A,9
NC_037338.1,NC_032660.1,33111755,33111756,34410293,AC,A,1
NC_037338.1,NC_032660.1,33403607,33403608,34716586,TC,T,1
NC_037338.1,NC_032660.1,33403655,33403656,34716632,TC,T,1
NC_037338.1,NC_032660.1,33669821,33669822,34989313,AC,A,1
NC_037338.1,NC_032660.1,33671925,33671926,34991416,GT,G,1
NC_037338.1,NC_032660.1,33839331,33839333,35104057,AAC,A,2
NC_037338.1,NC_032660.1,33966687,33966688,35233890,CA,C,1
NC_037338.1,NC_032660.1,33967815,33967819,35235015,ACTGT,A,4
NC_037338.1,NC_032660.1,34064638,34064639,35403214,AT,A,1
NC_037338.1,NC_032660.1,34065252,34065253,35403829,GA,G,1
NC_037338.1,NC_032660.1,34066336,34066337,35404914,CA,C,1
NC_037338.1,NC_032660.1,34066787,34066788,35405364,GT,G,1
NC_037338.1,NC_032660.1,34072946,34072947,35411518,AT,A,1
NC_037338.1,NC_032660.1,34072949,34072950,35411520,TC,T,1
NC_037338.1,NC_032660.1,34117865,34117866,35456639,CA,C,1
NC_037338.1,NC_032660.1,34172244,34172245,35511044,CT,C,1
NC_037338.1,NC_032660.1,34587069,34587119,35983560,GCCAAAAATATGTTGACTTTGTTAAATGGCTCTCAATAGGAATGGCATGCC,G,50
NC_037338.1,NC_032660.1,34607217,34607218,36003553,AG,A,1
NC_037338.1,NC_032660.1,34697073,34697075,36093415,ATT,A,2
NC_037338.1,NC_032660.1,34771767,34771768,36169641,TA,T,1
NC_037338.1,NC_032660.1,34776493,34776494,36174368,CT,C,1
NC_037338.1,NC_032660.1,34962720,34962721,36318829,AC,A,1
NC_037338.1,NC_032660.1,34989268,34989271,36345981,TCTC,T,3
NC_037338.1,NC_032660.1,35035477,35035478,36392236,GC,G,1
NC_037338.1,NC_032660.1,35192856,35192857,36595005,TG,T,1
NC_037338.1,NC_032660.1,35221525,35221526,36624264,AG,A,1
NC_037338.1,NC_032660.1,35652027,35652028,37077041,AG,A,1
NC_037338.1,NC_032660.1,35652035,35652036,37077048,AG,A,1
NC_037338.1,NC_032660.1,35652043,35652045,37077055,GGT,G,2
NC_037338.1,NC_032660.1,35682010,35682011,37107112,TG,T,1
NC_037338.1,NC_032660.1,36192031,36192032,37619598,TA,T,1
NC_037338.1,NC_032660.1,36408843,36408844,37833585,AC,A,1
NC_037338.1,NC_032660.1,36612145,36612146,38034062,GT,G,1
NC_037338.1,NC_032660.1,36612171,36612172,38034086,CA,C,1
NC_037338.1,NC_032660.1,36798339,36798341,38279476,AAT,A,2
NC_037338.1,NC_032660.1,37007276,37007277,38516920,AC,A,1
NC_037338.1,NC_032660.1,37178351,37178352,38690493,TG,T,1
NC_037338.1,NC_032660.1,37178527,37178528,38690666,GC,G,1
NC_037338.1,NC_032660.1,37216853,37216855,38729091,TTG,T,2
NC_037338.1,NC_032660.1,37216868,37216869,38729104,CG,C,1
NC_037338.1,NC_032660.1,37412261,37412262,38925088,TC,T,1
NC_037338.1,NC_032660.1,37845416,37845417,39416884,GC,G,1
NC_037338.1,NC_032660.1,37932613,37932614,39504155,AC,A,1
NC_037338.1,NC_032660.1,38151960,38151961,39723345,AG,A,1
NC_037338.1,NC_032660.1,38152070,38152071,39723454,AC,A,1
NC_037338.1,NC_032660.1,39109170,39109171,40654937,TC,T,1
NC_037338.1,NC_032660.1,39301681,39301682,40845690,TG,T,1
NC_037338.1,NC_032660.1,39565776,39565777,41155625,AT,A,1
NC_037338.1,NC_032660.1,39565781,39565782,41155629,CA,C,1
NC_037338.1,NC_032660.1,39865889,39865891,41462117,AAG,A,2
NC_037338.1,NC_032660.1,40238927,40238929,41842536,CTA,C,2
NC_037338.1,NC_032660.1,40812902,40812904,42477302,TTG,T,2
NC_037338.1,NC_032660.1,40813190,40813192,42477588,TTC,T,2
NC_037338.1,NC_032660.1,40813198,40813200,42477594,AAT,A,2
NC_037338.1,NC_032660.1,41407956,41407957,43070193,TC,T,1
NC_037338.1,NC_032660.1,41537193,41537194,43199340,TG,T,1
NC_037338.1,NC_032660.1,42915902,42915903,44632124,CT,C,1
NC_037338.1,NC_032660.1,42915919,42915921,44632140,CCT,C,2
NC_037338.1,NC_032660.1,42931718,42931719,44647942,CT,C,1
NC_037338.1,NC_032660.1,43039222,43039224,44755444,AAG,A,2
NC_037338.1,NC_032660.1,43313374,43313375,45029066,TA,T,1
NC_037338.1,NC_032660.1,43478645,43478649,45198198,GGGAT,G,4
NC_037338.1,NC_032660.1,44028968,44028969,45747578,AC,A,1
NC_037338.1,NC_032660.1,44042363,44042364,45761081,CT,C,1
NC_037338.1,NC_032660.1,44866237,44866239,46640191,GAA,G,2
NC_037338.1,NC_032660.1,44867277,44867278,46641229,AT,A,1
NC_037338.1,NC_032660.1,45152363,45152364,46911856,GC,G,1
NC_037338.1,NC_032660.1,45545446,45545447,47316968,TA,T,1
NC_037338.1,NC_032660.1,45806887,45806888,47579406,AC,A,1
NC_037338.1,NC_032660.1,46134138,46134139,47905957,GC,G,1
NC_037338.1,NC_032660.1,46959652,46959653,48732242,AG,A,1
NC_037338.1,NC_032660.1,47795938,47795939,49598140,AG,A,1
NC_037338.1,NC_032660.1,47939887,47939890,49743598,GTTT,G,3
NC_037338.1,NC_032660.1,47999702,47999703,49803453,TA,T,1
NC_037338.1,NC_032660.1,47999709,47999710,49803459,AG,A,1
NC_037338.1,NC_032660.1,47999724,47999725,49803473,TA,T,1
NC_037338.1,NC_032660.1,48003012,48003013,49806816,CA,C,1
NC_037338.1,NC_032660.1,48405080,48405081,50205186,CA,C,1
NC_037338.1,NC_032660.1,48433000,48433001,50233097,GT,G,1
NC_037338.1,NC_032660.1,48617951,48617952,50453886,GC,G,1
NC_037338.1,NC_032660.1,48617955,48617959,50453889,AAACC,A,4
NC_037338.1,NC_032660.1,48839689,48839690,50676124,AT,A,1
NC_037338.1,NC_032660.1,48839739,48839740,50676172,GT,G,1
NC_037338.1,NC_032660.1,48839756,48839757,50676188,TG,T,1
NC_037338.1,NC_032660.1,48844945,48844946,50681375,GA,G,1
NC_037338.1,NC_032660.1,48844957,48844958,50681386,AC,A,1
NC_037338.1,NC_032660.1,48923662,48923663,50760084,TG,T,1
NC_037338.1,NC_032660.1,49153713,49153714,50989945,AT,A,1
NC_037338.1,NC_032660.1,49153744,49153745,50989974,CT,C,1
NC_037338.1,NC_032660.1,49153774,49153775,50990003,TC,T,1
NC_037338.1,NC_032660.1,49153785,49153786,50990013,GC,G,1
NC_037338.1,NC_032660.1,49189008,49189009,51025229,CT,C,1
NC_037338.1,NC_032660.1,49191631,49191632,51028026,TG,T,1
NC_037338.1,NC_032660.1,50003834,50003835,51831017,GA,G,1
NC_037338.1,NC_032660.1,50003862,50003863,51831043,CA,C,1
NC_037338.1,NC_032660.1,50184538,50184539,52011595,CT,C,1
NC_037338.1,NC_032660.1,50203382,50203383,52030464,GT,G,1
NC_037338.1,NC_032660.1,50203636,50203637,52030718,GC,G,1
NC_037338.1,NC_032660.1,50203780,50203781,52030861,CT,C,1
NC_037338.1,NC_032660.1,50222971,50222972,52051331,AG,A,1
NC_037338.1,NC_032660.1,50224249,50224253,52052591,TATAA,T,4
NC_037338.1,NC_032660.1,50259055,50259056,52087332,GA,G,1
NC_037338.1,NC_032660.1,50266161,50266162,52094426,TC,T,1
NC_037338.1,NC_032660.1,50323697,50323698,52178353,AG,A,1
NC_037338.1,NC_032660.1,50323711,50323712,52178366,TC,T,1
NC_037338.1,NC_032660.1,50389626,50389627,52244871,TG,T,1
NC_037338.1,NC_032660.1,50430900,50430921,52285499,TAGGATGTCACTGCTTCCAGAC,T,21
NC_037338.1,NC_032660.1,50460241,50460242,52314820,TC,T,1
NC_037338.1,NC_032660.1,50461887,50461888,52316465,CT,C,1
NC_037338.1,NC_032660.1,51115862,51115863,52978837,AG,A,1
NC_037338.1,NC_032660.1,51319320,51319321,53185824,AT,A,1
NC_037338.1,NC_032660.1,51498174,51498193,53392973,AATCAAAGAATTTCCCTTGC,A,19
NC_037338.1,NC_032660.1,51611444,51611456,53506391,GGACATCCTTACA,G,12
NC_037338.1,NC_032660.1,51615912,51615913,53510846,CT,C,1
NC_037338.1,NC_032660.1,51815039,51815041,53670877,AAT,A,2
NC_037338.1,NC_032660.1,51815049,51815050,53670885,TA,T,1
NC_037338.1,NC_032660.1,52313640,52313641,54169846,GT,G,1
NC_037338.1,NC_032660.1,53173223,53173224,54984619,GT,G,1
NC_037338.1,NC_032660.1,55043513,55043514,56666658,AT,A,1
NC_037338.1,NC_032660.1,55056764,55056765,56679906,AG,A,1
NC_037338.1,NC_032660.1,55141077,55141078,56763916,AG,A,1
NC_037338.1,NC_032660.1,55294753,55294756,56927974,GACT,G,3
NC_037338.1,NC_032660.1,55298704,55298705,56931920,AC,A,1
NC_037338.1,NC_032660.1,55306770,55306771,56939983,CT,C,1
NC_037338.1,NC_032660.1,55349429,55349430,56982646,GA,G,1
NC_037338.1,NC_032660.1,55355895,55355896,56989111,TG,T,1
NC_037338.1,NC_032660.1,55359047,55359048,57040440,TA,T,1
NC_037338.1,NC_032660.1,55511948,55511949,57193271,TA,T,1
NC_037338.1,NC_032660.1,55511958,55511959,57193280,AT,A,1
NC_037338.1,NC_032660.1,55511964,55511965,57193285,AG,A,1
NC_037338.1,NC_032660.1,56369705,56369706,58064992,GT,G,1
NC_037338.1,NC_032660.1,56991824,56991825,58771689,AT,A,1
NC_037338.1,NC_032660.1,57144797,57144798,58927728,AG,A,1
NC_037338.1,NC_032660.1,57289015,57289016,59069273,CA,C,1
NC_037338.1,NC_032660.1,57629829,57629830,59651103,AC,A,1
NC_037338.1,NC_032660.1,57879135,57879136,59894865,TA,T,1
NC_037338.1,NC_032660.1,57893057,57893058,59908793,AC,A,1
NC_037338.1,NC_032660.1,57951581,57951600,59967802,ATGTGAGCCCCACTACAGAG,A,19
NC_037338.1,NC_032660.1,58744086,58744087,60554236,GC,G,1
NC_037338.1,NC_032660.1,59104741,59104748,60966479,GTATTGAC,G,7
NC_037338.1,NC_032660.1,59104750,59104754,60966481,TACTC,T,4
NC_037338.1,NC_032660.1,59108873,59108874,60971125,TG,T,1
NC_037338.1,NC_032660.1,59446341,59446342,61313265,TA,T,1
NC_037338.1,NC_032660.1,59460182,59460183,61327095,TA,T,1
NC_037338.1,NC_032660.1,59905067,59905073,61959341,GCTTTAA,G,6
NC_037338.1,NC_032660.1,60134062,60134063,62192104,CG,C,1
NC_037338.1,NC_032660.1,60304167,60304168,62362353,GC,G,1
NC_037338.1,NC_032660.1,60402108,60402109,62456686,AT,A,1
NC_037338.1,NC_032660.1,61139355,61139359,63202785,TCCCA,T,4
NC_037338.1,NC_032660.1,62096479,62096481,63949347,AAC,A,2
NC_037338.1,NC_032660.1,62438130,62438131,64290858,AT,A,1
NC_037338.1,NC_032660.1,62974054,62974055,64825003,GT,G,1
NC_037338.1,NC_032660.1,63068159,63068161,64918959,TTA,T,2
NC_037338.1,NC_032660.1,63121311,63121312,64971756,GT,G,1
NC_037338.1,NC_032660.1,63222277,63222278,65075549,CA,C,1
NC_037338.1,NC_032660.1,63981035,63981036,65738140,CT,C,1
NC_037338.1,NC_032660.1,64247211,64247212,66044818,CT,C,1
NC_037338.1,NC_032660.1,64247224,64247225,66044830,AT,A,1
NC_037338.1,NC_032660.1,64641122,64641123,66437285,CT,C,1
NC_037338.1,NC_032660.1,64751184,64751186,66568609,TTA,T,2
NC_037338.1,NC_032660.1,64751199,64751200,66568622,GA,G,1
NC_037338.1,NC_032660.1,64956180,64956181,66772557,CA,C,1
NC_037338.1,NC_032660.1,65035354,65035355,66852124,CA,C,1
NC_037338.1,NC_032660.1,65296854,65296855,67113306,CA,C,1
NC_037338.1,NC_032660.1,65436113,65436114,67263996,AC,A,1
NC_037338.1,NC_032660.1,66097810,66097811,67966890,GT,G,1
NC_037338.1,NC_032660.1,66402030,66402033,68377430,AGAC,A,3
NC_037338.1,NC_032660.1,66402040,66402041,68377437,GA,G,1
NC_037338.1,NC_032660.1,66442076,66442077,68417845,TA,T,1
NC_037338.1,NC_032660.1,66442087,66442088,68417855,AT,A,1
NC_037338.1,NC_032660.1,66442108,66442109,68417875,TC,T,1
NC_037338.1,NC_032660.1,66478929,66478930,68454713,TC,T,1
NC_037338.1,NC_032660.1,66668651,66668659,68642520,CGTAGGGCT,C,8
NC_037338.1,NC_032660.1,68011453,68011454,70018894,TC,T,1
NC_037338.1,NC_032660.1,68011463,68011464,70018903,GA,G,1
NC_037338.1,NC_032660.1,68089869,68089870,70097153,GC,G,1
NC_037338.1,NC_032660.1,68089932,68089933,70097214,GT,G,1
NC_037338.1,NC_032660.1,68120740,68120741,70129287,GA,G,1
NC_037338.1,NC_032660.1,68348879,68348881,70356864,CCA,C,2
NC_037338.1,NC_032660.1,68478754,68478755,70486652,GA,G,1
NC_037338.1,NC_032660.1,68956950,68956953,70966248,TGAG,T,3
NC_037338.1,NC_032660.1,69202401,69202402,71227235,AG,A,1
NC_037338.1,NC_032660.1,69202464,69202466,71227297,CAT,C,2
NC_037338.1,NC_032660.1,69245047,69245048,71269874,GA,G,1
NC_037338.1,NC_032660.1,69245063,69245064,71269889,AC,A,1
NC_037338.1,NC_032660.1,69245109,69245110,71269933,TA,T,1
NC_037338.1,NC_032660.1,69311912,69311913,71336718,TA,T,1
NC_037338.1,NC_032660.1,69483335,69483336,71502171,CA,C,1
NC_037338.1,NC_032660.1,70017410,70017411,72039881,GA,G,1
NC_037338.1,NC_032660.1,70263966,70263967,72287244,AC,A,1
NC_037338.1,NC_032660.1,70266729,70266730,72290004,AG,A,1
NC_037338.1,NC_032660.1,70303361,70303362,72326561,TA,T,1
NC_037338.1,NC_032660.1,70737106,70737107,72769598,TC,T,1
NC_037338.1,NC_032660.1,70777962,70777963,72810455,TC,T,1
NC_037338.1,NC_032660.1,70777990,70777991,72810484,TC,T,1
NC_037338.1,NC_032660.1,71040888,71040889,73324902,AT,A,1
NC_037338.1,NC_032660.1,71040893,71040894,73324906,TA,T,1
NC_037338.1,NC_032660.1,71121752,71121753,73181321,TA,T,1
NC_037338.1,NC_032660.1,71121775,71121776,73181343,GT,G,1
NC_037338.1,NC_032660.1,71354814,71354816,73501029,TCA,T,2
NC_037338.1,NC_032660.1,71872320,71872321,74030814,AT,A,1
NC_037338.1,NC_032660.1,72418988,72418989,74575643,TC,T,1
NC_037338.1,NC_032660.1,73459069,73459070,75620402,AG,A,1
NC_037338.1,NC_032660.1,74051861,74051863,76257589,CCT,C,2
NC_037338.1,NC_032660.1,74051891,74051892,76257616,AG,A,1
NC_037338.1,NC_032660.1,74051910,74051911,76257634,GC,G,1
NC_037338.1,NC_032660.1,74135188,74135189,76341100,GC,G,1
NC_037338.1,NC_032660.1,74192803,74192804,76399582,GT,G,1
NC_037338.1,NC_032660.1,74200386,74200387,76407164,GT,G,1
NC_037338.1,NC_032660.1,74323644,74323645,76531476,GT,G,1
NC_037338.1,NC_032660.1,74601298,74601299,76809042,GT,G,1
NC_037338.1,NC_032660.1,74601310,74601311,76809053,TA,T,1
NC_037338.1,NC_032660.1,74601324,74601325,76809066,AC,A,1
NC_037338.1,NC_032660.1,74601336,74601337,76809077,CA,C,1
NC_037338.1,NC_032660.1,75193325,75193326,77515449,AG,A,1
NC_037338.1,NC_032660.1,75387598,75387599,77709554,CT,C,1
NC_037338.1,NC_032660.1,76043399,76043426,78411880,ATCCAATGGCGAGGGAGGCTGTGACCTG,A,27
NC_037338.1,NC_032660.1,76094306,76094307,78462764,AG,A,1
NC_037338.1,NC_032660.1,76310889,76310890,78656520,CT,C,1
NC_037338.1,NC_032660.1,76561501,76561502,78915621,TC,T,1
NC_037338.1,NC_032660.1,76562513,76562514,78916631,CT,C,1
NC_037338.1,NC_032660.1,77466744,77466746,79806092,AAG,A,2
NC_037338.1,NC_032660.1,77466816,77466817,79806161,AT,A,1
NC_037338.1,NC_032660.1,77653127,77653128,79993097,CA,C,1
NC_037338.1,NC_032660.1,77806917,77806919,80146698,GGT,G,2
NC_037338.1,NC_032660.1,77806925,77806926,80146704,AT,A,1
NC_037338.1,NC_032660.1,78177531,78177539,80596015,TTGTTGCAA,T,8
NC_037338.1,NC_032660.1,79033095,79033096,81441458,TC,T,1
NC_037338.1,NC_032660.1,79043089,79043091,81451450,TTA,T,2
NC_037338.1,NC_032660.1,79052970,79052971,81461314,GA,G,1
NC_037338.1,NC_032660.1,79052975,79052976,81461318,CG,C,1
NC_037338.1,NC_032660.1,79052997,79052998,81461339,AC,A,1
NC_037338.1,NC_032660.1,79053007,79053008,81461348,CA,C,1
NC_037338.1,NC_032660.1,79120080,79120081,81527641,AT,A,1
NC_037338.1,NC_032660.1,79120087,79120088,81527647,GA,G,1
NC_037338.1,NC_032660.1,79120204,79120205,81527761,AT,A,1
NC_037338.1,NC_032660.1,79120210,79120211,81527766,TA,T,1
NC_037338.1,NC_032660.1,79120215,79120216,81527770,CA,C,1
NC_037338.1,NC_032660.1,79473769,79473770,81880687,TC,T,1
NC_037338.1,NC_032660.1,79537883,79537884,85254387,AT,A,1
NC_037338.1,NC_032660.1,79764075,79764076,81988251,AG,A,1
NC_037338.1,NC_032660.1,80430507,80430508,82653358,GA,G,1
NC_037338.1,NC_032660.1,80430511,80430512,82653361,AG,A,1
NC_037338.1,NC_032660.1,80430559,80430560,82653407,CA,C,1
NC_037338.1,NC_032660.1,80430573,80430574,82653420,AG,A,1
NC_037338.1,NC_032660.1,80432050,80432052,82654897,AAT,A,2
NC_037338.1,NC_032660.1,80713662,80713663,82942211,AG,A,1
NC_037338.1,NC_032660.1,80713713,80713714,82942261,CT,C,1
NC_037338.1,NC_032660.1,81391997,81391998,83626341,TC,T,1
NC_037338.1,NC_032660.1,81490493,81490494,83726977,TC,T,1
NC_037338.1,NC_032660.1,81731957,81731958,83977645,AG,A,1
NC_037338.1,NC_032660.1,81735359,81735360,83981046,AT,A,1
NC_037338.1,NC_032660.1,81735477,81735478,83981162,GT,G,1
NC_037338.1,NC_032660.1,81761657,81761658,84007222,AT,A,1
NC_037338.1,NC_032660.1,81761670,81761671,84007234,TC,T,1
NC_037338.1,NC_032660.1,81863324,81863326,84108656,CCT,C,2
NC_037338.1,NC_032660.1,81938407,81938408,84183524,AT,A,1
NC_037338.1,NC_032660.1,82413963,82413964,84689713,CA,C,1
NC_037338.1,NC_032660.1,83002322,83002323,85635010,TC,T,1
NC_037338.1,NC_032660.1,83002563,83002564,85635250,TA,T,1
NC_037338.1,NC_032660.1,83010048,83010049,85642763,AT,A,1
NC_037338.1,NC_032660.1,83010397,83010398,85643111,CT,C,1
NC_037338.1,NC_032660.1,83012297,83012298,85645009,TA,T,1
NC_037338.1,NC_032660.1,83012537,83012538,85645247,AT,A,1
NC_037338.1,NC_032660.1,84106826,84106827,86761686,GA,G,1
NC_037338.1,NC_032660.1,84409931,84409932,87060785,CA,C,1
NC_037338.1,NC_032660.1,84416542,84416543,87051200,CA,C,1
NC_037338.1,NC_032660.1,84441144,84441145,87193456,TC,T,1
NC_037338.1,NC_032660.1,84729270,84729271,87489873,AG,A,1
NC_037338.1,NC_032660.1,84729281,84729282,87489883,AG,A,1
NC_037338.1,NC_032660.1,84729293,84729294,87489894,GA,G,1
NC_037338.1,NC_032660.1,84910872,84910874,87676859,TTA,T,2
NC_037338.1,NC_032660.1,85389571,85389573,88156608,AAG,A,2
NC_037338.1,NC_032660.1,85806804,85806805,88542142,AT,A,1
NC_037338.1,NC_032660.1,85946561,85946562,88681530,GC,G,1
NC_037338.1,NC_032660.1,85946574,85946575,88681542,AC,A,1
NC_037338.1,NC_032660.1,85946607,85946608,88681575,GT,G,1
NC_037338.1,NC_032660.1,85948979,85948980,88683943,GA,G,1
NC_037338.1,NC_032660.1,86014550,86014551,88747679,GT,G,1
NC_037338.1,NC_032660.1,86014609,86014611,88747737,CCA,C,2
NC_037338.1,NC_032660.1,86075808,86075810,88807152,ATC,A,2
NC_037338.1,NC_032660.1,86615631,86615637,89423468,TCACCAG,T,6
NC_037338.1,NC_032660.1,86647781,86647782,89455615,CA,C,1
NC_037338.1,NC_032660.1,86707762,86707767,89517361,TTGCAA,T,5
NC_037338.1,NC_032660.1,86707769,86707778,89517363,CCTTTGGTTA,C,9
NC_037338.1,NC_032660.1,87619244,87619245,90459740,TG,T,1
NC_037338.1,NC_032660.1,87637104,87637105,90477597,CA,C,1
NC_037338.1,NC_032660.1,88010475,88010476,90852249,CT,C,1
NC_037338.1,NC_032660.1,88014542,88014543,90856303,AT,A,1
NC_037338.1,NC_032660.1,88738060,88738061,91576702,AG,A,1
NC_037338.1,NC_032660.1,88738064,88738065,91576705,TC,T,1
NC_037338.1,NC_032660.1,88738072,88738073,91576712,AG,A,1
NC_037338.1,NC_032660.1,89668054,89668055,92546154,AC,A,1
NC_037338.1,NC_032660.1,89705833,89705834,92583967,TA,T,1
NC_037338.1,NC_032660.1,89804023,89804024,92681770,AG,A,1
NC_037338.1,NC_032660.1,89804079,89804080,92681823,AT,A,1
NC_037338.1,NC_032660.1,89804086,89804087,92681829,CA,C,1
NC_037338.1,NC_032660.1,90296523,90296524,93183837,AT,A,1
NC_037338.1,NC_032660.1,90357238,90357239,93244568,CT,C,1
NC_037338.1,NC_032660.1,90883811,90883813,93937732,AAT,A,2
NC_037338.1,NC_032660.1,90883827,90883828,93937746,AG,A,1
NC_037338.1,NC_032660.1,91465733,91465734,94549812,GT,G,1
NC_037338.1,NC_032660.1,92118569,92118570,95212872,AG,A,1
NC_037338.1,NC_032660.1,92118569,92118570,95248862,AG,A,1
NC_037338.1,NC_032660.1,92251732,92251733,95382210,GT,G,1
NC_037338.1,NC_032660.1,92251741,92251742,95382218,AT,A,1
NC_037338.1,NC_032660.1,92394960,92394961,95525562,GC,G,1
NC_037338.1,NC_032660.1,92699790,92699791,95832361,AT,A,1
NC_037338.1,NC_032660.1,92842989,92842990,95975633,AT,A,1
NC_037338.1,NC_032660.1,93388205,93388206,96561675,AC,A,1
NC_037338.1,NC_032660.1,93579450,93579451,96746556,GC,G,1
NC_037338.1,NC_032660.1,93964029,93964030,97197381,AT,A,1
NC_037338.1,NC_032660.1,94172124,94172125,97405677,CA,C,1
NC_037338.1,NC_032660.1,94235667,94235668,97468705,TA,T,1
NC_037338.1,NC_032660.1,94235722,94235723,97468758,CA,C,1
NC_037338.1,NC_032660.1,94519437,94519439,97808327,CCT,C,2
NC_037338.1,NC_032660.1,94519474,94519475,97808362,CT,C,1
NC_037338.1,NC_032660.1,94528801,94528802,97817551,GA,G,1
NC_037338.1,NC_032660.1,94614984,94614986,97903731,GGA,G,2
NC_037338.1,NC_032660.1,94614999,94615000,97903744,CT,C,1
NC_037338.1,NC_032660.1,94644740,94644741,97933670,TC,T,1
NC_037338.1,NC_032660.1,96221032,96221033,99714492,GT,G,1
NC_037338.1,NC_032660.1,96836765,96836766,100322385,CG,C,1
NC_037338.1,NC_032660.1,96836773,96836774,100322392,CG,C,1
NC_037338.1,NC_032660.1,96877703,96877704,100365193,TC,T,1
NC_037338.1,NC_032660.1,96878442,96878443,100365931,AT,A,1
NC_037338.1,NC_032660.1,96878722,96878723,100366210,AC,A,1
NC_037338.1,NC_032660.1,96881624,96881625,100369110,CA,C,1
NC_037338.1,NC_032660.1,97088311,97088312,100573240,TC,T,1
NC_037338.1,NC_032660.1,97812923,97812924,101327167,TG,T,1
NC_037338.1,NC_032660.1,97826407,97826408,101340649,CA,C,1
NC_037338.1,NC_032660.1,98033682,98033683,101547925,TG,T,1
NC_037338.1,NC_032660.1,98185160,98185161,101771550,AT,A,1
NC_037338.1,NC_032660.1,98267263,98267265,101853680,CCA,C,2
NC_037338.1,NC_032660.1,98663692,98663700,102291883,CCATCCCAT,C,8
NC_037338.1,NC_032660.1,98738153,98738154,102367207,TC,T,1
NC_037338.1,NC_032660.1,98738213,98738214,102367266,AG,A,1
NC_037338.1,NC_032660.1,98738222,98738223,102367274,AC,A,1
NC_037338.1,NC_032660.1,99039656,99039657,102757341,CT,C,1
NC_037338.1,NC_032660.1,99374444,99374445,103125856,AT,A,1
NC_037338.1,NC_032660.1,99388516,99388517,103136914,GC,G,1
NC_037338.1,NC_032660.1,99390642,99390644,103139020,CTT,C,2
NC_037338.1,NC_032660.1,99438475,99438476,103186852,AT,A,1
NC_037338.1,NC_032660.1,99732175,99732179,103481137,GAGTC,G,4
NC_037338.1,NC_032660.1,100002602,100002603,103767340,TC,T,1
NC_037338.1,NC_032660.1,100002618,100002619,103767355,GC,G,1
NC_037338.1,NC_032660.1,100092894,100092895,103856163,AG,A,1
NC_037338.1,NC_032660.1,100545511,100545512,104338168,TG,T,1
NC_037338.1,NC_032660.1,100681592,100681593,104485860,TC,T,1
NC_037338.1,NC_032660.1,100681598,100681599,104485865,GC,G,1
NC_037338.1,NC_032660.1,100681616,100681617,104485882,GC,G,1
NC_037338.1,NC_032660.1,100794111,100794112,104597789,CA,C,1
NC_037338.1,NC_032660.1,101044657,101044658,104864795,GA,G,1
NC_037338.1,NC_032660.1,101044682,101044683,104864819,TA,T,1
NC_037338.1,NC_032660.1,101268446,101268447,105089701,AG,A,1
NC_037338.1,NC_032660.1,101312695,101312697,105133814,GGC,G,2
NC_037338.1,NC_032660.1,101471982,101471983,105293689,AG,A,1
NC_037338.1,NC_032660.1,101472030,101472032,105293736,TTA,T,2
NC_037338.1,NC_032660.1,101744024,101744026,105590564,TTA,T,2
NC_037338.1,NC_032660.1,101744065,101744067,105590603,GGC,G,2
NC_037338.1,NC_032660.1,101957158,101957159,105801968,GC,G,1
NC_037338.1,NC_032660.1,101958760,101958761,105803570,AG,A,1
NC_037338.1,NC_032660.1,102201467,102201468,106039625,AG,A,1
NC_037338.1,NC_032660.1,102244543,102244544,106082701,TG,T,1
NC_037338.1,NC_032660.1,102244567,102244568,106082724,AT,A,1
NC_037338.1,NC_032660.1,102246904,102246906,106085060,TTG,T,2
NC_037338.1,NC_032660.1,102246916,102246917,106085070,TG,T,1
NC_037338.1,NC_032660.1,103064611,103064612,106900806,AT,A,1
NC_037338.1,NC_032660.1,103064621,103064622,106900815,AT,A,1
NC_037338.1,NC_032660.1,103064635,103064636,106900828,AG,A,1
NC_037338.1,NC_032660.1,103082215,103082216,107058829,TC,T,1
NC_037338.1,NC_032660.1,103109603,103109606,106947133,AGTC,A,3
NC_037338.1,NC_032660.1,103241486,103241487,107192894,AC,A,1
NC_037338.1,NC_032660.1,103316924,103316926,107313506,CCA,C,2
NC_037338.1,NC_032660.1,103719752,103719764,107709454,CACTTGAAGCCAG,C,12
NC_037338.1,NC_032660.1,103831688,103831689,107822710,GT,G,1
NC_037338.1,NC_032660.1,103852173,103852174,107842576,GA,G,1
NC_037338.1,NC_032660.1,103872474,103872475,107862764,TG,T,1
NC_037338.1,NC_032660.1,103966968,103966969,107976373,GA,G,1
NC_037338.1,NC_032660.1,103966973,103966974,107976377,AG,A,1
NC_037338.1,NC_032660.1,103967042,103967043,107976445,CT,C,1
NC_037338.1,NC_032660.1,104605040,104605041,108617999,AC,A,1
