Reference ID,Query ID,Reference POS,Reference END,Query POS,REF,ALT,SVLEN
NC_037328.1,NC_032650.1,675813,675814,13943,CT,C,1
NC_037328.1,NC_032650.1,713928,713929,51331,GA,G,1
NC_037328.1,NC_032650.1,1140919,1140920,477798,GT,G,1
NC_037328.1,NC_032650.1,1140946,1140947,477824,TC,T,1
NC_037328.1,NC_032650.1,2198460,2198461,1283787,CG,C,1
NC_037328.1,NC_032650.1,2222648,2222669,1307981,TATTGGTCAAGCAGATGGTCAA,T,21
NC_037328.1,NC_032650.1,2255255,2255256,1340571,AT,A,1
NC_037328.1,NC_032650.1,2255381,2255382,1340692,TG,T,1
NC_037328.1,NC_032650.1,2755716,2755723,1860643,TGAGGCCA,T,7
NC_037328.1,NC_032650.1,2762299,2762300,1868612,AT,A,1
NC_037328.1,NC_032650.1,3441796,3441797,2552928,CA,C,1
NC_037328.1,NC_032650.1,3473607,3473613,2584906,ATCCTTT,A,6
NC_037328.1,NC_032650.1,3573466,3573467,2684639,AG,A,1
NC_037328.1,NC_032650.1,3600262,3600263,2711513,CG,C,1
NC_037328.1,NC_032650.1,3603156,3603157,2714402,AT,A,1
NC_037328.1,NC_032650.1,3683489,3683490,2794202,TA,T,1
NC_037328.1,NC_032650.1,3717942,3717943,2828488,GA,G,1
NC_037328.1,NC_032650.1,3756371,3756372,2866921,TA,T,1
NC_037328.1,NC_032650.1,3766952,3766953,2877501,GT,G,1
NC_037328.1,NC_032650.1,3867309,3867310,3007683,CA,C,1
NC_037328.1,NC_032650.1,3959158,3959159,3106551,TC,T,1
NC_037328.1,NC_032650.1,3959206,3959207,3106598,CT,C,1
NC_037328.1,NC_032650.1,4052390,4052391,3199744,TG,T,1
NC_037328.1,NC_032650.1,4181078,4181079,3330308,GC,G,1
NC_037328.1,NC_032650.1,4181729,4181730,3330958,CT,C,1
NC_037328.1,NC_032650.1,4310314,4310315,3491536,TC,T,1
NC_037328.1,NC_032650.1,4373072,4373073,3555593,CG,C,1
NC_037328.1,NC_032650.1,4572964,4572965,3755940,CA,C,1
NC_037328.1,NC_032650.1,4946340,4946341,4057469,TG,T,1
NC_037328.1,NC_032650.1,5034908,5034909,4195058,GT,G,1
NC_037328.1,NC_032650.1,5498562,5498563,4698871,GA,G,1
NC_037328.1,NC_032650.1,5753433,5753434,4958864,TC,T,1
NC_037328.1,NC_032650.1,5765458,5765459,4970891,TG,T,1
NC_037328.1,NC_032650.1,5919415,5919416,5131389,CA,C,1
NC_037328.1,NC_032650.1,5938646,5938651,5150679,GGACAA,G,5
NC_037328.1,NC_032650.1,5951731,5951739,5175056,TATTAGTAA,T,8
NC_037328.1,NC_032650.1,5982745,5982746,5211601,CA,C,1
NC_037328.1,NC_032650.1,6057307,6057308,5290823,AG,A,1
NC_037328.1,NC_032650.1,6261655,6261657,5495808,TTA,T,2
NC_037328.1,NC_032650.1,6377073,6377074,5624496,AT,A,1
NC_037328.1,NC_032650.1,6377112,6377113,5624533,AG,A,1
NC_037328.1,NC_032650.1,6387796,6387804,5635236,GACTCAAGA,G,8
NC_037328.1,NC_032650.1,6388115,6388116,5635547,GT,G,1
NC_037328.1,NC_032650.1,6434859,6434860,5682250,CT,C,1
NC_037328.1,NC_032650.1,6434960,6434961,5682350,AG,A,1
NC_037328.1,NC_032650.1,6449771,6449772,5697160,GT,G,1
NC_037328.1,NC_032650.1,6636023,6636024,5890947,TA,T,1
NC_037328.1,NC_032650.1,6661193,6661194,5916685,AG,A,1
NC_037328.1,NC_032650.1,6661232,6661233,5916722,GA,G,1
NC_037328.1,NC_032650.1,7249581,7249582,6551520,GT,G,1
NC_037328.1,NC_032650.1,7249587,7249589,6551525,TTG,T,2
NC_037328.1,NC_032650.1,7249652,7249653,6551586,TG,T,1
NC_037328.1,NC_032650.1,7357832,7357833,6678334,AG,A,1
NC_037328.1,NC_032650.1,7878633,7878634,7198858,AC,A,1
NC_037328.1,NC_032650.1,7971823,7971833,7292013,AGTATTTATTT,A,10
NC_037328.1,NC_032650.1,8500511,8500512,7834689,AT,A,1
NC_037328.1,NC_032650.1,8500535,8500537,7834712,TTG,T,2
NC_037328.1,NC_032650.1,8500546,8500547,7834721,GT,G,1
NC_037328.1,NC_032650.1,8500554,8500555,7834728,AT,A,1
NC_037328.1,NC_032650.1,8944729,8944730,8294332,GT,G,1
NC_037328.1,NC_032650.1,8945448,8945449,8295051,TG,T,1
NC_037328.1,NC_032650.1,8945570,8945571,8295172,AT,A,1
NC_037328.1,NC_032650.1,8945883,8945884,8295486,GT,G,1
NC_037328.1,NC_032650.1,8946089,8946090,8295692,AG,A,1
NC_037328.1,NC_032650.1,8946121,8946122,8295723,GT,G,1
NC_037328.1,NC_032650.1,8946595,8946596,8296193,GA,G,1
NC_037328.1,NC_032650.1,8973278,8973279,8280677,GT,G,1
NC_037328.1,NC_032650.1,8974030,8974031,8281432,CA,C,1
NC_037328.1,NC_032650.1,8974178,8974179,8281580,TA,T,1
NC_037328.1,NC_032650.1,8975390,8975391,8282801,CT,C,1
NC_037328.1,NC_032650.1,8977360,8977361,8284775,GT,G,1
NC_037328.1,NC_032650.1,8977467,8977468,8284881,TG,T,1
NC_037328.1,NC_032650.1,8977485,8977486,8284898,GC,G,1
NC_037328.1,NC_032650.1,8977729,8977730,8285143,GA,G,1
NC_037328.1,NC_032650.1,8978035,8978036,8285448,AC,A,1
NC_037328.1,NC_032650.1,8978573,8978574,8285986,CA,C,1
NC_037328.1,NC_032650.1,8979349,8979350,8286764,AC,A,1
NC_037328.1,NC_032650.1,8979381,8979382,8286796,AT,A,1
NC_037328.1,NC_032650.1,8979630,8979631,8287045,AC,A,1
NC_037328.1,NC_032650.1,8979788,8979789,8287202,GC,G,1
NC_037328.1,NC_032650.1,9498995,9498996,8802581,GT,G,1
NC_037328.1,NC_032650.1,9499033,9499034,8802617,CA,C,1
NC_037328.1,NC_032650.1,9817011,9817012,9197655,GC,G,1
NC_037328.1,NC_032650.1,10042416,10042417,9423660,GT,G,1
NC_037328.1,NC_032650.1,10042458,10042459,9423700,GA,G,1
NC_037328.1,NC_032650.1,10993038,10993039,10367119,CT,C,1
NC_037328.1,NC_032650.1,11160252,11160253,10579050,GT,G,1
NC_037328.1,NC_032650.1,11530727,11530728,11024274,AG,A,1
NC_037328.1,NC_032650.1,11530736,11530737,11024282,TA,T,1
NC_037328.1,NC_032650.1,11860587,11860588,11367391,GT,G,1
NC_037328.1,NC_032650.1,13032753,13032756,12613467,TTTA,T,3
NC_037328.1,NC_032650.1,13034641,13034642,12615335,TG,T,1
NC_037328.1,NC_032650.1,13454784,13454785,13042136,AG,A,1
NC_037328.1,NC_032650.1,13500674,13500675,13088008,AC,A,1
NC_037328.1,NC_032650.1,13503763,13503766,13091097,AAAT,A,3
NC_037328.1,NC_032650.1,13507160,13507161,13094486,GC,G,1
NC_037328.1,NC_032650.1,13516754,13516755,13104019,CG,C,1
NC_037328.1,NC_032650.1,13517222,13517225,13104483,GTAA,G,3
NC_037328.1,NC_032650.1,13518066,13518069,13105329,AGTT,A,3
NC_037328.1,NC_032650.1,13526563,13526566,13113406,CCAG,C,3
NC_037328.1,NC_032650.1,13529152,13529154,13115995,CAA,C,2
NC_037328.1,NC_032650.1,13534792,13534796,13121642,GCAAT,G,4
NC_037328.1,NC_032650.1,13724676,13724677,13316705,AG,A,1
NC_037328.1,NC_032650.1,13735652,13735653,13328695,TA,T,1
NC_037328.1,NC_032650.1,14119313,14119314,13724371,CA,C,1
NC_037328.1,NC_032650.1,14936205,14936206,14704954,TG,T,1
NC_037328.1,NC_032650.1,15081600,15081601,14853006,CG,C,1
NC_037328.1,NC_032650.1,15192929,15192931,14964472,CTT,C,2
NC_037328.1,NC_032650.1,15201049,15201050,14972614,CA,C,1
NC_037328.1,NC_032650.1,15477055,15477063,15248756,GGGATATTA,G,8
NC_037328.1,NC_032650.1,15492448,15492450,15264123,CTT,C,2
NC_037328.1,NC_032650.1,15494434,15494435,15271788,AG,A,1
NC_037328.1,NC_032650.1,15494449,15494454,15271802,TTCACA,T,5
NC_037328.1,NC_032650.1,15501340,15501341,15278688,AG,A,1
NC_037328.1,NC_032650.1,15637265,15637266,15506603,AG,A,1
NC_037328.1,NC_032650.1,15671471,15671487,15540819,CAACTGGCCCAGTCCAA,C,16
NC_037328.1,NC_032650.1,15694390,15694391,15563697,TG,T,1
NC_037328.1,NC_032650.1,15698778,15698783,15568030,TTAGTG,T,5
NC_037328.1,NC_032650.1,15803817,15803818,15724122,CG,C,1
NC_037328.1,NC_032650.1,16063518,16063545,15999200,ACGCTTGCACGGTCTGTCACAGCCAGTG,A,27
NC_037328.1,NC_032650.1,16091248,16091249,16027107,AT,A,1
NC_037328.1,NC_032650.1,16094121,16094123,16029980,AAT,A,2
NC_037328.1,NC_032650.1,16098590,16098592,16034449,GTT,G,2
NC_037328.1,NC_032650.1,16203167,16203168,16139061,CT,C,1
NC_037328.1,NC_032650.1,16334962,16334963,16271158,GC,G,1
NC_037328.1,NC_032650.1,16336534,16336535,16272730,AT,A,1
NC_037328.1,NC_032650.1,16412309,16412320,16348463,TGGTTGACAACA,T,11
NC_037328.1,NC_032650.1,16447333,16447334,16383357,TG,T,1
NC_037328.1,NC_032650.1,16924223,16924224,16613589,TC,T,1
NC_037328.1,NC_032650.1,16930412,16930413,16619785,GA,G,1
NC_037328.1,NC_032650.1,16941338,16941340,16663994,TTC,T,2
NC_037328.1,NC_032650.1,16957761,16957763,16680559,GCT,G,2
NC_037328.1,NC_032650.1,17446047,17446048,17133531,TA,T,1
NC_037328.1,NC_032650.1,17480303,17480304,17167702,AC,A,1
NC_037328.1,NC_032650.1,17480579,17480585,17167977,TCCTTTC,T,6
NC_037328.1,NC_032650.1,17496143,17496144,17183308,CA,C,1
NC_037328.1,NC_032650.1,17521300,17521301,17208221,AG,A,1
NC_037328.1,NC_032650.1,17751395,17751396,17476971,GC,G,1
NC_037328.1,NC_032650.1,17899835,17899836,17468172,GC,G,1
NC_037328.1,NC_032650.1,18327108,18327109,17971627,TG,T,1
NC_037328.1,NC_032650.1,18327122,18327124,17971640,AAG,A,2
NC_037328.1,NC_032650.1,18327149,18327151,17971665,TTA,T,2
NC_037328.1,NC_032650.1,18713070,18713071,18427243,TG,T,1
NC_037328.1,NC_032650.1,18754462,18754463,18468715,CG,C,1
NC_037328.1,NC_032650.1,18771758,18771759,18486005,AG,A,1
NC_037328.1,NC_032650.1,18952278,18952279,18662455,CT,C,1
NC_037328.1,NC_032650.1,18965580,18965584,18675046,CATTT,C,4
NC_037328.1,NC_032650.1,19054975,19054977,18763520,AAC,A,2
NC_037328.1,NC_032650.1,19055028,19055029,18763570,CT,C,1
NC_037328.1,NC_032650.1,19070395,19070396,18779060,AT,A,1
NC_037328.1,NC_032650.1,19518357,19518358,19234930,CA,C,1
NC_037328.1,NC_032650.1,20938093,20938095,20677554,TTC,T,2
NC_037328.1,NC_032650.1,21331331,21331332,21088461,AC,A,1
NC_037328.1,NC_032650.1,21349523,21349524,21106654,GC,G,1
NC_037328.1,NC_032650.1,21750462,21750463,21539296,CT,C,1
NC_037328.1,NC_032650.1,21802937,21802939,21591913,AAG,A,2
NC_037328.1,NC_032650.1,21802953,21802954,21591927,CT,C,1
NC_037328.1,NC_032650.1,21802959,21802960,21591932,AT,A,1
NC_037328.1,NC_032650.1,21845690,21845691,21634665,AT,A,1
NC_037328.1,NC_032650.1,21893836,21893837,21683062,AG,A,1
NC_037328.1,NC_032650.1,22034195,22034196,21823933,CT,C,1
NC_037328.1,NC_032650.1,22053575,22053576,21843323,GA,G,1
NC_037328.1,NC_032650.1,22384029,22384031,22174002,TTA,T,2
NC_037328.1,NC_032650.1,22399595,22399602,22189882,TCCTTTCC,T,7
NC_037328.1,NC_032650.1,22399629,22399630,22189909,CA,C,1
NC_037328.1,NC_032650.1,22517699,22517710,22307393,CAAGTTTAGTTT,C,11
NC_037328.1,NC_032650.1,22625425,22625426,22415721,CA,C,1
NC_037328.1,NC_032650.1,23027091,23027093,22888657,GTC,G,2
NC_037328.1,NC_032650.1,23029909,23029910,22891480,CG,C,1
NC_037328.1,NC_032650.1,23031247,23031255,22892818,AATTATGTG,A,8
NC_037328.1,NC_032650.1,23075609,23075610,22937179,TC,T,1
NC_037328.1,NC_032650.1,23198724,23198725,23059531,TA,T,1
NC_037328.1,NC_032650.1,23590811,23590813,23454563,AAG,A,2
NC_037328.1,NC_032650.1,23590858,23590859,23454607,CA,C,1
NC_037328.1,NC_032650.1,23876086,23876097,23798796,CGCCTCAACTTT,C,11
NC_037328.1,NC_032650.1,23876146,23876156,23798845,CATGGTCATTG,C,10
NC_037328.1,NC_032650.1,23931459,23931460,23853987,GA,G,1
NC_037328.1,NC_032650.1,23931714,23931715,23854241,GA,G,1
NC_037328.1,NC_032650.1,23943274,23943279,23865627,CAAGGG,C,5
NC_037328.1,NC_032650.1,25687765,25687767,25569364,CAT,C,2
NC_037328.1,NC_032650.1,25818542,25818545,25706916,ATCT,A,3
NC_037328.1,NC_032650.1,26525159,26525160,26506589,GT,G,1
NC_037328.1,NC_032650.1,27268219,27268220,27260400,TC,T,1
NC_037328.1,NC_032650.1,27322582,27322584,27406023,TCA,T,2
NC_037328.1,NC_032650.1,27347001,27347002,27307522,TA,T,1
NC_037328.1,NC_032650.1,27348052,27348053,27308568,AC,A,1
NC_037328.1,NC_032650.1,27348755,27348756,27309275,TG,T,1
NC_037328.1,NC_032650.1,27383798,27383799,27344231,GA,G,1
NC_037328.1,NC_032650.1,27393450,27393451,27353439,CG,C,1
NC_037328.1,NC_032650.1,27422910,27422911,27436699,TA,T,1
NC_037328.1,NC_032650.1,27533175,27533176,27547168,AC,A,1
NC_037328.1,NC_032650.1,27606907,27606908,27650099,TC,T,1
NC_037328.1,NC_032650.1,27660551,27660552,27703655,AG,A,1
NC_037328.1,NC_032650.1,27740666,27740667,27875774,GT,G,1
NC_037328.1,NC_032650.1,27773167,27773179,27907647,TAGTAAATATTAC,T,12
NC_037328.1,NC_032650.1,27805532,27805533,27939832,TC,T,1
NC_037328.1,NC_032650.1,28165130,28165131,28506306,AT,A,1
NC_037328.1,NC_032650.1,28165136,28165137,28506311,CT,C,1
NC_037328.1,NC_032650.1,28211996,28211997,28556613,GA,G,1
NC_037328.1,NC_032650.1,28212006,28212007,28556622,AT,A,1
NC_037328.1,NC_032650.1,28212014,28212015,28556629,AT,A,1
NC_037328.1,NC_032650.1,28212039,28212040,28556652,GC,G,1
NC_037328.1,NC_032650.1,28349393,28349394,28693421,CT,C,1
NC_037328.1,NC_032650.1,28405349,28405350,28763608,TA,T,1
NC_037328.1,NC_032650.1,28442428,28442429,28800462,AC,A,1
NC_037328.1,NC_032650.1,28442437,28442438,28800470,GT,G,1
NC_037328.1,NC_032650.1,28442499,28442500,28800529,TA,T,1
NC_037328.1,NC_032650.1,28442531,28442532,28800559,AT,A,1
NC_037328.1,NC_032650.1,28512679,28512681,28870163,TAA,T,2
NC_037328.1,NC_032650.1,28907681,28907683,29214751,TTC,T,2
NC_037328.1,NC_032650.1,28907720,28907721,29214787,CA,C,1
NC_037328.1,NC_032650.1,28990401,28990402,29296318,CT,C,1
NC_037328.1,NC_032650.1,29061362,29061363,29366661,AG,A,1
NC_037328.1,NC_032650.1,29063595,29063596,29368890,AG,A,1
NC_037328.1,NC_032650.1,29070383,29070384,29375680,GT,G,1
NC_037328.1,NC_032650.1,29138736,29138737,29443785,CT,C,1
NC_037328.1,NC_032650.1,29138829,29138831,29443876,GCT,G,2
NC_037328.1,NC_032650.1,29148980,29148982,29454029,TCA,T,2
NC_037328.1,NC_032650.1,29233201,29233202,29544115,AT,A,1
NC_037328.1,NC_032650.1,29272521,29272523,29583288,CAT,C,2
NC_037328.1,NC_032650.1,29358400,29358401,29670027,AT,A,1
NC_037328.1,NC_032650.1,29361276,29361277,29672902,AT,A,1
NC_037328.1,NC_032650.1,29584551,29584552,29895326,TG,T,1
NC_037328.1,NC_032650.1,29608558,29608565,29919343,GATAAAGT,G,7
NC_037328.1,NC_032650.1,29649120,29649121,29960356,GA,G,1
NC_037328.1,NC_032650.1,29717664,29717665,30028911,AC,A,1
NC_037328.1,NC_032650.1,29870563,29870566,30189188,TTCC,T,3
NC_037328.1,NC_032650.1,29891788,29891789,30210841,AG,A,1
NC_037328.1,NC_032650.1,29915237,29915238,30233829,CG,C,1
NC_037328.1,NC_032650.1,29921730,29921731,30240470,TG,T,1
NC_037328.1,NC_032650.1,30215456,30215457,30614068,CA,C,1
NC_037328.1,NC_032650.1,30218106,30218107,30616717,TA,T,1
NC_037328.1,NC_032650.1,30266106,30266107,30666599,AC,A,1
NC_037328.1,NC_032650.1,30266115,30266116,30666607,CA,C,1
NC_037328.1,NC_032650.1,30442410,30442411,30843666,TG,T,1
NC_037328.1,NC_032650.1,31152559,31152562,31063494,AGAG,A,3
NC_037328.1,NC_032650.1,31153789,31153791,31064724,CAG,C,2
NC_037328.1,NC_032650.1,31523462,31523463,31440852,CA,C,1
NC_037328.1,NC_032650.1,31523478,31523479,31440867,TA,T,1
NC_037328.1,NC_032650.1,31544075,31544076,31413612,CG,C,1
NC_037328.1,NC_032650.1,31581678,31581680,31489983,CTT,C,2
NC_037328.1,NC_032650.1,31624384,31624386,31554919,CAG,C,2
NC_037328.1,NC_032650.1,31712868,31712869,31778166,CT,C,1
NC_037328.1,NC_032650.1,31712882,31712883,31778179,TG,T,1
NC_037328.1,NC_032650.1,31715117,31715118,31782278,GC,G,1
NC_037328.1,NC_032650.1,31787495,31787497,31776292,GTA,G,2
NC_037328.1,NC_032650.1,31794079,31794085,31856979,CATAATT,C,6
NC_037328.1,NC_032650.1,31854342,31854343,31917419,AC,A,1
NC_037328.1,NC_032650.1,31854407,31854409,31917483,AAC,A,2
NC_037328.1,NC_032650.1,31854559,31854560,31917631,GA,G,1
NC_037328.1,NC_032650.1,32109671,32109672,32192545,AT,A,1
NC_037328.1,NC_032650.1,32251270,32251273,32334853,GAAA,G,3
NC_037328.1,NC_032650.1,32255642,32255643,32339933,AC,A,1
NC_037328.1,NC_032650.1,32268825,32268826,32353108,AC,A,1
NC_037328.1,NC_032650.1,32282947,32282948,32367254,TC,T,1
NC_037328.1,NC_032650.1,32285260,32285261,32369566,AG,A,1
NC_037328.1,NC_032650.1,32287796,32287797,32372115,TG,T,1
NC_037328.1,NC_032650.1,32289945,32289946,32374261,CT,C,1
NC_037328.1,NC_032650.1,32293776,32293777,32376591,TG,T,1
NC_037328.1,NC_032650.1,32295209,32295211,32378014,TAG,T,2
NC_037328.1,NC_032650.1,32297274,32297276,32380072,CTT,C,2
NC_037328.1,NC_032650.1,32426043,32426044,32519190,AG,A,1
NC_037328.1,NC_032650.1,32426195,32426197,32519340,CCT,C,2
NC_037328.1,NC_032650.1,32547964,32547968,32641665,CTACT,C,4
NC_037328.1,NC_032650.1,32895940,32895946,33023640,TGAATGA,T,6
NC_037328.1,NC_032650.1,32974257,32974258,33098892,TA,T,1
NC_037328.1,NC_032650.1,32997677,32997678,33122218,TG,T,1
NC_037328.1,NC_032650.1,32999779,32999781,33124174,GGA,G,2
NC_037328.1,NC_032650.1,33113606,33113607,33215884,GC,G,1
NC_037328.1,NC_032650.1,33165466,33165467,33267759,GA,G,1
NC_037328.1,NC_032650.1,33329986,33329987,33591175,AC,A,1
NC_037328.1,NC_032650.1,33334717,33334718,33595928,CA,C,1
NC_037328.1,NC_032650.1,33387691,33387693,33648894,CCT,C,2
NC_037328.1,NC_032650.1,33400040,33400041,33661250,AC,A,1
NC_037328.1,NC_032650.1,33400373,33400375,33661586,CTT,C,2
NC_037328.1,NC_032650.1,33514950,33514951,33776247,AT,A,1
NC_037328.1,NC_032650.1,33525944,33525945,33787254,TA,T,1
NC_037328.1,NC_032650.1,33583777,33583780,33845138,ATCT,A,3
NC_037328.1,NC_032650.1,33594005,33594006,33855356,AG,A,1
NC_037328.1,NC_032650.1,33675339,33675340,33940265,GA,G,1
NC_037328.1,NC_032650.1,33679825,33679826,33944740,TA,T,1
NC_037328.1,NC_032650.1,33727101,33727105,33998553,ACAAG,A,4
NC_037328.1,NC_032650.1,33801869,33801870,34073271,GA,G,1
NC_037328.1,NC_032650.1,33804332,33804334,34075733,TTA,T,2
NC_037328.1,NC_032650.1,33876791,33876792,34178039,TA,T,1
NC_037328.1,NC_032650.1,33878473,33878474,34179719,AT,A,1
NC_037328.1,NC_032650.1,34013757,34013759,34315939,CAA,C,2
NC_037328.1,NC_032650.1,34092755,34092757,34394663,GGT,G,2
NC_037328.1,NC_032650.1,34419152,34419153,34721388,AG,A,1
NC_037328.1,NC_032650.1,34419152,34419153,34764911,AG,A,1
NC_037328.1,NC_032650.1,34710653,34710654,35057456,GA,G,1
NC_037328.1,NC_032650.1,34710661,34710662,35057463,GA,G,1
NC_037328.1,NC_032650.1,35200819,35200820,35552886,TG,T,1
NC_037328.1,NC_032650.1,35347442,35347462,35701803,ATTTATCAAAAACTGGGCTAT,A,20
NC_037328.1,NC_032650.1,35614547,35614549,35999931,TAC,T,2
NC_037328.1,NC_032650.1,35614563,35614564,35999945,GT,G,1
NC_037328.1,NC_032650.1,35614584,35614585,35999965,TA,T,1
NC_037328.1,NC_032650.1,35728123,35728124,36113873,AT,A,1
NC_037328.1,NC_032650.1,35993806,35993807,36386408,AG,A,1
NC_037328.1,NC_032650.1,36121233,36121234,36555704,GA,G,1
NC_037328.1,NC_032650.1,36367950,36367952,36828169,ATT,A,2
NC_037328.1,NC_032650.1,36654900,36654901,37124769,AT,A,1
NC_037328.1,NC_032650.1,36816976,36816977,37286650,CA,C,1
NC_037328.1,NC_032650.1,36964371,36964372,37433866,GA,G,1
NC_037328.1,NC_032650.1,37065372,37065373,37535219,GC,G,1
NC_037328.1,NC_032650.1,37594937,37594938,38069375,GA,G,1
NC_037328.1,NC_032650.1,37594997,37594998,38069432,TA,T,1
NC_037328.1,NC_032650.1,37595005,37595006,38069439,GA,G,1
NC_037328.1,NC_032650.1,37595009,37595010,38069442,CA,C,1
NC_037328.1,NC_032650.1,37595223,37595224,38069635,AG,A,1
NC_037328.1,NC_032650.1,37595234,37595235,38069645,CT,C,1
NC_037328.1,NC_032650.1,37595239,37595240,38069649,CT,C,1
NC_037328.1,NC_032650.1,37595255,37595256,38069664,AT,A,1
NC_037328.1,NC_032650.1,37764762,37764763,38331898,AT,A,1
NC_037328.1,NC_032650.1,37891176,37891177,38458036,GT,G,1
NC_037328.1,NC_032650.1,37940164,37940165,38507021,CA,C,1
NC_037328.1,NC_032650.1,38006921,38006922,38573646,GA,G,1
NC_037328.1,NC_032650.1,38006928,38006929,38573652,CT,C,1
NC_037328.1,NC_032650.1,38006934,38006935,38573657,TG,T,1
NC_037328.1,NC_032650.1,38006950,38006951,38573672,AC,A,1
NC_037328.1,NC_032650.1,38006957,38006958,38573678,GT,G,1
NC_037328.1,NC_032650.1,38092035,38092036,38658755,AT,A,1
NC_037328.1,NC_032650.1,38259982,38259983,38826320,CT,C,1
NC_037328.1,NC_032650.1,38259992,38259993,38826329,TC,T,1
NC_037328.1,NC_032650.1,39281719,39281720,39988618,AC,A,1
NC_037328.1,NC_032650.1,39946642,39946643,40652667,CA,C,1
NC_037328.1,NC_032650.1,39949038,39949040,40655063,TTC,T,2
NC_037328.1,NC_032650.1,39982315,39982316,40688382,CA,C,1
NC_037328.1,NC_032650.1,40015251,40015253,40721319,TTC,T,2
NC_037328.1,NC_032650.1,40171137,40171139,40935596,ACT,A,2
NC_037328.1,NC_032650.1,40368085,40368087,41138178,TTC,T,2
NC_037328.1,NC_032650.1,40386113,40386114,41156223,CA,C,1
NC_037328.1,NC_032650.1,40433171,40433172,41204361,CA,C,1
NC_037328.1,NC_032650.1,40674846,40674847,41465319,CT,C,1
NC_037328.1,NC_032650.1,40675553,40675554,41466025,CG,C,1
NC_037328.1,NC_032650.1,40757601,40757602,41548130,TC,T,1
NC_037328.1,NC_032650.1,40835186,40835187,41624050,TA,T,1
NC_037328.1,NC_032650.1,40959938,40959941,41748815,GTCT,G,3
NC_037328.1,NC_032650.1,41113143,41113144,41936104,CT,C,1
NC_037328.1,NC_032650.1,41199773,41199778,42108785,AGAGAT,A,5
NC_037328.1,NC_032650.1,41261287,41261288,42170271,TA,T,1
NC_037328.1,NC_032650.1,41261292,41261293,42170275,CA,C,1
NC_037328.1,NC_032650.1,41261307,41261308,42170289,GA,G,1
NC_037328.1,NC_032650.1,41261312,41261313,42170293,CA,C,1
NC_037328.1,NC_032650.1,41262786,41262787,42171764,GT,G,1
NC_037328.1,NC_032650.1,41265808,41265809,42174811,AG,A,1
NC_037328.1,NC_032650.1,41352538,41352541,42309398,GGTA,G,3
NC_037328.1,NC_032650.1,41854830,41854831,42804820,CA,C,1
NC_037328.1,NC_032650.1,41954294,41954297,42904473,AGAT,A,3
NC_037328.1,NC_032650.1,41959147,41959148,42909327,TG,T,1
NC_037328.1,NC_032650.1,42019772,42019773,42970094,AT,A,1
NC_037328.1,NC_032650.1,42033191,42033194,42983518,ACAG,A,3
NC_037328.1,NC_032650.1,42068770,42068775,43018600,AGCTGG,A,5
NC_037328.1,NC_032650.1,42111747,42111748,43060482,TG,T,1
NC_037328.1,NC_032650.1,42278494,42278495,43232776,GT,G,1
NC_037328.1,NC_032650.1,42284904,42284907,43239010,TCAC,T,3
NC_037328.1,NC_032650.1,42514185,42514186,43484581,CA,C,1
NC_037328.1,NC_032650.1,42517811,42517813,43487167,TAC,T,2
NC_037328.1,NC_032650.1,42556726,42556727,43526106,CA,C,1
NC_037328.1,NC_032650.1,42606035,42606036,43588881,TA,T,1
NC_037328.1,NC_032650.1,42606046,42606047,43588891,AC,A,1
NC_037328.1,NC_032650.1,42606061,42606062,43588905,CT,C,1
NC_037328.1,NC_032650.1,42658154,42658155,43630729,TC,T,1
NC_037328.1,NC_032650.1,42856630,42856632,43834119,CAT,C,2
NC_037328.1,NC_032650.1,43372565,43372566,44423955,TA,T,1
NC_037328.1,NC_032650.1,43406244,43406245,44459212,CA,C,1
NC_037328.1,NC_032650.1,43595060,43595061,44647999,CA,C,1
NC_037328.1,NC_032650.1,43688246,43688247,44741369,TG,T,1
NC_037328.1,NC_032650.1,43913710,43913711,44966064,CA,C,1
NC_037328.1,NC_032650.1,43969329,43969330,45028037,AT,A,1
NC_037328.1,NC_032650.1,43970699,43970701,45029406,CAA,C,2
NC_037328.1,NC_032650.1,44145588,44145589,45205768,AC,A,1
NC_037328.1,NC_032650.1,44469301,44469302,45529104,TG,T,1
NC_037328.1,NC_032650.1,44540313,44540314,45638897,TA,T,1
NC_037328.1,NC_032650.1,44648694,44648700,45747486,TGATCAA,T,6
NC_037328.1,NC_032650.1,45146634,45146635,46279055,CA,C,1
NC_037328.1,NC_032650.1,45243566,45243570,46376064,TAACA,T,4
NC_037328.1,NC_032650.1,45289891,45289904,46422240,CCAGAGCCACGAGG,C,13
NC_037328.1,NC_032650.1,45383133,45383134,46515710,CT,C,1
NC_037328.1,NC_032650.1,45702907,45702908,46833449,AT,A,1
NC_037328.1,NC_032650.1,45702931,45702932,46833472,GA,G,1
NC_037328.1,NC_032650.1,45800823,45800824,46931364,AG,A,1
NC_037328.1,NC_032650.1,45813126,45813128,46943328,AAT,A,2
NC_037328.1,NC_032650.1,46224778,46224779,47352664,AT,A,1
NC_037328.1,NC_032650.1,46922215,46922216,48113669,TC,T,1
NC_037328.1,NC_032650.1,47007409,47007410,48198859,TC,T,1
NC_037328.1,NC_032650.1,47048956,47048957,48240397,CT,C,1
NC_037328.1,NC_032650.1,47234321,47234322,48426440,AC,A,1
NC_037328.1,NC_032650.1,47318596,47318597,48510773,AG,A,1
NC_037328.1,NC_032650.1,47330910,47330911,48522656,TA,T,1
NC_037328.1,NC_032650.1,47344083,47344084,48535755,GC,G,1
NC_037328.1,NC_032650.1,47521130,47521131,48743836,TA,T,1
NC_037328.1,NC_032650.1,47675707,47675708,48890989,AG,A,1
NC_037328.1,NC_032650.1,47760655,47760656,48976092,GT,G,1
NC_037328.1,NC_032650.1,47858504,47858505,49088128,AG,A,1
NC_037328.1,NC_032650.1,48015483,48015484,49276190,CA,C,1
NC_037328.1,NC_032650.1,48032470,48032471,49296629,TC,T,1
NC_037328.1,NC_032650.1,48263381,48263382,49539882,TC,T,1
NC_037328.1,NC_032650.1,48286971,48286972,49563477,GT,G,1
NC_037328.1,NC_032650.1,48394490,48394494,49671494,GTAGA,G,4
NC_037328.1,NC_032650.1,48480825,48480826,49757702,GT,G,1
NC_037328.1,NC_032650.1,48480872,48480874,49757748,TAA,T,2
NC_037328.1,NC_032650.1,48531569,48531575,49807940,AGGATTT,A,6
NC_037328.1,NC_032650.1,48811985,48811986,49936542,AT,A,1
NC_037328.1,NC_032650.1,48934985,48934986,50059596,AC,A,1
NC_037328.1,NC_032650.1,48935786,48935787,50060395,TC,T,1
NC_037328.1,NC_032650.1,48938147,48938148,50062755,AG,A,1
NC_037328.1,NC_032650.1,49088896,49088897,50214868,CA,C,1
NC_037328.1,NC_032650.1,49124154,49124155,50250120,GT,G,1
NC_037328.1,NC_032650.1,49138450,49138451,50264248,CA,C,1
NC_037328.1,NC_032650.1,49788904,49788907,50331649,TCTG,T,3
NC_037328.1,NC_032650.1,49812369,49812370,50356683,CA,C,1
NC_037328.1,NC_032650.1,50450965,50450966,50995219,GT,G,1
NC_037328.1,NC_032650.1,50455046,50455057,50999299,AGGAAGTTTAGT,A,11
NC_037328.1,NC_032650.1,50700930,50700932,51256357,TTC,T,2
NC_037328.1,NC_032650.1,50700939,50700940,51256364,AT,A,1
NC_037328.1,NC_032650.1,50700963,50700965,51256387,TTA,T,2
NC_037328.1,NC_032650.1,50700974,50700975,51256396,CA,C,1
NC_037328.1,NC_032650.1,50994562,50994563,51550122,CA,C,1
NC_037328.1,NC_032650.1,51015783,51015784,51576651,CA,C,1
NC_037328.1,NC_032650.1,51064807,51064808,51630764,TC,T,1
NC_037328.1,NC_032650.1,51064824,51064825,51630780,GT,G,1
NC_037328.1,NC_032650.1,51064842,51064843,51630797,AG,A,1
NC_037328.1,NC_032650.1,51064910,51064911,51630863,CA,C,1
NC_037328.1,NC_032650.1,51121069,51121070,51686928,GT,G,1
NC_037328.1,NC_032650.1,51358503,51358504,51948906,AC,A,1
NC_037328.1,NC_032650.1,51379997,51380001,51972890,GGATT,G,4
NC_037328.1,NC_032650.1,51380067,51380069,51972956,AAC,A,2
NC_037328.1,NC_032650.1,51405237,51405238,51998075,CG,C,1
NC_037328.1,NC_032650.1,51468217,51468218,51934334,CA,C,1
NC_037328.1,NC_032650.1,51470324,51470325,51936433,GA,G,1
NC_037328.1,NC_032650.1,51682931,51682932,52248804,AG,A,1
NC_037328.1,NC_032650.1,51751248,51751249,52316987,TC,T,1
NC_037328.1,NC_032650.1,52409696,52409697,52998620,TC,T,1
NC_037328.1,NC_032650.1,52450304,52450305,53039237,GA,G,1
NC_037328.1,NC_032650.1,55461233,55461234,56129015,AG,A,1
NC_037328.1,NC_032650.1,55486519,55486520,56153701,GA,G,1
NC_037328.1,NC_032650.1,55839725,55839726,56535808,GT,G,1
NC_037328.1,NC_032650.1,56038910,56038911,56736430,CA,C,1
NC_037328.1,NC_032650.1,56038915,56038917,56736434,TTC,T,2
NC_037328.1,NC_032650.1,56303490,56303491,57001026,CA,C,1
NC_037328.1,NC_032650.1,56560488,56560489,57279922,CA,C,1
NC_037328.1,NC_032650.1,56899676,56899677,57594074,AT,A,1
NC_037328.1,NC_032650.1,56899682,56899683,57594079,GT,G,1
NC_037328.1,NC_032650.1,56899689,56899690,57594085,CG,C,1
NC_037328.1,NC_032650.1,56972542,56972543,57667900,AT,A,1
NC_037328.1,NC_032650.1,56972565,56972566,57667922,AT,A,1
NC_037328.1,NC_032650.1,57476112,57476113,58231857,TG,T,1
NC_037328.1,NC_032650.1,57518998,57518999,58275067,CT,C,1
NC_037328.1,NC_032650.1,57519052,57519054,58275118,TTG,T,2
NC_037328.1,NC_032650.1,57730106,57730107,58465070,CT,C,1
NC_037328.1,NC_032650.1,58070095,58070096,58907544,GC,G,1
NC_037328.1,NC_032650.1,58182488,58182489,59055603,AG,A,1
NC_037328.1,NC_032650.1,58370552,58370553,59245586,CA,C,1
NC_037328.1,NC_032650.1,58438443,58438444,59291885,AT,A,1
NC_037328.1,NC_032650.1,58534482,58534483,59391422,CT,C,1
NC_037328.1,NC_032650.1,58534569,58534570,59391508,AT,A,1
NC_037328.1,NC_032650.1,58534581,58534582,59391519,GA,G,1
NC_037328.1,NC_032650.1,58605264,58605265,59462197,TC,T,1
NC_037328.1,NC_032650.1,58605275,58605276,59462207,GA,G,1
NC_037328.1,NC_032650.1,58997588,58997591,59854329,ACAT,A,3
NC_037328.1,NC_032650.1,58998283,58998284,59855021,CT,C,1
NC_037328.1,NC_032650.1,59263087,59263088,60118939,CT,C,1
NC_037328.1,NC_032650.1,59269604,59269605,60125459,AG,A,1
NC_037328.1,NC_032650.1,59281133,59281134,60136989,GC,G,1
NC_037328.1,NC_032650.1,59476302,59476303,60336224,AC,A,1
NC_037328.1,NC_032650.1,59476324,59476325,60336245,AG,A,1
NC_037328.1,NC_032650.1,59939224,59939225,60847231,CG,C,1
NC_037328.1,NC_032650.1,59940636,59940637,60848693,GA,G,1
NC_037328.1,NC_032650.1,60003328,60003329,60911382,AC,A,1
NC_037328.1,NC_032650.1,60277966,60277968,61270132,ATG,A,2
NC_037328.1,NC_032650.1,60312811,60312812,61304972,TA,T,1
NC_037328.1,NC_032650.1,60335122,60335123,61327435,CA,C,1
NC_037328.1,NC_032650.1,60346154,60346155,61338921,AC,A,1
NC_037328.1,NC_032650.1,60482819,60482820,61475729,CA,C,1
NC_037328.1,NC_032650.1,60659181,60659182,61653804,TG,T,1
NC_037328.1,NC_032650.1,60672598,60672599,61666285,GC,G,1
NC_037328.1,NC_032650.1,60743618,60743620,61737321,CGA,C,2
NC_037328.1,NC_032650.1,60785503,60785504,61783153,TA,T,1
NC_037328.1,NC_032650.1,61040378,61040379,62163252,AT,A,1
NC_037328.1,NC_032650.1,61043638,61043639,62166507,GC,G,1
NC_037328.1,NC_032650.1,61097473,61097475,62220793,AAT,A,2
NC_037328.1,NC_032650.1,61127989,61127990,62251399,TA,T,1
NC_037328.1,NC_032650.1,61138885,61138886,62262303,AG,A,1
NC_037328.1,NC_032650.1,61159486,61159487,62282917,TG,T,1
NC_037328.1,NC_032650.1,61189525,61189526,62313584,AG,A,1
NC_037328.1,NC_032650.1,61213855,61213856,62336557,TA,T,1
NC_037328.1,NC_032650.1,61296631,61296632,62422764,TG,T,1
NC_037328.1,NC_032650.1,61332513,61332514,62462851,TG,T,1
NC_037328.1,NC_032650.1,62044182,62044190,62963237,GTAAGTAGT,G,8
NC_037328.1,NC_032650.1,62079991,62079993,62999008,TAA,T,2
NC_037328.1,NC_032650.1,62233186,62233188,63151796,TTA,T,2
NC_037328.1,NC_032650.1,62233198,62233199,63151806,GA,G,1
NC_037328.1,NC_032650.1,62294621,62294622,63213295,GC,G,1
NC_037328.1,NC_032650.1,62448529,62448530,63367448,AG,A,1
NC_037328.1,NC_032650.1,62457228,62457229,63376147,TG,T,1
NC_037328.1,NC_032650.1,62771649,62771650,63694204,CT,C,1
NC_037328.1,NC_032650.1,62771667,62771668,63694221,GT,G,1
NC_037328.1,NC_032650.1,62803160,62803162,63725732,TTC,T,2
NC_037328.1,NC_032650.1,62803160,62803162,63754114,TTC,T,2
NC_037328.1,NC_032650.1,62803735,62803736,63726304,GT,G,1
NC_037328.1,NC_032650.1,62814328,62814329,63765323,GT,G,1
NC_037328.1,NC_032650.1,62855511,62855512,63806515,AT,A,1
NC_037328.1,NC_032650.1,62857822,62857824,63808810,AAT,A,2
NC_037328.1,NC_032650.1,62906973,62906974,63877675,GC,G,1
NC_037328.1,NC_032650.1,62907326,62907327,63862148,CT,C,1
NC_037328.1,NC_032650.1,62945630,62945631,63916931,CA,C,1
NC_037328.1,NC_032650.1,63344478,63344479,64318329,AG,A,1
NC_037328.1,NC_032650.1,63523867,63523869,64498952,TTA,T,2
NC_037328.1,NC_032650.1,63523887,63523889,64498970,TTA,T,2
NC_037328.1,NC_032650.1,63523894,63523895,64498975,GT,G,1
NC_037328.1,NC_032650.1,63523903,63523904,64498983,CT,C,1
NC_037328.1,NC_032650.1,63523918,63523920,64498997,TTG,T,2
NC_037328.1,NC_032650.1,63639416,63639417,64614567,TG,T,1
NC_037328.1,NC_032650.1,63706964,63706966,64682120,AAG,A,2
NC_037328.1,NC_032650.1,63843304,63843305,64840390,TC,T,1
NC_037328.1,NC_032650.1,63855826,63855827,64852933,GA,G,1
NC_037328.1,NC_032650.1,63885904,63885905,64883043,TC,T,1
NC_037328.1,NC_032650.1,63998585,63998586,64995749,CA,C,1
NC_037328.1,NC_032650.1,64428047,64428048,65484032,TC,T,1
NC_037328.1,NC_032650.1,64428863,64428864,65484847,CA,C,1
NC_037328.1,NC_032650.1,64609398,64609400,65666197,TTC,T,2
NC_037328.1,NC_032650.1,64609405,64609407,65666202,TTA,T,2
NC_037328.1,NC_032650.1,64609416,64609418,65666211,TTC,T,2
NC_037328.1,NC_032650.1,64773722,64773723,65834628,CA,C,1
NC_037328.1,NC_032650.1,64787756,64787757,65848662,TA,T,1
NC_037328.1,NC_032650.1,64797591,64797615,65858496,TAGTGTAGTGTACCCTACTACACTA,T,24
NC_037328.1,NC_032650.1,64835915,64835916,65895872,GT,G,1
NC_037328.1,NC_032650.1,64877345,64877347,65937184,TTC,T,2
NC_037328.1,NC_032650.1,64999375,64999376,66058729,AT,A,1
NC_037328.1,NC_032650.1,65152747,65152748,66241951,GA,G,1
NC_037328.1,NC_032650.1,65152777,65152779,66241980,AAT,A,2
NC_037328.1,NC_032650.1,65152782,65152783,66241983,TC,T,1
NC_037328.1,NC_032650.1,65152791,65152792,66241991,CA,C,1
NC_037328.1,NC_032650.1,65152799,65152813,66241998,CTGTGCCTCCTGATT,C,14
NC_037328.1,NC_032650.1,65340869,65340870,66360658,TG,T,1
NC_037328.1,NC_032650.1,65340890,65340891,66360678,AG,A,1
NC_037328.1,NC_032650.1,65340898,65340899,66360685,TC,T,1
NC_037328.1,NC_032650.1,65914146,65914147,66995821,AT,A,1
NC_037328.1,NC_032650.1,65914151,65914152,66995825,CT,C,1
NC_037328.1,NC_032650.1,65914160,65914161,66995833,AT,A,1
NC_037328.1,NC_032650.1,66496588,66496589,67587038,GC,G,1
NC_037328.1,NC_032650.1,66525995,66525996,67616484,AT,A,1
NC_037328.1,NC_032650.1,66671077,66671078,67763476,CA,C,1
NC_037328.1,NC_032650.1,66678511,66678512,67770916,CA,C,1
NC_037328.1,NC_032650.1,66903581,66903582,68012300,TG,T,1
NC_037328.1,NC_032650.1,66903594,66903595,68012312,AT,A,1
NC_037328.1,NC_032650.1,66903637,66903638,68012353,AT,A,1
NC_037328.1,NC_032650.1,67443988,67443989,68553754,GA,G,1
NC_037328.1,NC_032650.1,67505388,67505389,68612184,TG,T,1
NC_037328.1,NC_032650.1,67595454,67595458,68707338,TAAAC,T,4
NC_037328.1,NC_032650.1,67660807,67660808,68773449,CT,C,1
NC_037328.1,NC_032650.1,67824213,67824214,68947154,AG,A,1
NC_037328.1,NC_032650.1,67841308,67841309,68964248,CT,C,1
NC_037328.1,NC_032650.1,67846042,67846044,68968980,CCA,C,2
NC_037328.1,NC_032650.1,67846087,67846088,68969023,GT,G,1
NC_037328.1,NC_032650.1,67846098,67846099,68969033,CT,C,1
NC_037328.1,NC_032650.1,67946913,67946915,69069482,AAT,A,2
NC_037328.1,NC_032650.1,68201827,68201828,69297352,TG,T,1
NC_037328.1,NC_032650.1,68201852,68201853,69297376,TG,T,1
NC_037328.1,NC_032650.1,68201881,68201882,69297403,GT,G,1
NC_037328.1,NC_032650.1,68201889,68201890,69297410,GC,G,1
NC_037328.1,NC_032650.1,69188557,69188558,70392053,GC,G,1
NC_037328.1,NC_032650.1,69188595,69188596,70392089,TA,T,1
NC_037328.1,NC_032650.1,69188608,69188609,70392101,TG,T,1
NC_037328.1,NC_032650.1,69228732,69228733,70432228,TC,T,1
NC_037328.1,NC_032650.1,69251262,69251263,70454838,GT,G,1
NC_037328.1,NC_032650.1,69301491,69301492,70505632,AT,A,1
NC_037328.1,NC_032650.1,69878148,69878149,71086055,AG,A,1
NC_037328.1,NC_032650.1,70191496,70191497,71418429,CT,C,1
NC_037328.1,NC_032650.1,70657409,70657410,71836324,CA,C,1
NC_037328.1,NC_032650.1,70657427,70657428,71836341,GT,G,1
NC_037328.1,NC_032650.1,70821879,70821880,72000444,AG,A,1
NC_037328.1,NC_032650.1,70867204,70867205,72047525,AC,A,1
NC_037328.1,NC_032650.1,70891785,70891786,72093727,AC,A,1
NC_037328.1,NC_032650.1,71112407,71112408,72356759,AG,A,1
NC_037328.1,NC_032650.1,71112430,71112431,72356781,GA,G,1
NC_037328.1,NC_032650.1,71112437,71112438,72356787,AT,A,1
NC_037328.1,NC_032650.1,71112454,71112455,72356803,GT,G,1
NC_037328.1,NC_032650.1,71112539,71112540,72356886,AT,A,1
NC_037328.1,NC_032650.1,71416105,71416106,72530491,CA,C,1
NC_037328.1,NC_032650.1,71417816,71417817,72532201,CT,C,1
NC_037328.1,NC_032650.1,71769852,71769853,72914597,CT,C,1
NC_037328.1,NC_032650.1,71793443,71793444,72938184,AG,A,1
NC_037328.1,NC_032650.1,71793448,71793449,72938188,GA,G,1
NC_037328.1,NC_032650.1,72042514,72042515,73187174,GA,G,1
NC_037328.1,NC_032650.1,72042527,72042528,73187186,CT,C,1
NC_037328.1,NC_032650.1,72042532,72042533,73187190,TA,T,1
NC_037328.1,NC_032650.1,72042544,72042545,73187201,AG,A,1
NC_037328.1,NC_032650.1,72187430,72187432,73331383,AAT,A,2
NC_037328.1,NC_032650.1,72187441,72187442,73331392,AT,A,1
NC_037328.1,NC_032650.1,72686568,72686570,74011416,AGC,A,2
NC_037328.1,NC_032650.1,72723447,72723448,74048318,GT,G,1
NC_037328.1,NC_032650.1,73056598,73056599,74441251,AC,A,1
NC_037328.1,NC_032650.1,73402736,73402737,74787384,AG,A,1
NC_037328.1,NC_032650.1,73402781,73402782,74787428,AG,A,1
NC_037328.1,NC_032650.1,73402878,73402879,74787524,AG,A,1
NC_037328.1,NC_032650.1,73773508,73773509,75186913,AG,A,1
NC_037328.1,NC_032650.1,73773514,73773515,75186918,CA,C,1
NC_037328.1,NC_032650.1,73856852,73856854,75277122,TTG,T,2
NC_037328.1,NC_032650.1,73856891,73856893,75277158,GGA,G,2
NC_037328.1,NC_032650.1,73879553,73879554,75299819,GT,G,1
NC_037328.1,NC_032650.1,73913554,73913556,75333815,AAT,A,2
NC_037328.1,NC_032650.1,74359676,74359677,75923056,CT,C,1
NC_037328.1,NC_032650.1,74697644,74697658,76260326,GATAATTTGGATAAA,G,14
NC_037328.1,NC_032650.1,74741821,74741822,76304490,TA,T,1
NC_037328.1,NC_032650.1,74818139,74818141,76380969,GGT,G,2
NC_037328.1,NC_032650.1,75005645,75005646,76578227,AT,A,1
NC_037328.1,NC_032650.1,75535314,75535316,77099021,GGC,G,2
NC_037328.1,NC_032650.1,75676820,75676821,77252619,GA,G,1
NC_037328.1,NC_032650.1,76566601,76566602,78207424,AT,A,1
NC_037328.1,NC_032650.1,76678387,76678388,78320801,AC,A,1
NC_037328.1,NC_032650.1,76761020,76761021,78403208,TC,T,1
NC_037328.1,NC_032650.1,76761026,76761027,78403213,CA,C,1
NC_037328.1,NC_032650.1,77263084,77263085,78985383,GT,G,1
NC_037328.1,NC_032650.1,77346521,77346522,79068603,GT,G,1
NC_037328.1,NC_032650.1,77536885,77536886,79269176,AT,A,1
NC_037328.1,NC_032650.1,77538798,77538800,79271093,GAC,G,2
NC_037328.1,NC_032650.1,77539388,77539389,79271686,AG,A,1
NC_037328.1,NC_032650.1,77539404,77539405,79271701,TG,T,1
NC_037328.1,NC_032650.1,77539418,77539419,79271714,AG,A,1
NC_037328.1,NC_032650.1,77539433,77539434,79271728,GA,G,1
NC_037328.1,NC_032650.1,77539467,77539468,79271761,AG,A,1
NC_037328.1,NC_032650.1,77539489,77539490,79271782,GC,G,1
NC_037328.1,NC_032650.1,78253722,78253724,80011242,CCT,C,2
NC_037328.1,NC_032650.1,78341486,78341487,80098937,GT,G,1
NC_037328.1,NC_032650.1,78349633,78349634,80107084,GA,G,1
NC_037328.1,NC_032650.1,78524882,78524883,80281920,AG,A,1
NC_037328.1,NC_032650.1,78653598,78653599,80410705,AC,A,1
NC_037328.1,NC_032650.1,78653605,78653607,80410711,TGG,T,2
NC_037328.1,NC_032650.1,78896588,78896589,80655950,AC,A,1
NC_037328.1,NC_032650.1,78990286,78990287,80785160,AG,A,1
NC_037328.1,NC_032650.1,79467109,79467110,81260205,AT,A,1
NC_037328.1,NC_032650.1,79526871,79526872,81319966,TG,T,1
NC_037328.1,NC_032650.1,79526896,79526897,81319989,GT,G,1
NC_037328.1,NC_032650.1,79526910,79526911,81320002,GT,G,1
NC_037328.1,NC_032650.1,79671588,79671589,81464718,TG,T,1
NC_037328.1,NC_032650.1,79671653,79671654,81464781,GA,G,1
NC_037328.1,NC_032650.1,79756682,79756684,81549805,CAG,C,2
NC_037328.1,NC_032650.1,79830002,79830003,81657080,TC,T,1
NC_037328.1,NC_032650.1,79926200,79926201,81752597,CA,C,1
NC_037328.1,NC_032650.1,79926918,79926919,81753316,AG,A,1
NC_037328.1,NC_032650.1,79962639,79962640,81789037,CG,C,1
NC_037328.1,NC_032650.1,79992043,79992044,81818442,GT,G,1
NC_037328.1,NC_032650.1,80015633,80015634,81846830,GT,G,1
NC_037328.1,NC_032650.1,80024563,80024564,81855756,TC,T,1
NC_037328.1,NC_032650.1,80029793,80029794,81860985,GT,G,1
NC_037328.1,NC_032650.1,80029802,80029803,81860993,AT,A,1
NC_037328.1,NC_032650.1,80029815,80029816,81861005,TG,T,1
NC_037328.1,NC_032650.1,80029840,80029841,81861029,TG,T,1
NC_037328.1,NC_032650.1,80029847,80029848,81861035,TC,T,1
NC_037328.1,NC_032650.1,80029866,80029867,81861053,TC,T,1
NC_037328.1,NC_032650.1,80085580,80085581,81916769,TG,T,1
NC_037328.1,NC_032650.1,80086036,80086037,81917226,CT,C,1
NC_037328.1,NC_032650.1,80181592,80181593,82019300,GT,G,1
NC_037328.1,NC_032650.1,80245660,80245661,82083103,CA,C,1
NC_037328.1,NC_032650.1,80283322,80283323,82120743,CG,C,1
NC_037328.1,NC_032650.1,80285024,80285025,82122443,CT,C,1
NC_037328.1,NC_032650.1,80550791,80550792,82445488,GC,G,1
NC_037328.1,NC_032650.1,80550842,80550851,82445537,AAGCCTTCAG,A,9
NC_037328.1,NC_032650.1,80648080,80648081,82542856,GA,G,1
NC_037328.1,NC_032650.1,81164237,81164238,83059323,CT,C,1
NC_037328.1,NC_032650.1,81402032,81402033,83296984,TG,T,1
NC_037328.1,NC_032650.1,81476244,81476245,83371332,AT,A,1
NC_037328.1,NC_032650.1,81545868,81545869,83440902,AT,A,1
NC_037328.1,NC_032650.1,81681759,81681760,83576702,CT,C,1
NC_037328.1,NC_032650.1,81721355,81721357,83616322,CCT,C,2
NC_037328.1,NC_032650.1,81785042,81785043,83680004,AC,A,1
NC_037328.1,NC_032650.1,82150444,82150445,84047598,CT,C,1
NC_037328.1,NC_032650.1,82323412,82323413,84220562,GT,G,1
NC_037328.1,NC_032650.1,82344124,82344125,84241272,TC,T,1
NC_037328.1,NC_032650.1,82854623,82854624,84752596,GC,G,1
NC_037328.1,NC_032650.1,82854628,82854629,84752600,AC,A,1
NC_037328.1,NC_032650.1,83118000,83118001,85076722,GT,G,1
NC_037328.1,NC_032650.1,83598768,83598775,85562919,AGCCCAGT,A,7
NC_037328.1,NC_032650.1,83669050,83669051,85679735,GT,G,1
NC_037328.1,NC_032650.1,83695183,83695188,85705607,CTCAGT,C,5
NC_037328.1,NC_032650.1,83704268,83704269,85714737,GT,G,1
NC_037328.1,NC_032650.1,83712095,83712096,85722689,GT,G,1
NC_037328.1,NC_032650.1,83925479,83925480,85936132,TG,T,1
NC_037328.1,NC_032650.1,84011038,84011039,86021733,TG,T,1
NC_037328.1,NC_032650.1,84034777,84034778,86045481,TC,T,1
NC_037328.1,NC_032650.1,84307137,84307138,86322435,AC,A,1
NC_037328.1,NC_032650.1,84447163,84447164,86463954,AC,A,1
NC_037328.1,NC_032650.1,84601502,84601504,86690475,ACT,A,2
NC_037328.1,NC_032650.1,84956510,84956512,87047264,AAT,A,2
NC_037328.1,NC_032650.1,85056569,85056570,87146127,GT,G,1
NC_037328.1,NC_032650.1,85058018,85058019,87147575,TC,T,1
NC_037328.1,NC_032650.1,85252396,85252397,87333213,TA,T,1
NC_037328.1,NC_032650.1,85252401,85252402,87333217,GA,G,1
NC_037328.1,NC_032650.1,85373207,85373208,87454923,CT,C,1
NC_037328.1,NC_032650.1,85721157,85721158,87798646,GA,G,1
NC_037328.1,NC_032650.1,85721170,85721171,87798658,TA,T,1
NC_037328.1,NC_032650.1,85721189,85721190,87798676,CA,C,1
NC_037328.1,NC_032650.1,85721205,85721206,87798691,GT,G,1
NC_037328.1,NC_032650.1,85836188,85836190,87917676,AAT,A,2
NC_037328.1,NC_032650.1,86247149,86247150,88330571,TC,T,1
NC_037328.1,NC_032650.1,86459873,86459874,88543305,GT,G,1
NC_037328.1,NC_032650.1,86459989,86459990,88543420,TA,T,1
NC_037328.1,NC_032650.1,86461883,86461884,88545316,GT,G,1
NC_037328.1,NC_032650.1,86714184,86714185,88824478,TG,T,1
NC_037328.1,NC_032650.1,86834782,86834783,88944509,CT,C,1
NC_037328.1,NC_032650.1,86951942,86951943,89059981,GA,G,1
NC_037328.1,NC_032650.1,86988780,86988782,89096582,CTT,C,2
NC_037328.1,NC_032650.1,87169022,87169023,89326579,AG,A,1
NC_037328.1,NC_032650.1,87245512,87245513,89403080,CT,C,1
NC_037328.1,NC_032650.1,87245854,87245855,89403421,TC,T,1
NC_037328.1,NC_032650.1,87246578,87246579,89404146,TA,T,1
NC_037328.1,NC_032650.1,87721178,87721179,90143410,AG,A,1
NC_037328.1,NC_032650.1,88851987,88851988,90880327,TA,T,1
NC_037328.1,NC_032650.1,88960809,88960812,90989283,TTGC,T,3
NC_037328.1,NC_032650.1,88963140,88963141,90991621,AG,A,1
NC_037328.1,NC_032650.1,88978484,88978485,91006949,GT,G,1
NC_037328.1,NC_032650.1,89095537,89095538,91125035,AT,A,1
NC_037328.1,NC_032650.1,89118094,89118095,91147591,CT,C,1
NC_037328.1,NC_032650.1,89139735,89139736,91169233,CT,C,1
NC_037328.1,NC_032650.1,89139748,89139749,91169245,AT,A,1
NC_037328.1,NC_032650.1,89148921,89148923,91178144,ACC,A,2
NC_037328.1,NC_032650.1,89224018,89224019,91252952,TA,T,1
NC_037328.1,NC_032650.1,89224024,89224025,91252957,GA,G,1
NC_037328.1,NC_032650.1,89235943,89235957,91264871,CTCTCATGGTCTCAT,C,14
NC_037328.1,NC_032650.1,89503440,89503443,91528343,GAGA,G,3
NC_037328.1,NC_032650.1,89876415,89876416,91901011,AG,A,1
NC_037328.1,NC_032650.1,89880743,89880744,91905338,CG,C,1
NC_037328.1,NC_032650.1,89962608,89962609,91987193,GC,G,1
NC_037328.1,NC_032650.1,90004701,90004702,92034347,CA,C,1
NC_037328.1,NC_032650.1,90004734,90004753,92034379,ATTTATCCTAAGGGGCACAT,A,19
NC_037328.1,NC_032650.1,90018892,90018893,92048524,CA,C,1
NC_037328.1,NC_032650.1,90080772,90080773,92109918,TA,T,1
NC_037328.1,NC_032650.1,90080775,90080776,92109920,AT,A,1
NC_037328.1,NC_032650.1,90080782,90080784,92109926,TTA,T,2
NC_037328.1,NC_032650.1,90080799,90080800,92109941,AT,A,1
NC_037328.1,NC_032650.1,90102670,90102671,92131770,AG,A,1
NC_037328.1,NC_032650.1,90102745,90102746,92131844,GC,G,1
NC_037328.1,NC_032650.1,90704096,90704097,92808435,AG,A,1
NC_037328.1,NC_032650.1,90729879,90729880,92834231,AC,A,1
NC_037328.1,NC_032650.1,90857509,90857510,92986770,AT,A,1
NC_037328.1,NC_032650.1,90928347,90928348,93094697,TC,T,1
NC_037328.1,NC_032650.1,90948739,90948740,93115089,CT,C,1
NC_037328.1,NC_032650.1,91031846,91031847,93240760,AG,A,1
NC_037328.1,NC_032650.1,91065570,91065571,93280808,AC,A,1
NC_037328.1,NC_032650.1,91090024,91090025,93305264,AC,A,1
NC_037328.1,NC_032650.1,91146548,91146549,93361779,CA,C,1
NC_037328.1,NC_032650.1,91317155,91317156,93534659,TA,T,1
NC_037328.1,NC_032650.1,91385949,91385950,93603487,TA,T,1
NC_037328.1,NC_032650.1,91385954,91385955,93603491,AT,A,1
NC_037328.1,NC_032650.1,91401475,91401477,93618528,AGT,A,2
NC_037328.1,NC_032650.1,91441240,91441241,93658307,CG,C,1
NC_037328.1,NC_032650.1,91476208,91476209,93693290,AG,A,1
NC_037328.1,NC_032650.1,91489729,91489730,93706903,GT,G,1
NC_037328.1,NC_032650.1,91539894,91539895,93757794,AG,A,1
NC_037328.1,NC_032650.1,91539913,91539914,93757812,TC,T,1
NC_037328.1,NC_032650.1,91733510,91733512,93939310,ACC,A,2
NC_037328.1,NC_032650.1,91775275,91775276,93984528,TG,T,1
NC_037328.1,NC_032650.1,91858232,91858233,94068615,AT,A,1
NC_037328.1,NC_032650.1,91869724,91869725,94080096,CG,C,1
NC_037328.1,NC_032650.1,91869852,91869854,94080223,TAA,T,2
NC_037328.1,NC_032650.1,91993274,91993275,94198045,GA,G,1
NC_037328.1,NC_032650.1,92130074,92130076,94337969,AAT,A,2
NC_037328.1,NC_032650.1,92833134,92833138,95013040,CGGTG,C,4
NC_037328.1,NC_032650.1,93132526,93132527,95312389,AG,A,1
NC_037328.1,NC_032650.1,93520137,93520138,95700004,CA,C,1
NC_037328.1,NC_032650.1,94100481,94100486,96217647,CCTGTA,C,5
NC_037328.1,NC_032650.1,94101957,94101958,96219154,AG,A,1
NC_037328.1,NC_032650.1,94298919,94298920,96422501,TC,T,1
NC_037328.1,NC_032650.1,94432751,94432752,96571539,AG,A,1
NC_037328.1,NC_032650.1,94502428,94502429,96640402,GT,G,1
NC_037328.1,NC_032650.1,94502435,94502436,96640408,AT,A,1
NC_037328.1,NC_032650.1,94754365,94754366,96893419,TA,T,1
NC_037328.1,NC_032650.1,95381223,95381227,97519630,CAACT,C,4
NC_037328.1,NC_032650.1,95448635,95448636,97586837,TA,T,1
NC_037328.1,NC_032650.1,95604504,95604505,97742869,TG,T,1
NC_037328.1,NC_032650.1,96177056,96177057,98448309,CT,C,1
NC_037328.1,NC_032650.1,96615229,96615230,98892075,AG,A,1
NC_037328.1,NC_032650.1,97149423,97149424,99511180,AG,A,1
NC_037328.1,NC_032650.1,97249404,97249405,99615736,GA,G,1
NC_037328.1,NC_032650.1,97819218,97819219,100225149,AG,A,1
NC_037328.1,NC_032650.1,97840667,97840670,100246453,CTGA,C,3
NC_037328.1,NC_032650.1,97979782,97979783,100386774,TA,T,1
NC_037328.1,NC_032650.1,98048540,98048541,100426250,GT,G,1
NC_037328.1,NC_032650.1,98048618,98048619,100426325,AC,A,1
NC_037328.1,NC_032650.1,98119704,98119705,100498903,AT,A,1
NC_037328.1,NC_032650.1,98119736,98119737,100498933,AT,A,1
NC_037328.1,NC_032650.1,98368946,98368947,100748106,GT,G,1
NC_037328.1,NC_032650.1,98380399,98380400,100759570,GT,G,1
NC_037328.1,NC_032650.1,98633839,98633840,101012469,AT,A,1
NC_037328.1,NC_032650.1,98633856,98633857,101012485,CT,C,1
NC_037328.1,NC_032650.1,98633862,98633864,101012490,TTC,T,2
NC_037328.1,NC_032650.1,98633868,98633869,101012494,CA,C,1
NC_037328.1,NC_032650.1,98633886,98633887,101012511,AC,A,1
NC_037328.1,NC_032650.1,98723134,98723135,101108099,CA,C,1
NC_037328.1,NC_032650.1,98723144,98723145,101108108,CA,C,1
NC_037328.1,NC_032650.1,99168719,99168721,101553843,TGA,T,2
NC_037328.1,NC_032650.1,99221019,99221020,101603690,CA,C,1
NC_037328.1,NC_032650.1,99223488,99223489,101606156,GT,G,1
NC_037328.1,NC_032650.1,99224970,99224972,101607637,GGA,G,2
NC_037328.1,NC_032650.1,99324455,99324456,101706653,AG,A,1
NC_037328.1,NC_032650.1,99360669,99360670,101742928,TA,T,1
NC_037328.1,NC_032650.1,99434545,99434546,101816845,CA,C,1
NC_037328.1,NC_032650.1,99437109,99437110,101819408,TA,T,1
NC_037328.1,NC_032650.1,99572449,99572450,102032367,TC,T,1
NC_037328.1,NC_032650.1,99605992,99605993,102065923,TC,T,1
NC_037328.1,NC_032650.1,99664909,99664910,102124832,GC,G,1
NC_037328.1,NC_032650.1,99768588,99768594,102227058,TCTCATC,T,6
NC_037328.1,NC_032650.1,99866322,99866324,102302823,CTT,C,2
NC_037328.1,NC_032650.1,100167759,100167767,102676848,GACTCATTT,G,8
NC_037328.1,NC_032650.1,100286180,100286181,102795772,GT,G,1
NC_037328.1,NC_032650.1,100331200,100331204,102840798,TCTAA,T,4
NC_037328.1,NC_032650.1,100650213,100650215,103167573,CCA,C,2
NC_037328.1,NC_032650.1,100650219,100650220,103167577,CT,C,1
NC_037328.1,NC_032650.1,100650234,100650235,103167591,AT,A,1
NC_037328.1,NC_032650.1,100884955,100884956,103400458,AT,A,1
NC_037328.1,NC_032650.1,100981449,100981450,103491520,AT,A,1
NC_037328.1,NC_032650.1,101006880,101006881,103516952,CT,C,1
NC_037328.1,NC_032650.1,101102714,101102715,103613050,AC,A,1
NC_037328.1,NC_032650.1,101136098,101136099,103646427,AC,A,1
NC_037328.1,NC_032650.1,101538582,101538583,104051256,TA,T,1
NC_037328.1,NC_032650.1,101538596,101538612,104051269,GATGTGTCCAGTGTTAA,G,16
NC_037328.1,NC_032650.1,101746007,101746008,104277385,AT,A,1
NC_037328.1,NC_032650.1,101869408,101869409,104400562,CT,C,1
NC_037328.1,NC_032650.1,102027867,102027868,104563070,TG,T,1
NC_037328.1,NC_032650.1,102027937,102027939,104563139,AAC,A,2
NC_037328.1,NC_032650.1,102035301,102035302,104570472,AC,A,1
NC_037328.1,NC_032650.1,102086976,102086977,104621957,GT,G,1
NC_037328.1,NC_032650.1,102150279,102150280,104685170,CA,C,1
NC_037328.1,NC_032650.1,102167475,102167476,104702269,CA,C,1
NC_037328.1,NC_032650.1,102478191,102478195,105020017,ATCAT,A,4
NC_037328.1,NC_032650.1,102641696,102641697,105183044,CA,C,1
NC_037328.1,NC_032650.1,102688608,102688610,105452258,AAC,A,2
NC_037328.1,NC_032650.1,102875809,102875810,105539254,AG,A,1
NC_037328.1,NC_032650.1,102967085,102967086,105658541,CA,C,1
NC_037328.1,NC_032650.1,102967124,102967126,105658579,TTG,T,2
NC_037328.1,NC_032650.1,103009423,103009424,105700958,TC,T,1
NC_037328.1,NC_032650.1,103041919,103041920,105733606,TC,T,1
NC_037328.1,NC_032650.1,103114410,103114411,105806070,TA,T,1
NC_037328.1,NC_032650.1,103114419,103114420,105806078,TG,T,1
NC_037328.1,NC_032650.1,103154802,103154803,105846459,GT,G,1
NC_037328.1,NC_032650.1,103380744,103380745,105915925,AC,A,1
NC_037328.1,NC_032650.1,104675491,104675492,106508947,AG,A,1
NC_037328.1,NC_032650.1,105052977,105052978,106826761,TA,T,1
NC_037328.1,NC_032650.1,105585768,105585769,107466169,TC,T,1
NC_037328.1,NC_032650.1,105585787,105585788,107466187,AT,A,1
NC_037328.1,NC_032650.1,105594121,105594122,107474520,AC,A,1
NC_037328.1,NC_032650.1,105847693,105847699,107728027,GACATGA,G,6
NC_037328.1,NC_032650.1,105847701,105847705,107728029,ATGAC,A,4
NC_037328.1,NC_032650.1,105873365,105873366,107753742,TC,T,1
NC_037328.1,NC_032650.1,105873372,105873373,107753748,GA,G,1
NC_037328.1,NC_032650.1,105888910,105888911,107769307,AT,A,1
NC_037328.1,NC_032650.1,105997458,105997459,107877639,AT,A,1
NC_037328.1,NC_032650.1,106045346,106045347,107926983,TA,T,1
NC_037328.1,NC_032650.1,106300571,106300572,108192038,TA,T,1
NC_037328.1,NC_032650.1,106316939,106316940,108208418,TC,T,1
NC_037328.1,NC_032650.1,106338054,106338057,108229540,CCCA,C,3
NC_037328.1,NC_032650.1,106363461,106363462,108254948,AG,A,1
NC_037328.1,NC_032650.1,106367589,106367590,108259078,TA,T,1
NC_037328.1,NC_032650.1,106370114,106370115,108262214,TC,T,1
NC_037328.1,NC_032650.1,106386544,106386545,108278651,AG,A,1
NC_037328.1,NC_032650.1,106391520,106391521,108283632,TC,T,1
NC_037328.1,NC_032650.1,106687876,106687877,108497133,TA,T,1
NC_037328.1,NC_032650.1,106722503,106722506,108531846,AACT,A,3
NC_037328.1,NC_032650.1,106851781,106851785,108677647,GGAAA,G,4
NC_037328.1,NC_032650.1,107221887,107221888,109029975,CA,C,1
NC_037328.1,NC_032650.1,107221898,107221900,109029985,AAG,A,2
NC_037328.1,NC_032650.1,107329352,107329353,109137496,AT,A,1
NC_037328.1,NC_032650.1,107561166,107561167,109368666,AG,A,1
NC_037328.1,NC_032650.1,107622158,107622159,109432768,AG,A,1
NC_037328.1,NC_032650.1,107625844,107625845,109436453,GC,G,1
NC_037328.1,NC_032650.1,107632804,107632805,109443047,AG,A,1
NC_037328.1,NC_032650.1,107642775,107642776,109453032,CA,C,1
NC_037328.1,NC_032650.1,107724762,107724763,109534988,GT,G,1
NC_037328.1,NC_032650.1,108090801,108090802,109903911,TA,T,1
NC_037328.1,NC_032650.1,108106001,108106002,109919108,CG,C,1
NC_037328.1,NC_032650.1,108118287,108118288,109931546,GA,G,1
NC_037328.1,NC_032650.1,108129377,108129393,109942754,GCTGTTCAGACTTAAAT,G,16
NC_037328.1,NC_032650.1,108134755,108134756,109948113,GA,G,1
NC_037328.1,NC_032650.1,108134840,108134841,109948193,TA,T,1
NC_037328.1,NC_032650.1,108134845,108134846,109948197,TC,T,1
NC_037328.1,NC_032650.1,108136359,108136360,109950172,AG,A,1
NC_037328.1,NC_032650.1,108367421,108367423,110238125,CAA,C,2
NC_037328.1,NC_032650.1,108370431,108370432,110241138,AT,A,1
NC_037328.1,NC_032650.1,108391155,108391156,110261892,AT,A,1
NC_037328.1,NC_032650.1,108415032,108415033,110285773,CG,C,1
NC_037328.1,NC_032650.1,108607500,108607501,110478143,TA,T,1
NC_037328.1,NC_032650.1,108839054,108839055,110714942,CA,C,1
NC_037328.1,NC_032650.1,109025705,109025706,110905944,CA,C,1
NC_037328.1,NC_032650.1,109139616,109139617,111043195,GC,G,1
NC_037328.1,NC_032650.1,109234528,109234529,111138057,CT,C,1
NC_037328.1,NC_032650.1,109502943,109502945,111439646,TTG,T,2
NC_037328.1,NC_032650.1,109503080,109503081,111439781,AG,A,1
NC_037328.1,NC_032650.1,109604008,109604009,111541650,AT,A,1
NC_037328.1,NC_032650.1,109673016,109673017,111608745,TA,T,1
NC_037328.1,NC_032650.1,109688561,109688562,111624290,TA,T,1
NC_037328.1,NC_032650.1,109692698,109692705,111628427,ATGTTTTC,A,7
NC_037328.1,NC_032650.1,109897901,109897905,111899687,GCAAA,G,4
NC_037328.1,NC_032650.1,109900974,109900975,111902761,AG,A,1
NC_037328.1,NC_032650.1,109992303,109992305,111993854,TTC,T,2
NC_037328.1,NC_032650.1,110340290,110340291,112181737,CA,C,1
NC_037328.1,NC_032650.1,110341578,110341579,112183029,AG,A,1
NC_037328.1,NC_032650.1,110389438,110389439,112544576,CA,C,1
NC_037328.1,NC_032650.1,110686645,110686646,112882672,CT,C,1
NC_037328.1,NC_032650.1,110753758,110753759,112949465,AT,A,1
NC_037328.1,NC_032650.1,110918275,110918276,113117171,TG,T,1
NC_037328.1,NC_032650.1,110918282,110918283,113117177,AT,A,1
NC_037328.1,NC_032650.1,111057748,111057754,113249596,ACTTGAT,A,6
NC_037328.1,NC_032650.1,111105810,111105811,113298207,TC,T,1
NC_037328.1,NC_032650.1,111340877,111340878,113540046,CT,C,1
NC_037328.1,NC_032650.1,111755163,111755164,114098670,AT,A,1
NC_037328.1,NC_032650.1,111760111,111760113,114103623,ACT,A,2
NC_037328.1,NC_032650.1,111878874,111878876,114221775,TAA,T,2
NC_037328.1,NC_032650.1,111977526,111977527,114319967,AT,A,1
NC_037328.1,NC_032650.1,111977568,111977569,114320007,CT,C,1
NC_037328.1,NC_032650.1,111977587,111977588,114320025,CT,C,1
NC_037328.1,NC_032650.1,111980258,111980263,114322695,GTGCAA,G,5
NC_037328.1,NC_032650.1,112002526,112002531,114346578,GACAAA,G,5
NC_037328.1,NC_032650.1,112088351,112088353,114432752,TTA,T,2
NC_037328.1,NC_032650.1,112157271,112157272,114501670,AT,A,1
NC_037328.1,NC_032650.1,112802089,112802090,115188718,AC,A,1
NC_037328.1,NC_032650.1,113429050,113429052,115820192,CAA,C,2
NC_037328.1,NC_032650.1,113430072,113430073,115821212,TA,T,1
NC_037328.1,NC_032650.1,113435269,113435271,115826428,CAG,C,2
NC_037328.1,NC_032650.1,113443249,113443250,115834409,AT,A,1
NC_037328.1,NC_032650.1,113468560,113468561,115860527,CT,C,1
NC_037328.1,NC_032650.1,113498785,113498790,115890760,TCTTTG,T,5
NC_037328.1,NC_032650.1,113499139,113499140,115891109,AG,A,1
NC_037328.1,NC_032650.1,113502768,113502769,115894737,TC,T,1
NC_037328.1,NC_032650.1,113673577,113673585,116142615,AACTTTGGT,A,8
NC_037328.1,NC_032650.1,113673673,113673674,116142703,AT,A,1
NC_037328.1,NC_032650.1,113732236,113732237,116200794,GC,G,1
NC_037328.1,NC_032650.1,113820672,113820673,116466411,TG,T,1
NC_037328.1,NC_032650.1,113900676,113900677,116401913,TA,T,1
NC_037328.1,NC_032650.1,114200360,114200361,116773184,AC,A,1
NC_037328.1,NC_032650.1,114627512,114627514,117080405,CTT,C,2
NC_037328.1,NC_032650.1,114631670,114631687,117084576,AATGAACTTTTGGGGGAC,A,17
NC_037328.1,NC_032650.1,114632309,114632310,117085173,CT,C,1
NC_037328.1,NC_032650.1,114632353,114632354,117085216,TG,T,1
NC_037328.1,NC_032650.1,115401496,115401497,117100449,CG,C,1
NC_037328.1,NC_032650.1,115437686,115437688,117137032,GAA,G,2
NC_037328.1,NC_032650.1,115438038,115438039,117137380,GT,G,1
NC_037328.1,NC_032650.1,115439981,115439984,117139322,TTAG,T,3
NC_037328.1,NC_032650.1,115554634,115554635,117256295,CA,C,1
NC_037328.1,NC_032650.1,115813643,115813644,117668210,GT,G,1
NC_037328.1,NC_032650.1,115817772,115817773,117671469,TC,T,1
NC_037328.1,NC_032650.1,116648017,116648018,118195424,GA,G,1
NC_037328.1,NC_032650.1,116684217,116684219,118231629,GAA,G,2
NC_037328.1,NC_032650.1,116691239,116691241,118238654,CAA,C,2
NC_037328.1,NC_032650.1,116760325,116760326,118307533,GA,G,1
NC_037328.1,NC_032650.1,116760333,116760334,118307540,TA,T,1
NC_037328.1,NC_032650.1,116781734,116781735,118329106,GT,G,1
NC_037328.1,NC_032650.1,116781744,116781745,118329115,GA,G,1
NC_037328.1,NC_032650.1,116781750,116781751,118329120,AT,A,1
NC_037328.1,NC_032650.1,116809704,116809706,118357169,CCA,C,2
NC_037328.1,NC_032650.1,116809732,116809733,118357194,GA,G,1
NC_037328.1,NC_032650.1,116813171,116813172,118360462,CA,C,1
NC_037328.1,NC_032650.1,116848508,116848509,118396397,AC,A,1
NC_037328.1,NC_032650.1,116860894,116860895,118408781,TC,T,1
NC_037328.1,NC_032650.1,117180530,117180531,118780304,CG,C,1
NC_037328.1,NC_032650.1,117243219,117243228,118846739,CTCCCTGTCT,C,9
NC_037328.1,NC_032650.1,117649112,117649113,119415788,CA,C,1
NC_037328.1,NC_032650.1,117695041,117695043,119461441,AAG,A,2
NC_037328.1,NC_032650.1,117761991,117761992,119528226,GA,G,1
NC_037328.1,NC_032650.1,117967879,117967898,119734173,ATCTCCAAGGTCTAACATTC,A,19
NC_037328.1,NC_032650.1,118244229,118244230,120028523,TC,T,1
NC_037328.1,NC_032650.1,118283951,118283953,120101603,AGT,A,2
NC_037328.1,NC_032650.1,118348370,118348371,120166552,CA,C,1
NC_037328.1,NC_032650.1,118401939,118401940,120231497,TG,T,1
NC_037328.1,NC_032650.1,118422041,118422062,120328508,CTTTCTTAGGCACTTGGAACAA,C,21
NC_037328.1,NC_032650.1,118472567,118472569,120379211,GAC,G,2
NC_037328.1,NC_032650.1,118902155,118902156,120815657,CA,C,1
NC_037328.1,NC_032650.1,118974605,118974607,120888088,CAT,C,2
NC_037328.1,NC_032650.1,118978704,118978705,120892186,CT,C,1
NC_037328.1,NC_032650.1,118985574,118985577,120899064,CATT,C,3
NC_037328.1,NC_032650.1,119228037,119228038,121145706,AT,A,1
NC_037328.1,NC_032650.1,119453872,119453915,121385393,GAAATTTCTTTAGGAATTCAGCATCAAGAAGACTCTGCTCCATT,G,43
NC_037328.1,NC_032650.1,119546548,119546555,121481380,TGAACTTC,T,7
NC_037328.1,NC_032650.1,119552184,119552185,121491345,TC,T,1
NC_037328.1,NC_032650.1,119562206,119562207,121501368,TA,T,1
NC_037328.1,NC_032650.1,119942005,119942006,121908511,GC,G,1
NC_037328.1,NC_032650.1,120090539,120090540,122047955,GC,G,1
NC_037328.1,NC_032650.1,120478550,120478551,122511038,TG,T,1
NC_037328.1,NC_032650.1,120564739,120564744,122712846,ATAATT,A,5
NC_037328.1,NC_032650.1,120769281,120769282,122927771,CA,C,1
NC_037328.1,NC_032650.1,120892539,120892540,123049739,GA,G,1
NC_037328.1,NC_032650.1,120892557,120892558,123049756,GA,G,1
NC_037328.1,NC_032650.1,120892567,120892568,123049765,GA,G,1
NC_037328.1,NC_032650.1,120892584,120892585,123049781,AG,A,1
NC_037328.1,NC_032650.1,120898130,120898131,123053058,CG,C,1
NC_037328.1,NC_032650.1,120898343,120898344,123053269,CG,C,1
NC_037328.1,NC_032650.1,120901898,120901899,123056823,CA,C,1
NC_037328.1,NC_032650.1,120950723,120950727,123105256,CTGCT,C,4
NC_037328.1,NC_032650.1,121283492,121283493,123467794,CA,C,1
NC_037328.1,NC_032650.1,121283511,121283512,123467812,CT,C,1
NC_037328.1,NC_032650.1,121285180,121285181,123469478,TA,T,1
NC_037328.1,NC_032650.1,121354368,121354369,123539969,AG,A,1
NC_037328.1,NC_032650.1,121354384,121354385,123539984,TG,T,1
NC_037328.1,NC_032650.1,121501387,121501388,123687582,GC,G,1
NC_037328.1,NC_032650.1,121571616,121571617,123757833,CT,C,1
NC_037328.1,NC_032650.1,121927533,121927534,124174100,CA,C,1
NC_037328.1,NC_032650.1,121927559,121927560,124174125,CA,C,1
NC_037328.1,NC_032650.1,122013205,122013206,124256097,CA,C,1
NC_037328.1,NC_032650.1,122013212,122013213,124256103,TA,T,1
NC_037328.1,NC_032650.1,122014426,122014428,124257316,CTT,C,2
NC_037328.1,NC_032650.1,122356254,122356255,124620765,AC,A,1
NC_037328.1,NC_032650.1,122544569,122544570,124872854,CA,C,1
NC_037328.1,NC_032650.1,122779784,122779785,125065772,TA,T,1
NC_037328.1,NC_032650.1,122860701,122860702,125146615,GA,G,1
NC_037328.1,NC_032650.1,122873915,122873917,125159840,AAT,A,2
NC_037328.1,NC_032650.1,122873939,122873941,125159862,TTC,T,2
NC_037328.1,NC_032650.1,122873949,122873950,125159870,CA,C,1
NC_037328.1,NC_032650.1,122873972,122873973,125159892,AG,A,1
NC_037328.1,NC_032650.1,122874987,122874989,125160908,TTA,T,2
NC_037328.1,NC_032650.1,122875022,122875023,125160940,TG,T,1
NC_037328.1,NC_032650.1,123010121,123010130,125295896,TTTGGCAAAC,T,9
NC_037328.1,NC_032650.1,123013355,123013356,125299150,TA,T,1
NC_037328.1,NC_032650.1,123014395,123014397,125300196,AAT,A,2
NC_037328.1,NC_032650.1,123058235,123058236,125345047,CA,C,1
NC_037328.1,NC_032650.1,123108383,123108384,125398440,AG,A,1
NC_037328.1,NC_032650.1,123131773,123131774,125421843,TG,T,1
NC_037328.1,NC_032650.1,123150036,123150037,125471526,CT,C,1
NC_037328.1,NC_032650.1,123181051,123181052,125502065,GA,G,1
NC_037328.1,NC_032650.1,123187130,123187132,125508145,ATT,A,2
NC_037328.1,NC_032650.1,123206494,123206495,125527513,TA,T,1
NC_037328.1,NC_032650.1,123349011,123349012,125674882,TC,T,1
NC_037328.1,NC_032650.1,123564138,123564140,125892890,TTA,T,2
NC_037328.1,NC_032650.1,123755304,123755306,126080474,GGC,G,2
NC_037328.1,NC_032650.1,123872962,123872964,126207681,CAA,C,2
NC_037328.1,NC_032650.1,123966565,123966566,126215902,GA,G,1
NC_037328.1,NC_032650.1,124271828,124271829,126390639,GA,G,1
NC_037328.1,NC_032650.1,124288776,124288783,126407591,TGGTATAA,T,7
NC_037328.1,NC_032650.1,124423156,124423157,126561140,TC,T,1
NC_037328.1,NC_032650.1,125121543,125121544,127125467,GA,G,1
NC_037328.1,NC_032650.1,125124464,125124468,127128389,CTTAG,C,4
NC_037328.1,NC_032650.1,125348135,125348137,127391823,TTG,T,2
NC_037328.1,NC_032650.1,125420237,125420238,127463939,CA,C,1
NC_037328.1,NC_032650.1,125538695,125538696,127579525,CT,C,1
NC_037328.1,NC_032650.1,125583672,125583673,127668626,TC,T,1
NC_037328.1,NC_032650.1,125650472,125650473,127735405,GC,G,1
NC_037328.1,NC_032650.1,125663810,125663816,127753096,CTGCAGT,C,6
NC_037328.1,NC_032650.1,126321953,126321955,128420338,TTC,T,2
NC_037328.1,NC_032650.1,126418846,126418847,128519815,CG,C,1
NC_037328.1,NC_032650.1,126542845,126542846,128643826,CA,C,1
NC_037328.1,NC_032650.1,126957816,126957817,129076049,GC,G,1
NC_037328.1,NC_032650.1,127097697,127097698,129218751,TC,T,1
NC_037328.1,NC_032650.1,127108025,127108026,129229103,GT,G,1
NC_037328.1,NC_032650.1,127160424,127160425,129281389,AG,A,1
NC_037328.1,NC_032650.1,127444130,127444131,129617669,TG,T,1
NC_037328.1,NC_032650.1,127482655,127482656,129656182,AG,A,1
NC_037328.1,NC_032650.1,127483478,127483479,129657004,GA,G,1
NC_037328.1,NC_032650.1,127496497,127496498,129670035,TA,T,1
NC_037328.1,NC_032650.1,127512840,127512841,129690257,GT,G,1
NC_037328.1,NC_032650.1,127663431,127663433,129840739,ATC,A,2
NC_037328.1,NC_032650.1,127888950,127888954,130066122,GGGCC,G,4
NC_037328.1,NC_032650.1,127908838,127908839,130086018,TA,T,1
NC_037328.1,NC_032650.1,128096196,128096197,130273392,GC,G,1
NC_037328.1,NC_032650.1,128140941,128140942,130318512,GC,G,1
NC_037328.1,NC_032650.1,128156095,128156100,130333694,ACTGCC,A,5
NC_037328.1,NC_032650.1,128255125,128255126,130453084,CA,C,1
NC_037328.1,NC_032650.1,128257255,128257256,130455232,AG,A,1
NC_037328.1,NC_032650.1,128267925,128267926,130465787,TG,T,1
NC_037328.1,NC_032650.1,128269423,128269425,130467284,TTC,T,2
NC_037328.1,NC_032650.1,128308314,128308315,130510135,AG,A,1
NC_037328.1,NC_032650.1,128327258,128327259,130527436,TG,T,1
NC_037328.1,NC_032650.1,128329250,128329251,130529435,AG,A,1
NC_037328.1,NC_032650.1,128363000,128363057,130562867,GCTTCACATCCCACCATGGTTACTTGCATGGCTTCAGATGGCCTCAGCTCCCTGGTAC,G,57
NC_037328.1,NC_032650.1,128629681,128629682,130823168,AC,A,1
NC_037328.1,NC_032650.1,128632419,128632420,130825905,AG,A,1
NC_037328.1,NC_032650.1,128645284,128645285,130838769,TA,T,1
NC_037328.1,NC_032650.1,128676850,128676851,130870299,GC,G,1
NC_037328.1,NC_032650.1,128679118,128679119,130872565,AC,A,1
NC_037328.1,NC_032650.1,128710082,128710083,130903520,AT,A,1
NC_037328.1,NC_032650.1,128725262,128725263,130918698,AC,A,1
NC_037328.1,NC_032650.1,128746556,128746557,130940006,GC,G,1
NC_037328.1,NC_032650.1,128765625,128765626,130959074,AC,A,1
NC_037328.1,NC_032650.1,128771259,128771260,130964707,CG,C,1
NC_037328.1,NC_032650.1,128771266,128771269,130964713,CATG,C,3
NC_037328.1,NC_032650.1,128886038,128886039,131141835,CA,C,1
NC_037328.1,NC_032650.1,128892443,128892444,131148238,CG,C,1
NC_037328.1,NC_032650.1,128941806,128941814,131197607,GCTTTTACA,G,8
NC_037328.1,NC_032650.1,129249635,129249636,131506886,TG,T,1
NC_037328.1,NC_032650.1,129279955,129279956,131537248,TA,T,1
NC_037328.1,NC_032650.1,129514540,129514541,131796516,AC,A,1
NC_037328.1,NC_032650.1,129520406,129520407,131801989,AG,A,1
NC_037328.1,NC_032650.1,130275305,130275306,132178728,AT,A,1
NC_037328.1,NC_032650.1,130278948,130278949,132182372,TG,T,1
NC_037328.1,NC_032650.1,130650305,130650309,132614667,TCAAG,T,4
NC_037328.1,NC_032650.1,130660101,130660102,132624488,TC,T,1
NC_037328.1,NC_032650.1,130792936,130792937,132797116,TG,T,1
NC_037328.1,NC_032650.1,130981147,130981149,132989623,CAA,C,2
NC_037328.1,NC_032650.1,131244537,131244538,133293018,CG,C,1
NC_037328.1,NC_032650.1,131245279,131245280,133293759,AT,A,1
NC_037328.1,NC_032650.1,131257774,131257775,133306248,AT,A,1
NC_037328.1,NC_032650.1,131260545,131260546,133309355,CA,C,1
NC_037328.1,NC_032650.1,131573069,131573070,133622767,TC,T,1
NC_037328.1,NC_032650.1,132065852,132065853,134111568,GC,G,1
NC_037328.1,NC_032650.1,132131429,132131430,134195861,CA,C,1
NC_037328.1,NC_032650.1,132131440,132131441,134195871,AC,A,1
NC_037328.1,NC_032650.1,132131482,132131483,134195911,AT,A,1
NC_037328.1,NC_032650.1,132177480,132177481,134241869,TG,T,1
NC_037328.1,NC_032650.1,132181209,132181210,134245599,CG,C,1
NC_037328.1,NC_032650.1,132243920,132243921,134307925,GA,G,1
NC_037328.1,NC_032650.1,132454988,132454990,134518384,TTG,T,2
NC_037328.1,NC_032650.1,133308179,133308180,135539120,CT,C,1
NC_037328.1,NC_032650.1,133442685,133442687,135445740,AAT,A,2
NC_037328.1,NC_032650.1,133442717,133442718,135445769,TC,T,1
NC_037328.1,NC_032650.1,133595481,133595482,135887893,CA,C,1
NC_037328.1,NC_032650.1,133595529,133595530,135887939,CG,C,1
NC_037328.1,NC_032650.1,133596316,133596317,135888723,AC,A,1
NC_037328.1,NC_032650.1,133911005,133911006,136193619,AT,A,1
NC_037328.1,NC_032650.1,133924958,133924959,136205411,AG,A,1
NC_037328.1,NC_032650.1,133932734,133932735,136213187,AC,A,1
NC_037328.1,NC_032650.1,133941471,133941472,136221540,TG,T,1
NC_037328.1,NC_032650.1,133945689,133945690,136225759,AT,A,1
NC_037328.1,NC_032650.1,134420322,134420323,136744700,CA,C,1
NC_037328.1,NC_032650.1,134549241,134549242,136872931,AG,A,1
NC_037328.1,NC_032650.1,134688755,134688756,137013370,TC,T,1
NC_037328.1,NC_032650.1,134803544,134803545,137131449,TG,T,1
NC_037328.1,NC_032650.1,134861956,134861958,137189751,CCT,C,2
NC_037328.1,NC_032650.1,134862042,134862043,137189834,TG,T,1
NC_037328.1,NC_032650.1,135141700,135141701,137463845,AC,A,1
NC_037328.1,NC_032650.1,135307866,135307867,137680063,GC,G,1
NC_037328.1,NC_032650.1,135335336,135335337,137708165,CG,C,1
NC_037328.1,NC_032650.1,135380196,135380197,137753138,GT,G,1
NC_037328.1,NC_032650.1,135658577,135658584,137940881,AGGTTGAC,A,7
NC_037328.1,NC_032650.1,135669251,135669252,137951550,GA,G,1
NC_037328.1,NC_032650.1,135670176,135670177,137952474,GT,G,1
NC_037328.1,NC_032650.1,135878218,135878222,138000821,ACCCC,A,4
NC_037328.1,NC_032650.1,135933089,135933090,138055493,AG,A,1
NC_037328.1,NC_032650.1,135937440,135937441,138059843,AG,A,1
NC_037328.1,NC_032650.1,135950544,135950545,138084509,TA,T,1
NC_037328.1,NC_032650.1,136053007,136053009,138186677,AAC,A,2
NC_037328.1,NC_032650.1,136081632,136081633,138214700,GT,G,1
NC_037328.1,NC_032650.1,136088240,136088244,138221314,TGATA,T,4
NC_037328.1,NC_032650.1,136435493,136435494,138619801,AT,A,1
NC_037328.1,NC_032650.1,137056388,137056391,139228736,TTTA,T,3
NC_037328.1,NC_032650.1,137332982,137332983,139505983,TA,T,1
NC_037328.1,NC_032650.1,137347446,137347447,139520256,TA,T,1
NC_037328.1,NC_032650.1,137490693,137490694,139664754,TA,T,1
NC_037328.1,NC_032650.1,137508450,137508486,139682541,CATCAAAATCTCATTCTTCCAACGAGCAAAGATGCAG,C,36
NC_037328.1,NC_032650.1,137508641,137508642,139682695,GT,G,1
NC_037328.1,NC_032650.1,137856128,137856129,140021453,TC,T,1
NC_037328.1,NC_032650.1,137917466,137917467,140082298,AT,A,1
NC_037328.1,NC_032650.1,137977638,137977639,140141286,AC,A,1
NC_037328.1,NC_032650.1,137978706,137978707,140142354,GA,G,1
NC_037328.1,NC_032650.1,137990289,137990290,140153937,AG,A,1
NC_037328.1,NC_032650.1,138058217,138058218,140223983,TG,T,1
NC_037328.1,NC_032650.1,138240310,138240311,140406659,TC,T,1
NC_037328.1,NC_032650.1,138247247,138247248,140413592,AG,A,1
NC_037328.1,NC_032650.1,138277083,138277085,140443108,TAA,T,2
NC_037328.1,NC_032650.1,138639706,138639707,140831427,GA,G,1
NC_037328.1,NC_032650.1,138818643,138818644,141067053,CT,C,1
NC_037328.1,NC_032650.1,138905400,138905401,141154963,CT,C,1
NC_037328.1,NC_032650.1,138940863,138940864,141190073,AT,A,1
NC_037328.1,NC_032650.1,139031988,139031990,141283795,CAT,C,2
NC_037328.1,NC_032650.1,139085910,139085912,141337787,TTA,T,2
NC_037328.1,NC_032650.1,139085958,139085960,141337833,CCT,C,2
NC_037328.1,NC_032650.1,139085962,139085963,141337835,CT,C,1
NC_037328.1,NC_032650.1,140264750,140264751,142693470,TA,T,1
NC_037328.1,NC_032650.1,140278759,140278768,142707450,ACCATGCTGG,A,9
NC_037328.1,NC_032650.1,140279295,140279296,142707978,CT,C,1
NC_037328.1,NC_032650.1,140284422,140284423,142713106,TC,T,1
NC_037328.1,NC_032650.1,140317863,140317864,142746410,AG,A,1
NC_037328.1,NC_032650.1,140335343,140335344,142763889,AT,A,1
NC_037328.1,NC_032650.1,140384851,140384852,142818496,AC,A,1
NC_037328.1,NC_032650.1,140392304,140392305,142825927,TG,T,1
NC_037328.1,NC_032650.1,140499110,140499111,142954917,TG,T,1
NC_037328.1,NC_032650.1,140500241,140500244,142956047,AGCT,A,3
NC_037328.1,NC_032650.1,140514171,140514173,142970024,TGC,T,2
NC_037328.1,NC_032650.1,140633769,140633770,143334586,CG,C,1
NC_037328.1,NC_032650.1,140655205,140655206,143356036,CT,C,1
NC_037328.1,NC_032650.1,140689089,140689090,143398776,AT,A,1
NC_037328.1,NC_032650.1,140689099,140689100,143398785,CA,C,1
NC_037328.1,NC_032650.1,140794293,140794294,143539976,GC,G,1
NC_037328.1,NC_032650.1,140820585,140820586,143567263,TC,T,1
NC_037328.1,NC_032650.1,140847318,140847319,143594003,AT,A,1
NC_037328.1,NC_032650.1,140944376,140944395,143709927,TGTTTTTAGGAGTAGGGGAG,T,19
NC_037328.1,NC_032650.1,140944756,140944757,143710288,CA,C,1
NC_037328.1,NC_032650.1,140946420,140946422,143711956,AGG,A,2
NC_037328.1,NC_032650.1,140946770,140946771,143712304,TG,T,1
NC_037328.1,NC_032650.1,140956917,140956918,143722478,GA,G,1
NC_037328.1,NC_032650.1,140956924,140956925,143722484,TG,T,1
NC_037328.1,NC_032650.1,140956934,140956935,143722493,GT,G,1
NC_037328.1,NC_032650.1,140956980,140956981,143722537,AC,A,1
NC_037328.1,NC_032650.1,140957002,140957003,143722557,GC,G,1
NC_037328.1,NC_032650.1,140972723,140972724,143738333,TA,T,1
NC_037328.1,NC_032650.1,140976180,140976207,143741837,CTCCAAATTTATAGTACTGACCTCCGTT,C,27
NC_037328.1,NC_032650.1,141040748,141040749,143806183,CG,C,1
NC_037328.1,NC_032650.1,141043045,141043046,143808481,CT,C,1
NC_037328.1,NC_032650.1,141386682,141386683,144154780,TA,T,1
NC_037328.1,NC_032650.1,141389501,141389502,144157597,AG,A,1
NC_037328.1,NC_032650.1,141465119,141465120,144232984,TC,T,1
NC_037328.1,NC_032650.1,141494634,141494635,144262576,TA,T,1
NC_037328.1,NC_032650.1,141509472,141509474,144277470,CCT,C,2
NC_037328.1,NC_032650.1,141509504,141509505,144277500,TC,T,1
NC_037328.1,NC_032650.1,141509979,141509980,144277974,CT,C,1
NC_037328.1,NC_032650.1,141510317,141510318,144278311,AC,A,1
NC_037328.1,NC_032650.1,141856791,141856792,144625071,GC,G,1
NC_037328.1,NC_032650.1,142334737,142334738,145200068,CT,C,1
NC_037328.1,NC_032650.1,142401352,142401353,145267036,GC,G,1
NC_037328.1,NC_032650.1,142419816,142419817,145285504,CA,C,1
NC_037328.1,NC_032650.1,142473254,142473256,145338963,AAC,A,2
NC_037328.1,NC_032650.1,142569507,142569508,145435642,TC,T,1
NC_037328.1,NC_032650.1,142637489,142637490,145477639,CA,C,1
NC_037328.1,NC_032650.1,142762707,142762734,145687246,GTTGCCAAGCATATTGGTCTACTCAGAT,G,27
NC_037328.1,NC_032650.1,142766062,142766063,145690595,CT,C,1
NC_037328.1,NC_032650.1,142880900,142880901,145808071,AG,A,1
NC_037328.1,NC_032650.1,142971243,142971244,145898458,TA,T,1
NC_037328.1,NC_032650.1,142987430,142987432,145914678,AAG,A,2
NC_037328.1,NC_032650.1,142987487,142987489,145914731,AAG,A,2
NC_037328.1,NC_032650.1,142987497,142987499,145914739,CCA,C,2
NC_037328.1,NC_032650.1,142987508,142987509,145914748,AT,A,1
NC_037328.1,NC_032650.1,142987560,142987561,145914799,TC,T,1
NC_037328.1,NC_032650.1,142987573,142987574,145914811,CT,C,1
NC_037328.1,NC_032650.1,142987657,142987658,145914894,CG,C,1
NC_037328.1,NC_032650.1,143016076,143016077,145943313,GT,G,1
NC_037328.1,NC_032650.1,143126707,143126708,146016855,CG,C,1
NC_037328.1,NC_032650.1,143126717,143126718,146016864,TC,T,1
NC_037328.1,NC_032650.1,143223177,143223178,146162582,CA,C,1
NC_037328.1,NC_032650.1,143330151,143330153,146270589,TAG,T,2
NC_037328.1,NC_032650.1,143379967,143380030,146321441,ACCCCGGGGGTTCCAGAAGGCTTGCCTTGCCCCTCCTAGCCTGCAGAATCTTACCCATTACCAG,A,63
NC_037328.1,NC_032650.1,145161158,145161159,147971122,CA,C,1
NC_037328.1,NC_032650.1,145161168,145161169,147971131,CA,C,1
NC_037328.1,NC_032650.1,145161175,145161176,147971137,GT,G,1
NC_037328.1,NC_032650.1,145322470,145322472,148211818,CAA,C,2
NC_037328.1,NC_032650.1,145325141,145325142,148214487,CT,C,1
NC_037328.1,NC_032650.1,145352972,145352973,148239249,CT,C,1
NC_037328.1,NC_032650.1,145439307,145439311,148324784,CTCTT,C,4
NC_037328.1,NC_032650.1,145476005,145476006,148361942,CT,C,1
NC_037328.1,NC_032650.1,145592170,145592172,148478407,CGG,C,2
NC_037328.1,NC_032650.1,145593545,145593546,148479779,AC,A,1
NC_037328.1,NC_032650.1,145594738,145594739,148480971,CG,C,1
NC_037328.1,NC_032650.1,145595897,145595898,148482129,GT,G,1
NC_037328.1,NC_032650.1,145714564,145714565,148661571,CA,C,1
NC_037328.1,NC_032650.1,145714640,145714641,148661644,CA,C,1
NC_037328.1,NC_032650.1,145714650,145714651,148661653,TA,T,1
NC_037328.1,NC_032650.1,145714659,145714660,148661661,GA,G,1
NC_037328.1,NC_032650.1,145714667,145714668,148661668,TA,T,1
NC_037328.1,NC_032650.1,145716214,145716216,148663210,ATC,A,2
NC_037328.1,NC_032650.1,145735832,145735833,148682880,GT,G,1
NC_037328.1,NC_032650.1,145916299,145916300,148866635,GA,G,1
NC_037328.1,NC_032650.1,146157846,146157847,149127724,CT,C,1
NC_037328.1,NC_032650.1,146169196,146169197,149139071,TC,T,1
NC_037328.1,NC_032650.1,146365051,146365052,149342291,CT,C,1
NC_037328.1,NC_032650.1,146365326,146365330,149342565,CCCAT,C,4
NC_037328.1,NC_032650.1,146391970,146391971,149371509,TG,T,1
NC_037328.1,NC_032650.1,146395174,146395175,149374713,TC,T,1
NC_037328.1,NC_032650.1,146407098,146407100,149386640,CAT,C,2
NC_037328.1,NC_032650.1,146421703,146421704,149406485,AC,A,1
NC_037328.1,NC_032650.1,146878100,146878107,149882266,ATTTCGCT,A,7
NC_037328.1,NC_032650.1,146883243,146883245,149887277,TTG,T,2
NC_037328.1,NC_032650.1,147471359,147471360,150488028,TC,T,1
NC_037328.1,NC_032650.1,147667311,147667323,150684273,AGCAATCCTACAT,A,12
NC_037328.1,NC_032650.1,147667386,147667388,150684336,AGT,A,2
NC_037328.1,NC_032650.1,147672490,147672491,150689472,AG,A,1
NC_037328.1,NC_032650.1,147712065,147712066,150729306,TA,T,1
NC_037328.1,NC_032650.1,148277239,148277240,151403768,TG,T,1
NC_037328.1,NC_032650.1,148278241,148278242,151404769,AC,A,1
NC_037328.1,NC_032650.1,148329887,148329888,151526147,GC,G,1
NC_037328.1,NC_032650.1,148347439,148347443,151604939,TTTTA,T,4
NC_037328.1,NC_032650.1,148347867,148347869,151605367,CCA,C,2
NC_037328.1,NC_032650.1,148920439,148920440,152204025,GT,G,1
NC_037328.1,NC_032650.1,149318658,149318659,152694393,CG,C,1
NC_037328.1,NC_032650.1,149359607,149359608,152735413,AC,A,1
NC_037328.1,NC_032650.1,149359618,149359619,152735423,GT,G,1
NC_037328.1,NC_032650.1,149359625,149359626,152735429,GA,G,1
NC_037328.1,NC_032650.1,149634859,149634860,153005202,GT,G,1
NC_037328.1,NC_032650.1,149876460,149876461,153267710,AT,A,1
NC_037328.1,NC_032650.1,149876500,149876501,153267749,TG,T,1
NC_037328.1,NC_032650.1,150049753,150049762,153441508,CCTAGGCTAT,C,9
NC_037328.1,NC_032650.1,150129625,150129626,153520010,TC,T,1
NC_037328.1,NC_032650.1,150272702,150272703,153664385,AT,A,1
NC_037328.1,NC_032650.1,150280624,150280625,153672305,AT,A,1
NC_037328.1,NC_032650.1,150290134,150290136,153681822,CCA,C,2
NC_037328.1,NC_032650.1,150344091,150344092,153736305,AT,A,1
NC_037328.1,NC_032650.1,150430989,150430990,153824223,GA,G,1
NC_037328.1,NC_032650.1,150478435,150478438,153872387,CTTG,C,3
NC_037328.1,NC_032650.1,150495040,150495041,153888993,CA,C,1
NC_037328.1,NC_032650.1,150666930,150666946,154092557,TACAAGAGGTTCTCATG,T,16
NC_037328.1,NC_032650.1,150736051,150736052,154161595,AG,A,1
NC_037328.1,NC_032650.1,150856358,150856359,154282366,CA,C,1
NC_037328.1,NC_032650.1,150919345,150919346,154344799,CA,C,1
NC_037328.1,NC_032650.1,150975896,150975897,154408952,GC,G,1
NC_037328.1,NC_032650.1,151006436,151006437,154439495,TG,T,1
NC_037328.1,NC_032650.1,151035835,151035836,154468831,GT,G,1
NC_037328.1,NC_032650.1,151036555,151036556,154469552,GC,G,1
NC_037328.1,NC_032650.1,151036784,151036785,154469778,TC,T,1
NC_037328.1,NC_032650.1,151348129,151348130,154782726,GC,G,1
NC_037328.1,NC_032650.1,151351210,151351211,154785805,CT,C,1
NC_037328.1,NC_032650.1,151352939,151352940,154787531,CA,C,1
NC_037328.1,NC_032650.1,151400031,151400033,154859032,CGT,C,2
NC_037328.1,NC_032650.1,151404966,151404967,154863962,AT,A,1
NC_037328.1,NC_032650.1,151420307,151420308,154906161,TC,T,1
NC_037328.1,NC_032650.1,151572056,151572058,155062461,TTA,T,2
NC_037328.1,NC_032650.1,151602810,151602811,155093216,CT,C,1
NC_037328.1,NC_032650.1,151617199,151617200,155107604,GA,G,1
NC_037328.1,NC_032650.1,151838701,151838702,155315124,GA,G,1
NC_037328.1,NC_032650.1,151898163,151898197,155374618,CCAATACCCATGTTACACCAATACCCATGTTACAT,C,34
NC_037328.1,NC_032650.1,152051506,152051507,155527996,AT,A,1
NC_037328.1,NC_032650.1,152183426,152183427,155669463,AT,A,1
NC_037328.1,NC_032650.1,152231246,152231247,155718510,CA,C,1
NC_037328.1,NC_032650.1,152232517,152232518,155719778,TC,T,1
NC_037328.1,NC_032650.1,152367447,152367448,155862727,CG,C,1
NC_037328.1,NC_032650.1,152446565,152446578,155941693,CTAAAAACAATCGT,C,13
NC_037328.1,NC_032650.1,152506245,152506246,156001197,AG,A,1
NC_037328.1,NC_032650.1,152514316,152514317,156009268,GC,G,1
NC_037328.1,NC_032650.1,152515083,152515084,156010036,GA,G,1
NC_037328.1,NC_032650.1,152632296,152632297,156129294,AC,A,1
NC_037328.1,NC_032650.1,152690432,152690433,156187301,GA,G,1
NC_037328.1,NC_032650.1,153032898,153032900,156531996,GGA,G,2
NC_037328.1,NC_032650.1,153063118,153063119,156565284,CT,C,1
NC_037328.1,NC_032650.1,153259443,153259444,156761721,AT,A,1
NC_037328.1,NC_032650.1,153346958,153346959,156847230,GA,G,1
NC_037328.1,NC_032650.1,153419855,153419856,156920142,CA,C,1
NC_037328.1,NC_032650.1,153463462,153463463,156968754,AT,A,1
NC_037328.1,NC_032650.1,153487391,153487392,156992950,AG,A,1
NC_037328.1,NC_032650.1,153502460,153502464,157008029,AGCCT,A,4
NC_037328.1,NC_032650.1,153503112,153503113,157008672,CT,C,1
NC_037328.1,NC_032650.1,153521874,153521875,157027220,GC,G,1
NC_037328.1,NC_032650.1,153540371,153540388,157045752,TTACGGTACCCTGAGCGA,T,17
NC_037328.1,NC_032650.1,153681088,153681089,157216981,CT,C,1
NC_037328.1,NC_032650.1,154042918,154042919,157577447,GT,G,1
NC_037328.1,NC_032650.1,154042928,154042929,157577456,TA,T,1
NC_037328.1,NC_032650.1,154063226,154063227,157597753,TA,T,1
NC_037328.1,NC_032650.1,154102329,154102330,157637506,GC,G,1
NC_037328.1,NC_032650.1,154317814,154317815,157857653,GA,G,1
NC_037328.1,NC_032650.1,154433096,154433097,157978843,CT,C,1
NC_037328.1,NC_032650.1,154534781,154534782,158080409,AC,A,1
NC_037328.1,NC_032650.1,154636448,154636449,158182450,GC,G,1
NC_037328.1,NC_032650.1,154774709,154774710,158321288,TC,T,1
NC_037328.1,NC_032650.1,154774954,154774957,158321532,AACG,A,3
NC_037328.1,NC_032650.1,154827232,154827233,158373474,TA,T,1
NC_037328.1,NC_032650.1,154830651,154830652,158376896,TG,T,1
NC_037328.1,NC_032650.1,154870450,154870451,158416697,AC,A,1
NC_037328.1,NC_032650.1,154963221,154963222,158509504,GC,G,1
NC_037328.1,NC_032650.1,154976223,154976224,158522435,AT,A,1
NC_037328.1,NC_032650.1,155219577,155219578,158761517,TG,T,1
NC_037328.1,NC_032650.1,155240455,155240456,158782414,CT,C,1
NC_037328.1,NC_032650.1,155240693,155240694,158782651,GC,G,1
NC_037328.1,NC_032650.1,155409685,155409686,158964109,GC,G,1
NC_037328.1,NC_032650.1,155428875,155428876,158985136,GA,G,1
NC_037328.1,NC_032650.1,155468414,155468415,159024680,GC,G,1
NC_037328.1,NC_032650.1,155535878,155535879,159090488,GA,G,1
NC_037328.1,NC_032650.1,155587832,155587833,159142407,GT,G,1
NC_037328.1,NC_032650.1,155587871,155587873,159142444,TTC,T,2
NC_037328.1,NC_032650.1,155587933,155587934,159142503,AC,A,1
NC_037328.1,NC_032650.1,155590732,155590733,159145292,TA,T,1
NC_037328.1,NC_032650.1,155640106,155640176,159194695,CGGGGGACCATACTTGAGATCCCGTTGATTTCTCACCTTGGGAATGCAAAGACAGCACATGTTACCTACCA,C,70
NC_037328.1,NC_032650.1,155882506,155882507,159437330,CG,C,1
NC_037328.1,NC_032650.1,155882520,155882521,159437343,TG,T,1
NC_037328.1,NC_032650.1,155886999,155887000,159441820,CG,C,1
NC_037328.1,NC_032650.1,155887022,155887023,159441842,CT,C,1
NC_037328.1,NC_032650.1,155931681,155931682,159487208,CG,C,1
NC_037328.1,NC_032650.1,155941490,155941491,159497004,TA,T,1
NC_037328.1,NC_032650.1,155975673,155975674,159532107,CT,C,1
NC_037328.1,NC_032650.1,155985252,155985253,159541686,GC,G,1
NC_037328.1,NC_032650.1,155985259,155985261,159541692,CAG,C,2
NC_037328.1,NC_032650.1,156028295,156028296,159585156,AG,A,1
NC_037328.1,NC_032650.1,156279195,156279196,159858701,GA,G,1
NC_037328.1,NC_032650.1,156378604,156378605,159958111,CT,C,1
NC_037328.1,NC_032650.1,156380029,156380031,159959535,CTT,C,2
NC_037328.1,NC_032650.1,156394219,156394224,159973737,TAAAGG,T,5
NC_037328.1,NC_032650.1,156762724,156762725,160239490,CG,C,1
NC_037328.1,NC_032650.1,156802762,156802763,160279518,TA,T,1
NC_037328.1,NC_032650.1,156863350,156863351,160340537,AG,A,1
NC_037328.1,NC_032650.1,156992305,156992306,160514426,AT,A,1
NC_037328.1,NC_032650.1,157083659,157083660,160607286,AC,A,1
NC_037328.1,NC_032650.1,157254146,157254147,160775702,GC,G,1
NC_037328.1,NC_032650.1,157444762,157444763,160961207,CG,C,1
NC_037328.1,NC_032650.1,157446522,157446523,160962966,AG,A,1
NC_037328.1,NC_032650.1,157448532,157448533,160964975,GT,G,1
NC_037328.1,NC_032650.1,157520949,157520950,161042264,AT,A,1
NC_037328.1,NC_032650.1,157521165,157521166,161042478,CT,C,1
NC_037328.1,NC_032650.1,157540933,157540934,161063105,AC,A,1
NC_037328.1,NC_032650.1,157541635,157541636,161063806,AC,A,1
NC_037328.1,NC_032650.1,157541723,157541729,161063893,GTGACTT,G,6
NC_037328.1,NC_032650.1,157542044,157542045,161064216,CA,C,1
