Reference ID,Query ID,Reference POS,Reference END,Query POS,REF,ALT,SVLEN
NC_037351.1,NC_032673.1,572185,572186,281389,GC,G,1
NC_037351.1,NC_032673.1,574705,574706,283935,TG,T,1
NC_037351.1,NC_032673.1,944084,944087,677082,CTCT,C,3
NC_037351.1,NC_032673.1,944096,944097,677091,AC,A,1
NC_037351.1,NC_032673.1,944108,944109,677102,GA,G,1
NC_037351.1,NC_032673.1,944130,944131,677123,CT,C,1
NC_037351.1,NC_032673.1,1090555,1090566,828373,CTTGGCCACAGG,C,11
NC_037351.1,NC_032673.1,1091573,1091574,829379,GC,G,1
NC_037351.1,NC_032673.1,1091682,1091683,829487,TG,T,1
NC_037351.1,NC_032673.1,1264563,1264564,1005081,AG,A,1
NC_037351.1,NC_032673.1,1272155,1272196,1012673,CTCGTGGGCTCACTCTGCCCTCGTGGGCTCACTCTCTCCCTG,C,41
NC_037351.1,NC_032673.1,1273780,1273781,1014237,TC,T,1
NC_037351.1,NC_032673.1,1273791,1273792,1014247,TC,T,1
NC_037351.1,NC_032673.1,1370470,1370471,1110966,TG,T,1
NC_037351.1,NC_032673.1,1523636,1523639,1356457,GTTC,G,3
NC_037351.1,NC_032673.1,1523636,1523639,1264418,GTTC,G,3
NC_037351.1,NC_032673.1,1599671,1599672,1432533,GC,G,1
NC_037351.1,NC_032673.1,1619218,1619232,1452448,GCGTGGCCAAGGCTA,G,14
NC_037351.1,NC_032673.1,1619810,1619811,1453026,TG,T,1
NC_037351.1,NC_032673.1,1629740,1629741,1463027,CT,C,1
NC_037351.1,NC_032673.1,1660766,1660768,1494195,ATT,A,2
NC_037351.1,NC_032673.1,1682186,1682187,1515639,CA,C,1
NC_037351.1,NC_032673.1,1850023,1850024,1722664,CA,C,1
NC_037351.1,NC_032673.1,2243281,2243282,2037738,GC,G,1
NC_037351.1,NC_032673.1,2508919,2508920,2340197,AG,A,1
NC_037351.1,NC_032673.1,2636501,2636502,2467113,TG,T,1
NC_037351.1,NC_032673.1,2662735,2662737,2493338,CGA,C,2
NC_037351.1,NC_032673.1,2664174,2664177,2494775,CATT,C,3
NC_037351.1,NC_032673.1,2668625,2668626,2499223,GA,G,1
NC_037351.1,NC_032673.1,2721355,2721356,2551256,CA,C,1
NC_037351.1,NC_032673.1,2721365,2721366,2551265,GT,G,1
NC_037351.1,NC_032673.1,2721370,2721371,2551269,CA,C,1
NC_037351.1,NC_032673.1,2737155,2737156,2566911,CA,C,1
NC_037351.1,NC_032673.1,2974256,2974258,2803930,CAA,C,2
NC_037351.1,NC_032673.1,2999782,2999802,2829452,CCGACAGTCTCTGTAATTTGG,C,20
NC_037351.1,NC_032673.1,3147739,3147741,2977254,GAA,G,2
NC_037351.1,NC_032673.1,3150089,3150093,2979592,GAAAC,G,4
NC_037351.1,NC_032673.1,3172924,3172925,3002111,GT,G,1
NC_037351.1,NC_032673.1,3310271,3310272,3165459,TG,T,1
NC_037351.1,NC_032673.1,3310278,3310279,3165465,CA,C,1
NC_037351.1,NC_032673.1,3401444,3401446,3256542,TTC,T,2
NC_037351.1,NC_032673.1,3401493,3401495,3256589,AAC,A,2
NC_037351.1,NC_032673.1,3586823,3586824,3483123,CA,C,1
NC_037351.1,NC_032673.1,3588462,3588463,3484762,GT,G,1
NC_037351.1,NC_032673.1,3620653,3620654,3516960,CT,C,1
NC_037351.1,NC_032673.1,3620890,3620895,3517196,AGCAGC,A,5
NC_037351.1,NC_032673.1,3745521,3745522,3655017,CT,C,1
NC_037351.1,NC_032673.1,3855488,3855489,3764927,GA,G,1
NC_037351.1,NC_032673.1,3887511,3887512,3796951,TG,T,1
NC_037351.1,NC_032673.1,3889891,3889892,3799330,GC,G,1
NC_037351.1,NC_032673.1,3928557,3928559,3837991,CCT,C,2
NC_037351.1,NC_032673.1,3994870,3994872,3903025,TTG,T,2
NC_037351.1,NC_032673.1,4003552,4003553,3911712,AG,A,1
NC_037351.1,NC_032673.1,4005826,4005827,3913986,TG,T,1
NC_037351.1,NC_032673.1,4161200,4161201,4075369,TG,T,1
NC_037351.1,NC_032673.1,4161341,4161343,4075571,TGG,T,2
NC_037351.1,NC_032673.1,4165229,4165230,4079459,CT,C,1
NC_037351.1,NC_032673.1,4184860,4184861,4097903,CT,C,1
NC_037351.1,NC_032673.1,4191746,4191747,4104746,CA,C,1
NC_037351.1,NC_032673.1,4334532,4334533,4251841,GA,G,1
NC_037351.1,NC_032673.1,4336408,4336409,4253715,CG,C,1
NC_037351.1,NC_032673.1,4337316,4337337,4254533,GAGGAAGGGACGCACAGCCCCA,G,21
NC_037351.1,NC_032673.1,4337850,4337851,4255046,GT,G,1
NC_037351.1,NC_032673.1,4419105,4419106,4323294,CT,C,1
NC_037351.1,NC_032673.1,4618623,4618624,4525190,GC,G,1
NC_037351.1,NC_032673.1,4648450,4648451,4555023,TA,T,1
NC_037351.1,NC_032673.1,4648460,4648462,4555032,ATC,A,2
NC_037351.1,NC_032673.1,4830647,4830651,4740474,CACTG,C,4
NC_037351.1,NC_032673.1,4830647,4830651,4859492,CACTG,C,4
NC_037351.1,NC_032673.1,4853114,4853115,4881531,GC,G,1
NC_037351.1,NC_032673.1,4853114,4853115,4763174,GC,G,1
NC_037351.1,NC_032673.1,4928115,4928117,4957307,TTG,T,2
NC_037351.1,NC_032673.1,4928182,4928183,4957370,AT,A,1
NC_037351.1,NC_032673.1,5035444,5035445,5062825,TA,T,1
NC_037351.1,NC_032673.1,5116081,5116082,5143553,TG,T,1
NC_037351.1,NC_032673.1,5376698,5376699,5608172,GA,G,1
NC_037351.1,NC_032673.1,5443340,5443347,5673913,TGAAAAGC,T,7
NC_037351.1,NC_032673.1,5454766,5454768,5685334,GTT,G,2
NC_037351.1,NC_032673.1,5591188,5591199,5818075,GTACTGTAAATT,G,11
NC_037351.1,NC_032673.1,5626500,5626502,5853362,AGG,A,2
NC_037351.1,NC_032673.1,5635720,5635721,5862598,CA,C,1
NC_037351.1,NC_032673.1,5670097,5670098,5896980,CG,C,1
NC_037351.1,NC_032673.1,5760028,5760029,5987417,AT,A,1
NC_037351.1,NC_032673.1,6303057,6303060,6527212,GGAT,G,3
NC_037351.1,NC_032673.1,6921576,6921577,7030197,GA,G,1
NC_037351.1,NC_032673.1,7383976,7383977,7488113,TC,T,1
NC_037351.1,NC_032673.1,7475130,7475131,7579456,AT,A,1
NC_037351.1,NC_032673.1,7616607,7616610,7720980,TGGA,T,3
NC_037351.1,NC_032673.1,7689957,7689958,7962750,GA,G,1
NC_037351.1,NC_032673.1,7982187,7982190,8218747,ATTG,A,3
NC_037351.1,NC_032673.1,8024065,8024066,8266571,AT,A,1
NC_037351.1,NC_032673.1,8049438,8049439,8291948,AC,A,1
NC_037351.1,NC_032673.1,8180276,8180277,8422708,TC,T,1
NC_037351.1,NC_032673.1,8199957,8199959,8442305,CAA,C,2
NC_037351.1,NC_032673.1,8202229,8202233,8444577,TCATA,T,4
NC_037351.1,NC_032673.1,8204929,8204930,8447276,AT,A,1
NC_037351.1,NC_032673.1,8881871,8881872,9262399,TG,T,1
NC_037351.1,NC_032673.1,8881875,8881876,9262402,CA,C,1
NC_037351.1,NC_032673.1,9045280,9045281,9425655,TC,T,1
NC_037351.1,NC_032673.1,9267336,9267339,9651446,ATAT,A,3
NC_037351.1,NC_032673.1,9645167,9645169,10057819,AAG,A,2
NC_037351.1,NC_032673.1,9680817,9680840,10091106,AGTGGATGGAATGGAATCAGCAAT,A,23
NC_037351.1,NC_032673.1,10636370,10636371,11220589,AT,A,1
NC_037351.1,NC_032673.1,10636514,10636521,11220733,CTGTTTAG,C,7
NC_037351.1,NC_032673.1,10636983,10636987,11221195,AAAGC,A,4
NC_037351.1,NC_032673.1,10637004,10637006,11221212,GAA,G,2
NC_037351.1,NC_032673.1,10641633,10641634,11225843,TG,T,1
NC_037351.1,NC_032673.1,10803357,10803358,11387238,GA,G,1
NC_037351.1,NC_032673.1,10928983,10928984,11510951,TG,T,1
NC_037351.1,NC_032673.1,10951487,10951489,11533381,AAC,A,2
NC_037351.1,NC_032673.1,10956559,10956561,11538457,CTG,C,2
NC_037351.1,NC_032673.1,10971660,10971663,11553591,TTAA,T,3
NC_037351.1,NC_032673.1,10971989,10971990,11553916,GA,G,1
NC_037351.1,NC_032673.1,10972004,10972005,11553930,AC,A,1
NC_037351.1,NC_032673.1,11067963,11067964,11650712,TG,T,1
NC_037351.1,NC_032673.1,11096119,11096121,11678873,GAA,G,2
NC_037351.1,NC_032673.1,11202429,11202430,11790438,CT,C,1
NC_037351.1,NC_032673.1,11215777,11215779,11803789,ATT,A,2
NC_037351.1,NC_032673.1,11391306,11391307,11991474,AG,A,1
NC_037351.1,NC_032673.1,11392117,11392119,11992282,ATT,A,2
NC_037351.1,NC_032673.1,11822880,11822881,12422102,GC,G,1
NC_037351.1,NC_032673.1,13405872,13405873,14108466,GA,G,1
NC_037351.1,NC_032673.1,13405888,13405889,14108481,CA,C,1
NC_037351.1,NC_032673.1,13417615,13417616,14120207,CA,C,1
NC_037351.1,NC_032673.1,13417652,13417654,14120243,TTA,T,2
NC_037351.1,NC_032673.1,13417657,13417659,14120246,TTC,T,2
NC_037351.1,NC_032673.1,13726441,13726442,14444824,CT,C,1
NC_037351.1,NC_032673.1,13774374,13774375,14492861,CA,C,1
NC_037351.1,NC_032673.1,13774400,13774401,14492886,TA,T,1
NC_037351.1,NC_032673.1,13950950,13950951,14669330,CA,C,1
NC_037351.1,NC_032673.1,13951038,13951039,14669412,CA,C,1
NC_037351.1,NC_032673.1,13951045,13951046,14669418,TA,T,1
NC_037351.1,NC_032673.1,14300058,14300060,15020242,AAG,A,2
NC_037351.1,NC_032673.1,14300151,14300152,15020332,AG,A,1
NC_037351.1,NC_032673.1,14300216,14300217,15020395,GT,G,1
NC_037351.1,NC_032673.1,14300224,14300225,15020402,AG,A,1
NC_037351.1,NC_032673.1,15142761,15142762,15870927,AT,A,1
NC_037351.1,NC_032673.1,15592819,15592820,16320777,CA,C,1
NC_037351.1,NC_032673.1,15690037,15690038,16417426,CT,C,1
NC_037351.1,NC_032673.1,15690055,15690056,16417443,GA,G,1
NC_037351.1,NC_032673.1,15690083,15690084,16417469,CT,C,1
NC_037351.1,NC_032673.1,16228732,16228733,16966680,AT,A,1
NC_037351.1,NC_032673.1,16986750,16986751,17714404,AC,A,1
NC_037351.1,NC_032673.1,17568652,17568653,18341839,GC,G,1
NC_037351.1,NC_032673.1,17605231,17605232,18414932,CG,C,1
NC_037351.1,NC_032673.1,17622504,17622505,18432539,GT,G,1
NC_037351.1,NC_032673.1,18602093,18602094,19431552,CA,C,1
NC_037351.1,NC_032673.1,18602138,18602139,19431595,TA,T,1
NC_037351.1,NC_032673.1,18602154,18602156,19431610,AAG,A,2
NC_037351.1,NC_032673.1,18884811,18884812,19714283,GT,G,1
NC_037351.1,NC_032673.1,18889839,18889840,19719327,GT,G,1
NC_037351.1,NC_032673.1,18928567,18928568,19758473,AT,A,1
NC_037351.1,NC_032673.1,19615489,19615490,20666299,GC,G,1
NC_037351.1,NC_032673.1,20249219,20249220,21355346,AT,A,1
NC_037351.1,NC_032673.1,21377971,21377974,22478954,CAAA,C,3
NC_037351.1,NC_032673.1,21566418,21566420,22667462,TTA,T,2
NC_037351.1,NC_032673.1,21566515,21566516,22667555,AG,A,1
NC_037351.1,NC_032673.1,21566531,21566532,22667570,AC,A,1
NC_037351.1,NC_032673.1,21960593,21960594,23061483,AG,A,1
NC_037351.1,NC_032673.1,22002867,22002868,23103754,CT,C,1
NC_037351.1,NC_032673.1,22002977,22002978,23103861,CT,C,1
NC_037351.1,NC_032673.1,22003025,22003026,23103907,CT,C,1
NC_037351.1,NC_032673.1,22883071,22883072,23962627,CT,C,1
NC_037351.1,NC_032673.1,22883538,22883541,23963094,ACCC,A,3
NC_037351.1,NC_032673.1,22885518,22885519,23965079,GC,G,1
NC_037351.1,NC_032673.1,22885644,22885645,23965207,CA,C,1
NC_037351.1,NC_032673.1,23561411,23561412,24640774,TG,T,1
NC_037351.1,NC_032673.1,23909881,23909882,24989174,GA,G,1
NC_037351.1,NC_032673.1,24045921,24045924,25125083,CGCA,C,3
NC_037351.1,NC_032673.1,24301046,24301047,25371286,GT,G,1
NC_037351.1,NC_032673.1,24301102,24301103,25371339,CT,C,1
NC_037351.1,NC_032673.1,25342440,25342442,26423798,GGT,G,2
NC_037351.1,NC_032673.1,25342504,25342506,26423859,TTA,T,2
NC_037351.1,NC_032673.1,25342518,25342519,26423871,TA,T,1
NC_037351.1,NC_032673.1,25504856,25504857,26586045,AG,A,1
NC_037351.1,NC_032673.1,25504887,25504888,26586074,GT,G,1
NC_037351.1,NC_032673.1,25504895,25504896,26586081,GA,G,1
NC_037351.1,NC_032673.1,25917432,25917433,26982729,AG,A,1
NC_037351.1,NC_032673.1,25917493,25917494,26982788,TA,T,1
NC_037351.1,NC_032673.1,25917620,25917621,26982948,AT,A,1
NC_037351.1,NC_032673.1,25948987,25948988,27014313,TA,T,1
NC_037351.1,NC_032673.1,25997641,25997642,27062919,GT,G,1
NC_037351.1,NC_032673.1,26035672,26035678,27101035,TGAAATG,T,6
NC_037351.1,NC_032673.1,26035726,26035741,27101083,CTGTGCTGCCTTCCTA,C,15
NC_037351.1,NC_032673.1,26068147,26068148,27135226,AT,A,1
NC_037351.1,NC_032673.1,26875226,26875227,27897692,GT,G,1
NC_037351.1,NC_032673.1,27136068,27136069,28158957,CT,C,1
NC_037351.1,NC_032673.1,27287907,27287908,28311919,CT,C,1
NC_037351.1,NC_032673.1,27340845,27340846,28364699,TC,T,1
NC_037351.1,NC_032673.1,27564486,27564487,28595431,TC,T,1
NC_037351.1,NC_032673.1,27566421,27566423,28597367,TAA,T,2
NC_037351.1,NC_032673.1,27767861,27767862,28798845,GC,G,1
NC_037351.1,NC_032673.1,27798114,27798135,28829104,GTTATGTTACAGAATATCAGTT,G,21
NC_037351.1,NC_032673.1,27929763,27929764,28960708,GT,G,1
NC_037351.1,NC_032673.1,28142245,28142246,29200329,CA,C,1
NC_037351.1,NC_032673.1,28147577,28147578,29206212,TG,T,1
NC_037351.1,NC_032673.1,28404882,28404883,29461777,AT,A,1
NC_037351.1,NC_032673.1,28409311,28409312,29466208,AT,A,1
NC_037351.1,NC_032673.1,28410905,28410906,29467803,TA,T,1
NC_037351.1,NC_032673.1,28410972,28410973,29467869,GT,G,1
NC_037351.1,NC_032673.1,28472685,28472686,29527014,CT,C,1
NC_037351.1,NC_032673.1,28499275,28499276,29553605,AC,A,1
NC_037351.1,NC_032673.1,28549540,28549541,29603883,AG,A,1
NC_037351.1,NC_032673.1,28638359,28638360,29692712,TA,T,1
NC_037351.1,NC_032673.1,28687043,28687044,29741453,AC,A,1
NC_037351.1,NC_032673.1,28688020,28688021,29742429,TC,T,1
NC_037351.1,NC_032673.1,28991195,28991196,30037985,CG,C,1
NC_037351.1,NC_032673.1,29306418,29306419,30353746,CT,C,1
NC_037351.1,NC_032673.1,29322714,29322716,30370043,TAA,T,2
NC_037351.1,NC_032673.1,29864680,29864681,30671121,GA,G,1
NC_037351.1,NC_032673.1,29864761,29864762,30671201,GA,G,1
NC_037351.1,NC_032673.1,29915649,29915650,30721866,AC,A,1
NC_037351.1,NC_032673.1,30753321,30753326,31846635,TAGAAG,T,5
NC_037351.1,NC_032673.1,30832605,30832606,31926087,AT,A,1
NC_037351.1,NC_032673.1,31131613,31131633,32242093,AAGGAATGTAAAGTCATGTGC,A,20
NC_037351.1,NC_032673.1,31268387,31268388,32377372,TA,T,1
NC_037351.1,NC_032673.1,31547910,31547911,32657342,TA,T,1
NC_037351.1,NC_032673.1,32101200,32101202,33210887,CCA,C,2
NC_037351.1,NC_032673.1,32101207,32101208,33210892,GA,G,1
NC_037351.1,NC_032673.1,32119632,32119633,33229322,AG,A,1
NC_037351.1,NC_032673.1,32274379,32274380,33613013,TA,T,1
NC_037351.1,NC_032673.1,32295394,32295396,33494257,GCT,G,2
NC_037351.1,NC_032673.1,32595439,32595440,33713497,TC,T,1
NC_037351.1,NC_032673.1,32627739,32627740,33745828,CG,C,1
NC_037351.1,NC_032673.1,32647846,32647847,33765928,AT,A,1
NC_037351.1,NC_032673.1,32827337,32827342,33935476,CGAGGA,C,5
NC_037351.1,NC_032673.1,32852743,32852744,33960977,CT,C,1
NC_037351.1,NC_032673.1,32872696,32872697,33980934,GC,G,1
NC_037351.1,NC_032673.1,32884088,32884090,33992331,CAA,C,2
NC_037351.1,NC_032673.1,32890215,32890216,33998451,CT,C,1
NC_037351.1,NC_032673.1,33142371,33142383,34232323,ACCACAGCAATGT,A,12
NC_037351.1,NC_032673.1,33231473,33231474,34321417,AG,A,1
NC_037351.1,NC_032673.1,33231591,33231592,34321532,AT,A,1
NC_037351.1,NC_032673.1,33359151,33359152,34459739,CA,C,1
NC_037351.1,NC_032673.1,33573925,33573926,34691351,GT,G,1
NC_037351.1,NC_032673.1,34013324,34013325,35130830,TA,T,1
NC_037351.1,NC_032673.1,34013334,34013335,35130839,TG,T,1
NC_037351.1,NC_032673.1,34013349,34013351,35130853,GGA,G,2
NC_037351.1,NC_032673.1,34013362,34013363,35130864,GT,G,1
NC_037351.1,NC_032673.1,34060559,34060560,35178059,AG,A,1
NC_037351.1,NC_032673.1,34086200,34086201,35210599,AT,A,1
NC_037351.1,NC_032673.1,34185252,34185253,35309544,CA,C,1
NC_037351.1,NC_032673.1,34185258,34185259,35309549,AT,A,1
NC_037351.1,NC_032673.1,34249659,34249660,35373570,TG,T,1
NC_037351.1,NC_032673.1,34522621,34522622,35644920,GC,G,1
NC_037351.1,NC_032673.1,34554275,34554276,35676661,AC,A,1
NC_037351.1,NC_032673.1,34623482,34623483,35743477,TC,T,1
NC_037351.1,NC_032673.1,34623489,34623490,35743483,AG,A,1
NC_037351.1,NC_032673.1,34696579,34696580,35807422,CA,C,1
NC_037351.1,NC_032673.1,34735613,34735626,35846556,AATGTCAGACCCAG,A,13
NC_037351.1,NC_032673.1,34735675,34735680,35846605,CCCAGA,C,5
NC_037351.1,NC_032673.1,34779782,34779783,35890667,AG,A,1
NC_037351.1,NC_032673.1,34866329,34866330,35974515,TG,T,1
NC_037351.1,NC_032673.1,34902947,34902948,36011081,GA,G,1
NC_037351.1,NC_032673.1,35059612,35059614,36179482,AAT,A,2
NC_037351.1,NC_032673.1,35059649,35059650,36179514,CA,C,1
NC_037351.1,NC_032673.1,35059653,35059654,36179517,GA,G,1
NC_037351.1,NC_032673.1,35263970,35263971,36383629,AG,A,1
NC_037351.1,NC_032673.1,35265573,35265574,36385229,AT,A,1
NC_037351.1,NC_032673.1,35298783,35298784,36418525,GA,G,1
NC_037351.1,NC_032673.1,35336798,35336799,36456599,TC,T,1
NC_037351.1,NC_032673.1,35620239,35620241,36822429,TCA,T,2
NC_037351.1,NC_032673.1,35687718,35687719,36890049,CA,C,1
NC_037351.1,NC_032673.1,35842373,35842387,37049302,ATGGTGCCAGTCCTT,A,14
NC_037351.1,NC_032673.1,36290212,36290213,37492701,AG,A,1
NC_037351.1,NC_032673.1,36467098,36467099,37803078,TC,T,1
NC_037351.1,NC_032673.1,36523467,36523468,37859806,AG,A,1
NC_037351.1,NC_032673.1,36528003,36528004,37864344,AG,A,1
NC_037351.1,NC_032673.1,36534269,36534270,37870614,GA,G,1
NC_037351.1,NC_032673.1,36692356,36692357,38028406,TC,T,1
NC_037351.1,NC_032673.1,36692360,36692361,38028409,GT,G,1
NC_037351.1,NC_032673.1,36696576,36696577,38032624,GC,G,1
NC_037351.1,NC_032673.1,36888760,36888762,37617728,AAT,A,2
NC_037351.1,NC_032673.1,37061756,37061757,38455181,CA,C,1
NC_037351.1,NC_032673.1,37093763,37093766,38487200,AGAG,A,3
NC_037351.1,NC_032673.1,37129211,37129219,38522644,ACCACCTCC,A,8
NC_037351.1,NC_032673.1,37198985,37198986,38592535,AC,A,1
NC_037351.1,NC_032673.1,37350669,37350672,38744500,CTAT,C,3
NC_037351.1,NC_032673.1,37424914,37424915,38819460,AG,A,1
NC_037351.1,NC_032673.1,37431183,37431184,38825728,CA,C,1
NC_037351.1,NC_032673.1,37446506,37446507,38841051,AC,A,1
NC_037351.1,NC_032673.1,37446685,37446687,38841229,CTT,C,2
NC_037351.1,NC_032673.1,37689093,37689094,39078112,CT,C,1
NC_037351.1,NC_032673.1,37784304,37784307,39173330,CCTT,C,3
NC_037351.1,NC_032673.1,37830811,37830813,39219205,TGG,T,2
NC_037351.1,NC_032673.1,37860948,37860949,39249109,AT,A,1
NC_037351.1,NC_032673.1,37860957,37860958,39249117,CT,C,1
NC_037351.1,NC_032673.1,37892569,37892570,39280476,AC,A,1
NC_037351.1,NC_032673.1,37989930,37989931,39377955,GT,G,1
NC_037351.1,NC_032673.1,38147842,38147843,39535907,AG,A,1
NC_037351.1,NC_032673.1,38147868,38147869,39535932,AT,A,1
NC_037351.1,NC_032673.1,38330837,38330838,39719034,CA,C,1
NC_037351.1,NC_032673.1,38330873,38330874,39719069,CA,C,1
NC_037351.1,NC_032673.1,38361321,38361322,39748785,CA,C,1
NC_037351.1,NC_032673.1,38378080,38378081,39765460,AG,A,1
NC_037351.1,NC_032673.1,38436877,38436881,39829534,GGACT,G,4
NC_037351.1,NC_032673.1,38466270,38466271,39862945,TC,T,1
NC_037351.1,NC_032673.1,39807775,39807776,41306188,CT,C,1
NC_037351.1,NC_032673.1,39851298,39851299,41349708,CA,C,1
NC_037351.1,NC_032673.1,39898761,39898762,41396283,CA,C,1
NC_037351.1,NC_032673.1,39898766,39898767,41396287,GA,G,1
NC_037351.1,NC_032673.1,40034379,40034380,41531487,AG,A,1
NC_037351.1,NC_032673.1,40042202,40042203,41539460,AG,A,1
NC_037351.1,NC_032673.1,40767166,40767168,42324878,AAG,A,2
NC_037351.1,NC_032673.1,40767191,40767192,42324900,TA,T,1
NC_037351.1,NC_032673.1,40767202,40767203,42324910,GA,G,1
NC_037351.1,NC_032673.1,41242242,41242243,42815516,CG,C,1
NC_037351.1,NC_032673.1,41242283,41242284,42815555,GC,G,1
NC_037351.1,NC_032673.1,41413702,41413704,43006160,AAG,A,2
NC_037351.1,NC_032673.1,41413712,41413714,43006168,AAG,A,2
NC_037351.1,NC_032673.1,41413724,41413725,43006178,GA,G,1
NC_037351.1,NC_032673.1,41593409,41593410,43184477,TC,T,1
NC_037351.1,NC_032673.1,41884202,41884203,43475342,GT,G,1
NC_037351.1,NC_032673.1,41884208,41884209,43475347,TG,T,1
NC_037351.1,NC_032673.1,41884223,41884224,43475361,TA,T,1
NC_037351.1,NC_032673.1,41884240,41884241,43475377,AT,A,1
NC_037351.1,NC_032673.1,41884296,41884297,43475432,TC,T,1
NC_037351.1,NC_032673.1,42721647,42721648,44314600,GC,G,1
NC_037351.1,NC_032673.1,42721661,42721662,44314613,GA,G,1
NC_037351.1,NC_032673.1,42721676,42721677,44314627,CT,C,1
NC_037351.1,NC_032673.1,43496502,43496503,45088675,AC,A,1
NC_037351.1,NC_032673.1,43548590,43548591,45140763,AC,A,1
NC_037351.1,NC_032673.1,43548598,43548599,45140770,AG,A,1
NC_037351.1,NC_032673.1,43548607,43548608,45140778,TG,T,1
NC_037351.1,NC_032673.1,43548637,43548638,45140807,TG,T,1
NC_037351.1,NC_032673.1,43548681,43548682,45140849,TA,T,1
NC_037351.1,NC_032673.1,43651972,43651973,45240823,TA,T,1
NC_037351.1,NC_032673.1,44696919,44696920,46254136,TC,T,1
NC_037351.1,NC_032673.1,45367974,45367976,46918713,CCT,C,2
NC_037351.1,NC_032673.1,45378765,45378766,46929115,GC,G,1
NC_037351.1,NC_032673.1,45378778,45378779,46929127,AT,A,1
NC_037351.1,NC_032673.1,45378804,45378806,46929152,GGA,G,2
NC_037351.1,NC_032673.1,45703705,45703706,47255054,AT,A,1
NC_037351.1,NC_032673.1,45703733,45703734,47255080,TG,T,1
NC_037351.1,NC_032673.1,45703742,45703743,47255088,AT,A,1
NC_037351.1,NC_032673.1,45703780,45703781,47255124,CG,C,1
NC_037351.1,NC_032673.1,45786100,45786101,47397298,CT,C,1
NC_037351.1,NC_032673.1,45809306,45809307,47420502,AG,A,1
NC_037351.1,NC_032673.1,46333224,46333225,48015284,CA,C,1
NC_037351.1,NC_032673.1,46601987,46601988,48285446,TA,T,1
NC_037351.1,NC_032673.1,46800840,46800841,48472965,GC,G,1
NC_037351.1,NC_032673.1,46801016,46801017,48473139,AG,A,1
NC_037351.1,NC_032673.1,46801070,46801071,48473191,AT,A,1
NC_037351.1,NC_032673.1,46801082,46801083,48473202,GA,G,1
NC_037351.1,NC_032673.1,46811996,46811997,48484188,AC,A,1
NC_037351.1,NC_032673.1,47411438,47411440,49114284,AAC,A,2
NC_037351.1,NC_032673.1,47411474,47411475,49114317,AG,A,1
NC_037351.1,NC_032673.1,47427601,47427602,49130443,CA,C,1
NC_037351.1,NC_032673.1,47569677,47569678,49425397,AG,A,1
NC_037351.1,NC_032673.1,47673749,47673750,49233395,AG,A,1
NC_037351.1,NC_032673.1,47769885,47769886,49329606,AC,A,1
NC_037351.1,NC_032673.1,47807249,47807251,49366971,CCT,C,2
NC_037351.1,NC_032673.1,48392534,48392535,50056842,TA,T,1
NC_037351.1,NC_032673.1,48541287,48541288,50205589,AC,A,1
NC_037351.1,NC_032673.1,49378616,49378618,51104126,AAT,A,2
NC_037351.1,NC_032673.1,49731452,49731453,51483992,TG,T,1
NC_037351.1,NC_032673.1,49731475,49731476,51484014,GC,G,1
NC_037351.1,NC_032673.1,49786449,49786450,51539246,GC,G,1
NC_037351.1,NC_032673.1,49786460,49786461,51539256,CT,C,1
NC_037351.1,NC_032673.1,50763500,50763501,52500209,GA,G,1
NC_037351.1,NC_032673.1,51626928,51626929,53249453,GT,G,1
NC_037351.1,NC_032673.1,51630547,51630549,53252822,TTA,T,2
NC_037351.1,NC_032673.1,51630558,51630559,53252831,AT,A,1
NC_037351.1,NC_032673.1,51685746,51685747,53792266,GT,G,1
NC_037351.1,NC_032673.1,52379438,52379439,54422537,TG,T,1
NC_037351.1,NC_032673.1,52638277,52638278,54681838,AT,A,1
NC_037351.1,NC_032673.1,53399795,53399796,55449004,TG,T,1
NC_037351.1,NC_032673.1,53642015,53642018,55739077,TTCA,T,3
NC_037351.1,NC_032673.1,53642047,53642048,55739103,TA,T,1
NC_037351.1,NC_032673.1,53646556,53646578,55743616,ATTTAAGAGTATTCTCAATTCAT,A,22
NC_037351.1,NC_032673.1,54458033,54458045,56530122,TTCATCCAACATG,T,12
NC_037351.1,NC_032673.1,54915700,54915701,57003781,CT,C,1
NC_037351.1,NC_032673.1,54915714,54915715,57003794,GT,G,1
NC_037351.1,NC_032673.1,55106713,55106714,57237315,CT,C,1
NC_037351.1,NC_032673.1,55106724,55106725,57237325,TC,T,1
NC_037351.1,NC_032673.1,55155500,55155501,57286168,GT,G,1
NC_037351.1,NC_032673.1,55224464,55224465,57355125,GT,G,1
NC_037351.1,NC_032673.1,55722133,55722134,57951674,AG,A,1
NC_037351.1,NC_032673.1,55774028,55774029,58003463,GT,G,1
NC_037351.1,NC_032673.1,55975929,55975931,58205330,AAC,A,2
NC_037351.1,NC_032673.1,56019303,56019305,58248487,GGT,G,2
NC_037351.1,NC_032673.1,56066726,56066727,58296297,CG,C,1
NC_037351.1,NC_032673.1,56075529,56075530,58305100,AC,A,1
NC_037351.1,NC_032673.1,56335315,56335383,58574505,CCCAGCGCCAGCGTGCGTTCGGAGCGCGCTTCCATCCGCTTTCAGCCAGCAAGAGCCCCCGGGCTTCCT,C,68
NC_037351.1,NC_032673.1,56420367,56420368,58659514,CT,C,1
NC_037351.1,NC_032673.1,56422958,56422968,58662131,CCTACGTGATT,C,10
NC_037351.1,NC_032673.1,56620237,56620238,58903461,AT,A,1
NC_037351.1,NC_032673.1,56731778,56731779,59043279,CT,C,1
NC_037351.1,NC_032673.1,56796449,56796450,59108042,TG,T,1
NC_037351.1,NC_032673.1,57319948,57319949,59594164,GT,G,1
NC_037351.1,NC_032673.1,57319957,57319958,59594172,GT,G,1
NC_037351.1,NC_032673.1,57529153,57529154,59803554,TA,T,1
NC_037351.1,NC_032673.1,57668732,57668733,60006426,TG,T,1
NC_037351.1,NC_032673.1,57896382,57896383,60233905,GT,G,1
NC_037351.1,NC_032673.1,57896391,57896392,60233913,TC,T,1
NC_037351.1,NC_032673.1,57896405,57896406,60233926,AG,A,1
NC_037351.1,NC_032673.1,57896425,57896426,60233945,GT,G,1
NC_037351.1,NC_032673.1,57896431,57896432,60233950,GC,G,1
NC_037351.1,NC_032673.1,57896452,57896453,60233970,CG,C,1
NC_037351.1,NC_032673.1,59205407,59205408,61764664,CG,C,1
NC_037351.1,NC_032673.1,59270773,59270774,61829994,CT,C,1
NC_037351.1,NC_032673.1,59789192,59789194,62349365,GGA,G,2
NC_037351.1,NC_032673.1,59789199,59789201,62349370,CCG,C,2
NC_037351.1,NC_032673.1,59887815,59887816,62449206,CT,C,1
NC_037351.1,NC_032673.1,60872601,60872602,63519897,TC,T,1
NC_037351.1,NC_032673.1,61555082,61555083,64178077,AC,A,1
NC_037351.1,NC_032673.1,61824170,61824171,64467747,GA,G,1
NC_037351.1,NC_032673.1,61861141,61861143,64522040,GCT,G,2
NC_037351.1,NC_032673.1,61866199,61866200,64526814,AC,A,1
NC_037351.1,NC_032673.1,61866593,61866594,64527202,GC,G,1
NC_037351.1,NC_032673.1,61871958,61871959,64532570,AG,A,1
NC_037351.1,NC_032673.1,61883291,61883304,64560638,TAACATTATCCATA,T,13
NC_037351.1,NC_032673.1,61964441,61964442,64775604,GC,G,1
NC_037351.1,NC_032673.1,61971705,61971706,64782853,TC,T,1
NC_037351.1,NC_032673.1,61984975,61984976,64796121,TA,T,1
NC_037351.1,NC_032673.1,61984984,61984985,64796129,TA,T,1
NC_037351.1,NC_032673.1,62160458,62160459,64975629,CA,C,1
