Reference ID,Query ID,Reference POS,Reference END,Query POS,REF,ALT,SVLEN
NC_037334.1,NC_032656.1,263172,263173,177328,GC,G,1
NC_037334.1,NC_032656.1,263873,263875,177993,GGA,G,2
NC_037334.1,NC_032656.1,810583,810587,763662,CCTCT,C,4
NC_037334.1,NC_032656.1,1344731,1344735,1322900,TCCCC,T,4
NC_037334.1,NC_032656.1,1344856,1344857,1323021,TC,T,1
NC_037334.1,NC_032656.1,1451666,1451667,1429437,GA,G,1
NC_037334.1,NC_032656.1,1505947,1505948,1482873,GT,G,1
NC_037334.1,NC_032656.1,1527300,1527301,1504166,TC,T,1
NC_037334.1,NC_032656.1,1734858,1734859,1585234,GC,G,1
NC_037334.1,NC_032656.1,1751110,1751111,1601482,TG,T,1
NC_037334.1,NC_032656.1,1752481,1752483,1602926,AAT,A,2
NC_037334.1,NC_032656.1,2052106,2052107,1920716,CT,C,1
NC_037334.1,NC_032656.1,2138930,2138931,2007661,TC,T,1
NC_037334.1,NC_032656.1,2167530,2167531,2034629,CG,C,1
NC_037334.1,NC_032656.1,2214388,2214389,2081520,CA,C,1
NC_037334.1,NC_032656.1,2380702,2380703,2249353,GC,G,1
NC_037334.1,NC_032656.1,2628938,2628939,2541111,AC,A,1
NC_037334.1,NC_032656.1,2753034,2753035,2669610,AG,A,1
NC_037334.1,NC_032656.1,2853863,2853869,2770493,GATTTCT,G,6
NC_037334.1,NC_032656.1,2885729,2885730,2802367,CA,C,1
NC_037334.1,NC_032656.1,2886484,2886485,2803121,GC,G,1
NC_037334.1,NC_032656.1,2907564,2907565,2824214,TG,T,1
NC_037334.1,NC_032656.1,2912632,2912656,2829570,GATATAAGCTAGGTACCCCTACAGT,G,24
NC_037334.1,NC_032656.1,2981830,2981831,2899146,AG,A,1
NC_037334.1,NC_032656.1,2981836,2981837,2899151,GA,G,1
NC_037334.1,NC_032656.1,3039085,3039086,2956407,TG,T,1
NC_037334.1,NC_032656.1,3183263,3183264,3103577,AG,A,1
NC_037334.1,NC_032656.1,3204961,3204962,3125278,GT,G,1
NC_037334.1,NC_032656.1,3204967,3204968,3125283,CT,C,1
NC_037334.1,NC_032656.1,3534870,3534881,3449158,AGTACTTAAAAG,A,11
NC_037334.1,NC_032656.1,3573110,3573117,3487125,CAGGTACG,C,7
NC_037334.1,NC_032656.1,3602878,3602879,3525439,TC,T,1
NC_037334.1,NC_032656.1,3604376,3604377,3526934,CA,C,1
NC_037334.1,NC_032656.1,3807978,3807979,3730651,GC,G,1
NC_037334.1,NC_032656.1,3974973,3974974,3897885,AG,A,1
NC_037334.1,NC_032656.1,4250212,4250213,4176743,CT,C,1
NC_037334.1,NC_032656.1,4254493,4254502,4181018,AAAGATACCT,A,9
NC_037334.1,NC_032656.1,4402279,4402280,4328369,AC,A,1
NC_037334.1,NC_032656.1,4587317,4587318,4514247,AG,A,1
NC_037334.1,NC_032656.1,4763329,4763330,4689890,CT,C,1
NC_037334.1,NC_032656.1,4815800,4815801,4741343,GC,G,1
NC_037334.1,NC_032656.1,4925210,4925211,4852203,CT,C,1
NC_037334.1,NC_032656.1,4925277,4925279,4852266,TTG,T,2
NC_037334.1,NC_032656.1,4964974,4964975,4892224,TG,T,1
NC_037334.1,NC_032656.1,4976040,4976041,4908131,CT,C,1
NC_037334.1,NC_032656.1,5000616,5000618,4932832,AGG,A,2
NC_037334.1,NC_032656.1,5140048,5140049,5072327,TG,T,1
NC_037334.1,NC_032656.1,5140055,5140056,5072333,AG,A,1
NC_037334.1,NC_032656.1,5140064,5140065,5072341,AC,A,1
NC_037334.1,NC_032656.1,5140078,5140079,5072354,AC,A,1
NC_037334.1,NC_032656.1,5140093,5140094,5072368,GC,G,1
NC_037334.1,NC_032656.1,5327287,5327288,5259563,AC,A,1
NC_037334.1,NC_032656.1,5327296,5327297,5259571,GT,G,1
NC_037334.1,NC_032656.1,5331643,5331644,5263919,CA,C,1
NC_037334.1,NC_032656.1,5647254,5647255,5584198,AC,A,1
NC_037334.1,NC_032656.1,5666415,5666416,5603591,CA,C,1
NC_037334.1,NC_032656.1,5701774,5701775,5642853,TG,T,1
NC_037334.1,NC_032656.1,5702937,5702938,5644015,CT,C,1
NC_037334.1,NC_032656.1,5741375,5741376,5682255,GC,G,1
NC_037334.1,NC_032656.1,5748329,5748330,5689207,AG,A,1
NC_037334.1,NC_032656.1,5748488,5748489,5689365,AC,A,1
NC_037334.1,NC_032656.1,5773922,5773924,5714796,TCA,T,2
NC_037334.1,NC_032656.1,5923354,5923372,5864828,CCCCTTCTCACTCTGCATG,C,18
NC_037334.1,NC_032656.1,5939048,5939049,5880511,CT,C,1
NC_037334.1,NC_032656.1,6153095,6153096,6606322,TG,T,1
NC_037334.1,NC_032656.1,6167500,6167501,6620721,GC,G,1
NC_037334.1,NC_032656.1,6199774,6199775,6653209,GC,G,1
NC_037334.1,NC_032656.1,6349043,6349044,6802029,CA,C,1
NC_037334.1,NC_032656.1,6387791,6387792,6841133,GC,G,1
NC_037334.1,NC_032656.1,6422048,6422050,6875721,TCA,T,2
NC_037334.1,NC_032656.1,6441285,6441287,6894488,TTG,T,2
NC_037334.1,NC_032656.1,6441297,6441298,6894498,TG,T,1
NC_037334.1,NC_032656.1,6635903,6635904,7111163,TC,T,1
NC_037334.1,NC_032656.1,6715504,6715505,7190576,GA,G,1
NC_037334.1,NC_032656.1,6724979,6724982,7200056,CTTT,C,3
NC_037334.1,NC_032656.1,6772858,6772859,7249000,TG,T,1
NC_037334.1,NC_032656.1,6772870,6772871,7249011,GA,G,1
NC_037334.1,NC_032656.1,6789180,6789181,7265321,TC,T,1
NC_037334.1,NC_032656.1,6830865,6830867,7307009,ATC,A,2
NC_037334.1,NC_032656.1,6843925,6843927,7321190,TCC,T,2
NC_037334.1,NC_032656.1,7131261,7131262,8320199,TC,T,1
NC_037334.1,NC_032656.1,7141263,7141268,8330200,TTTCCC,T,5
NC_037334.1,NC_032656.1,7889435,7889436,9053482,TG,T,1
NC_037334.1,NC_032656.1,7947513,7947514,9111559,AG,A,1
NC_037334.1,NC_032656.1,8497308,8497309,7664040,AG,A,1
NC_037334.1,NC_032656.1,8589214,8589215,7753872,TC,T,1
NC_037334.1,NC_032656.1,8601023,8601024,7765680,AT,A,1
NC_037334.1,NC_032656.1,8800200,8800201,7956046,GA,G,1
NC_037334.1,NC_032656.1,8800219,8800220,7956064,TA,T,1
NC_037334.1,NC_032656.1,8802837,8802838,7958759,TA,T,1
NC_037334.1,NC_032656.1,11400845,11400847,9573954,TTA,T,2
NC_037334.1,NC_032656.1,11504835,11504837,9677749,CCA,C,2
NC_037334.1,NC_032656.1,12049076,12049079,10312832,CCCG,C,3
NC_037334.1,NC_032656.1,12062120,12062122,10325874,AAG,A,2
NC_037334.1,NC_032656.1,12062286,12062287,10326025,CA,C,1
NC_037334.1,NC_032656.1,12062290,12062291,10326028,GA,G,1
NC_037334.1,NC_032656.1,12101813,12101814,10365336,AT,A,1
NC_037334.1,NC_032656.1,12101830,12101831,10365352,CA,C,1
NC_037334.1,NC_032656.1,12116471,12116472,10380179,GC,G,1
NC_037334.1,NC_032656.1,12289152,12289153,10552514,AC,A,1
NC_037334.1,NC_032656.1,12344487,12344489,10607798,TTG,T,2
NC_037334.1,NC_032656.1,13225326,13225327,11504050,GC,G,1
NC_037334.1,NC_032656.1,13451715,13451716,11805797,TG,T,1
NC_037334.1,NC_032656.1,13452883,13452884,11806967,CA,C,1
NC_037334.1,NC_032656.1,13452989,13452991,11807072,TAC,T,2
NC_037334.1,NC_032656.1,13453639,13453640,11807720,AT,A,1
NC_037334.1,NC_032656.1,13520599,13520600,11866418,TA,T,1
NC_037334.1,NC_032656.1,13520615,13520616,11866433,TA,T,1
NC_037334.1,NC_032656.1,13520673,13520674,11866489,GC,G,1
NC_037334.1,NC_032656.1,13947567,13947568,12331495,CA,C,1
NC_037334.1,NC_032656.1,14278903,14278904,12727885,GA,G,1
NC_037334.1,NC_032656.1,14505094,14505095,12967941,GT,G,1
NC_037334.1,NC_032656.1,14505112,14505113,12967958,CA,C,1
NC_037334.1,NC_032656.1,15183705,15183709,13642356,TCTGA,T,4
NC_037334.1,NC_032656.1,15184666,15184669,13643313,TATG,T,3
NC_037334.1,NC_032656.1,15545659,15545660,13998102,TG,T,1
NC_037334.1,NC_032656.1,15604768,15604769,14057177,AT,A,1
NC_037334.1,NC_032656.1,15624287,15624288,14076694,GC,G,1
NC_037334.1,NC_032656.1,15624346,15624347,14076751,AG,A,1
NC_037334.1,NC_032656.1,15636128,15636129,14088444,GC,G,1
NC_037334.1,NC_032656.1,15897163,15897164,14349093,AT,A,1
NC_037334.1,NC_032656.1,15897179,15897180,14349108,AC,A,1
NC_037334.1,NC_032656.1,16604923,16604924,15056129,CA,C,1
NC_037334.1,NC_032656.1,16608698,16608699,15059908,AC,A,1
NC_037334.1,NC_032656.1,17434591,17434592,15839367,TC,T,1
NC_037334.1,NC_032656.1,17441436,17441437,15846214,AT,A,1
NC_037334.1,NC_032656.1,17574275,17574276,16017557,CA,C,1
NC_037334.1,NC_032656.1,17574287,17574288,16017568,GT,G,1
NC_037334.1,NC_032656.1,17574292,17574293,16017572,GC,G,1
NC_037334.1,NC_032656.1,17865129,17865130,16408668,TA,T,1
NC_037334.1,NC_032656.1,17902694,17902695,16446291,CA,C,1
NC_037334.1,NC_032656.1,18476091,18476092,17041027,AC,A,1
NC_037334.1,NC_032656.1,18476137,18476138,17041071,TC,T,1
NC_037334.1,NC_032656.1,18756277,18756278,17366221,AG,A,1
NC_037334.1,NC_032656.1,18757311,18757312,17367254,AT,A,1
NC_037334.1,NC_032656.1,18769781,18769782,17356918,TA,T,1
NC_037334.1,NC_032656.1,18770151,18770152,17357290,TG,T,1
NC_037334.1,NC_032656.1,18770192,18770193,17357330,TG,T,1
NC_037334.1,NC_032656.1,18770222,18770224,17357360,GGT,G,2
NC_037334.1,NC_032656.1,18770240,18770241,17357376,GA,G,1
NC_037334.1,NC_032656.1,18770320,18770321,17357456,TC,T,1
NC_037334.1,NC_032656.1,18770329,18770330,17357464,CA,C,1
NC_037334.1,NC_032656.1,18770421,18770422,17357556,TA,T,1
NC_037334.1,NC_032656.1,18770520,18770521,17357657,CT,C,1
NC_037334.1,NC_032656.1,18770718,18770719,17357855,CG,C,1
NC_037334.1,NC_032656.1,18770874,18770875,17358010,TG,T,1
NC_037334.1,NC_032656.1,18771534,18771535,17358672,CT,C,1
NC_037334.1,NC_032656.1,18775772,18775773,17362913,AG,A,1
NC_037334.1,NC_032656.1,19151905,19151906,17739181,CT,C,1
NC_037334.1,NC_032656.1,19158012,19158013,17745466,TC,T,1
NC_037334.1,NC_032656.1,19297903,19297904,17897374,TC,T,1
NC_037334.1,NC_032656.1,19297938,19297941,17897408,ACCT,A,3
NC_037334.1,NC_032656.1,19333729,19333730,17933163,AC,A,1
NC_037334.1,NC_032656.1,19462879,19462880,18062163,AC,A,1
NC_037334.1,NC_032656.1,19902190,19902191,18535543,AG,A,1
NC_037334.1,NC_032656.1,19902201,19902202,18535553,AG,A,1
NC_037334.1,NC_032656.1,19902208,19902210,18535559,AAG,A,2
NC_037334.1,NC_032656.1,20089451,20089460,18722430,AGCTCTGGCC,A,9
NC_037334.1,NC_032656.1,20199770,20199771,18831953,AC,A,1
NC_037334.1,NC_032656.1,20205551,20205553,18838073,TTC,T,2
NC_037334.1,NC_032656.1,20475003,20475004,19139329,CA,C,1
NC_037334.1,NC_032656.1,20644870,20644871,19309217,GC,G,1
NC_037334.1,NC_032656.1,20706200,20706201,19369455,CA,C,1
NC_037334.1,NC_032656.1,20794184,20794186,19538686,TTG,T,2
NC_037334.1,NC_032656.1,21254814,21254815,20007691,CG,C,1
NC_037334.1,NC_032656.1,21437243,21437252,20198949,CTTCAGACCT,C,9
NC_037334.1,NC_032656.1,21500793,21500825,20262148,TGGGGGGAGGGGTTCGAGGCGTGGGGAGCTCGG,T,32
NC_037334.1,NC_032656.1,21689999,21690000,20478325,CA,C,1
NC_037334.1,NC_032656.1,21690015,21690016,20478340,TA,T,1
NC_037334.1,NC_032656.1,21690026,21690028,20478350,TTA,T,2
NC_037334.1,NC_032656.1,21690043,21690044,20478365,TC,T,1
NC_037334.1,NC_032656.1,22455507,22455508,21170881,GA,G,1
NC_037334.1,NC_032656.1,22505412,22505413,21220793,AG,A,1
NC_037334.1,NC_032656.1,22571739,22571740,21288113,GA,G,1
NC_037334.1,NC_032656.1,23033874,23033875,21628623,GC,G,1
NC_037334.1,NC_032656.1,23055058,23055059,21649809,TA,T,1
NC_037334.1,NC_032656.1,23085458,23085459,21680208,CG,C,1
NC_037334.1,NC_032656.1,23373856,23373894,21999490,ATGTCTGCAGTTGGCCCTATCTGGTGGGTATTCCTACTT,A,38
NC_037334.1,NC_032656.1,23431754,23431759,22054922,GTCATC,G,5
NC_037334.1,NC_032656.1,23441012,23441017,22064173,ATTGCT,A,5
NC_037334.1,NC_032656.1,23452541,23452542,22082650,GT,G,1
NC_037334.1,NC_032656.1,23510739,23510740,22159313,AG,A,1
NC_037334.1,NC_032656.1,23560740,23560741,22215413,TC,T,1
NC_037334.1,NC_032656.1,23566764,23566765,22221448,TG,T,1
NC_037334.1,NC_032656.1,23599566,23599568,22253947,ATG,A,2
NC_037334.1,NC_032656.1,23723147,23723148,22377769,GT,G,1
NC_037334.1,NC_032656.1,23820104,23820105,22475004,GT,G,1
NC_037334.1,NC_032656.1,23820110,23820111,22475009,TG,T,1
NC_037334.1,NC_032656.1,23849177,23849178,22504076,GT,G,1
NC_037334.1,NC_032656.1,23991457,23991458,22646381,CG,C,1
NC_037334.1,NC_032656.1,24441667,24441669,23132836,AAG,A,2
NC_037334.1,NC_032656.1,24458067,24458068,23149234,AG,A,1
NC_037334.1,NC_032656.1,24458180,24458181,23149343,CA,C,1
NC_037334.1,NC_032656.1,24458192,24458193,23149354,AG,A,1
NC_037334.1,NC_032656.1,24809163,24809164,23504734,TC,T,1
NC_037334.1,NC_032656.1,25017277,25017278,23776224,GT,G,1
NC_037334.1,NC_032656.1,25050129,25050130,23809064,CT,C,1
NC_037334.1,NC_032656.1,25736316,25736317,24691440,TG,T,1
NC_037334.1,NC_032656.1,25738684,25738685,24693808,AG,A,1
NC_037334.1,NC_032656.1,25849578,25849587,24804697,CGACACGTCT,C,9
NC_037334.1,NC_032656.1,25883552,25883553,24838671,CT,C,1
NC_037334.1,NC_032656.1,26373174,26373175,25337017,TA,T,1
NC_037334.1,NC_032656.1,26398227,26398228,25362160,CA,C,1
NC_037334.1,NC_032656.1,26399830,26399832,25363767,CAT,C,2
NC_037334.1,NC_032656.1,26418059,26418060,25382013,GT,G,1
NC_037334.1,NC_032656.1,26474909,26474910,25438992,CT,C,1
NC_037334.1,NC_032656.1,26540572,26540574,25503818,CTT,C,2
NC_037334.1,NC_032656.1,26605713,26605714,25569045,CA,C,1
NC_037334.1,NC_032656.1,26605720,26605721,25569051,GT,G,1
NC_037334.1,NC_032656.1,26708466,26708467,25671807,CT,C,1
NC_037334.1,NC_032656.1,26820293,26820294,25783655,TA,T,1
NC_037334.1,NC_032656.1,26906913,26906917,25870225,CTAAT,C,4
NC_037334.1,NC_032656.1,27003380,27003381,25970121,CA,C,1
NC_037334.1,NC_032656.1,27072146,27072147,26039032,CT,C,1
NC_037334.1,NC_032656.1,27292696,27292697,26206750,CA,C,1
NC_037334.1,NC_032656.1,27297794,27297795,26211867,TA,T,1
NC_037334.1,NC_032656.1,27641519,27641520,26484625,TC,T,1
NC_037334.1,NC_032656.1,27645274,27645276,26488379,ACT,A,2
NC_037334.1,NC_032656.1,27752039,27752040,26595149,CA,C,1
NC_037334.1,NC_032656.1,27927842,27927843,26771327,GC,G,1
NC_037334.1,NC_032656.1,27957506,27957507,26800851,GA,G,1
NC_037334.1,NC_032656.1,28059317,28059318,26909528,CA,C,1
NC_037334.1,NC_032656.1,28147043,28147044,26997456,CA,C,1
NC_037334.1,NC_032656.1,28256372,28256373,27106805,CA,C,1
NC_037334.1,NC_032656.1,28357091,28357092,27223761,TC,T,1
NC_037334.1,NC_032656.1,28371673,28371674,27238344,AC,A,1
NC_037334.1,NC_032656.1,28382734,28382735,27249909,AT,A,1
NC_037334.1,NC_032656.1,28425417,28425447,27292588,TACAGGCCTCAAATGTTTGGCCTTGGAGCAG,T,30
NC_037334.1,NC_032656.1,28509212,28509213,27376612,CG,C,1
NC_037334.1,NC_032656.1,28910272,28910273,27771282,TG,T,1
NC_037334.1,NC_032656.1,28939708,28939712,27800731,ACAAT,A,4
NC_037334.1,NC_032656.1,29364726,29364727,28172895,GT,G,1
NC_037334.1,NC_032656.1,29364742,29364744,28172910,AAG,A,2
NC_037334.1,NC_032656.1,29364753,29364754,28172919,CA,C,1
NC_037334.1,NC_032656.1,29422651,29422653,28230828,CAT,C,2
NC_037334.1,NC_032656.1,29466660,29466669,28313390,TTCCCAAAAA,T,9
NC_037334.1,NC_032656.1,29477773,29477775,28325338,TTA,T,2
NC_037334.1,NC_032656.1,29561772,29561773,28412283,AT,A,1
NC_037334.1,NC_032656.1,29639966,29639967,28490231,AC,A,1
NC_037334.1,NC_032656.1,29642077,29642078,28492341,CT,C,1
NC_037334.1,NC_032656.1,30052963,30052971,28805412,ATGAACATT,A,8
NC_037334.1,NC_032656.1,30120763,30120764,28872001,TC,T,1
NC_037334.1,NC_032656.1,30144174,30144182,28895413,GCAGTCAAT,G,8
NC_037334.1,NC_032656.1,30176292,30176295,28927529,CAAG,C,3
NC_037334.1,NC_032656.1,30404289,30404290,29184096,CT,C,1
NC_037334.1,NC_032656.1,30754535,30754537,29548722,AAG,A,2
NC_037334.1,NC_032656.1,30867675,30867676,29663058,AG,A,1
NC_037334.1,NC_032656.1,31098686,31098687,29855184,GA,G,1
NC_037334.1,NC_032656.1,31107294,31107295,29863635,AT,A,1
NC_037334.1,NC_032656.1,31174909,31174910,29931255,AC,A,1
NC_037334.1,NC_032656.1,31756317,31756318,30514724,TC,T,1
NC_037334.1,NC_032656.1,31840585,31840586,30599757,CA,C,1
NC_037334.1,NC_032656.1,32011517,32011518,30809548,CA,C,1
NC_037334.1,NC_032656.1,32251042,32251043,31061949,AG,A,1
NC_037334.1,NC_032656.1,32295739,32295743,31107533,GTGAA,G,4
NC_037334.1,NC_032656.1,32322198,32322199,31133836,TC,T,1
NC_037334.1,NC_032656.1,32494104,32494105,31305841,GA,G,1
NC_037334.1,NC_032656.1,32494145,32494146,31305881,GC,G,1
NC_037334.1,NC_032656.1,32494159,32494160,31305894,TG,T,1
NC_037334.1,NC_032656.1,32502030,32502031,31313878,GT,G,1
NC_037334.1,NC_032656.1,32515322,32515323,31327240,TG,T,1
NC_037334.1,NC_032656.1,32520279,32520280,31332203,AC,A,1
NC_037334.1,NC_032656.1,32568846,32568847,31383636,AT,A,1
NC_037334.1,NC_032656.1,32569022,32569023,31383810,AT,A,1
NC_037334.1,NC_032656.1,32631557,32631558,31446426,CA,C,1
NC_037334.1,NC_032656.1,32824825,32824827,31639785,GGA,G,2
NC_037334.1,NC_032656.1,32824829,32824830,31639787,CA,C,1
NC_037334.1,NC_032656.1,32825105,32825106,31640062,CA,C,1
NC_037334.1,NC_032656.1,32904234,32904235,31732060,CA,C,1
NC_037334.1,NC_032656.1,33034242,33034249,31959165,CACATGTT,C,7
NC_037334.1,NC_032656.1,33461490,33461493,32582939,TCTG,T,3
NC_037334.1,NC_032656.1,33609467,33609472,32824920,CCAAGA,C,5
NC_037334.1,NC_032656.1,33610934,33610935,32826382,TG,T,1
NC_037334.1,NC_032656.1,33620104,33620105,32835602,CA,C,1
NC_037334.1,NC_032656.1,33695382,33695383,32862205,CG,C,1
NC_037334.1,NC_032656.1,33700144,33700145,32866973,GC,G,1
NC_037334.1,NC_032656.1,33763569,33763570,32933627,TA,T,1
NC_037334.1,NC_032656.1,33819455,33819456,32989421,GT,G,1
NC_037334.1,NC_032656.1,34242513,34242514,33409646,TG,T,1
NC_037334.1,NC_032656.1,34243314,34243315,33410445,CA,C,1
NC_037334.1,NC_032656.1,34344917,34344918,33580030,GT,G,1
NC_037334.1,NC_032656.1,34344931,34344932,33580043,AT,A,1
NC_037334.1,NC_032656.1,34918104,34918105,34111928,TC,T,1
NC_037334.1,NC_032656.1,35412789,35412790,34605645,GT,G,1
NC_037334.1,NC_032656.1,35412796,35412797,34605651,CA,C,1
NC_037334.1,NC_032656.1,35477142,35477144,34669520,GGA,G,2
NC_037334.1,NC_032656.1,35512708,35512710,34706034,CAA,C,2
NC_037334.1,NC_032656.1,35561009,35561020,34754275,ATTGCAGTCATT,A,11
NC_037334.1,NC_032656.1,35741996,35741997,34956793,GC,G,1
NC_037334.1,NC_032656.1,35963069,35963070,35179786,AT,A,1
NC_037334.1,NC_032656.1,36057586,36057587,35278953,AT,A,1
NC_037334.1,NC_032656.1,36161518,36161519,35382687,TA,T,1
NC_037334.1,NC_032656.1,36161531,36161533,35382699,AAT,A,2
NC_037334.1,NC_032656.1,36161572,36161573,35382738,AC,A,1
NC_037334.1,NC_032656.1,36581092,36581093,35801234,AG,A,1
NC_037334.1,NC_032656.1,36700807,36700808,35929899,GA,G,1
NC_037334.1,NC_032656.1,36700908,36700909,35929999,GA,G,1
NC_037334.1,NC_032656.1,36805422,36805423,36049342,GC,G,1
NC_037334.1,NC_032656.1,36826255,36826257,36070174,GGA,G,2
NC_037334.1,NC_032656.1,36836487,36836489,36080402,TAA,T,2
NC_037334.1,NC_032656.1,37202861,37202862,36562759,CT,C,1
NC_037334.1,NC_032656.1,37203456,37203457,36563353,GT,G,1
NC_037334.1,NC_032656.1,37450906,37450908,36803580,TTA,T,2
NC_037334.1,NC_032656.1,37512914,37512915,36866393,GA,G,1
NC_037334.1,NC_032656.1,37617967,37617968,36968838,TA,T,1
NC_037334.1,NC_032656.1,37644592,37644593,36995476,CT,C,1
NC_037334.1,NC_032656.1,37644608,37644609,36995491,CA,C,1
NC_037334.1,NC_032656.1,37644614,37644615,36995496,AT,A,1
NC_037334.1,NC_032656.1,37745589,37745591,37096509,ATG,A,2
NC_037334.1,NC_032656.1,37799821,37799822,37151602,GT,G,1
NC_037334.1,NC_032656.1,37816170,37816171,37168025,AC,A,1
NC_037334.1,NC_032656.1,37816185,37816186,37168039,TG,T,1
NC_037334.1,NC_032656.1,38335309,38335310,37666333,AC,A,1
NC_037334.1,NC_032656.1,38809649,38809651,38150564,AAT,A,2
NC_037334.1,NC_032656.1,38809678,38809679,38150590,AT,A,1
NC_037334.1,NC_032656.1,38809689,38809691,38150600,AAC,A,2
NC_037334.1,NC_032656.1,38811853,38811854,38152742,TA,T,1
NC_037334.1,NC_032656.1,38811891,38811893,38152778,AAT,A,2
NC_037334.1,NC_032656.1,38814879,38814880,38155763,TC,T,1
NC_037334.1,NC_032656.1,38897997,38897999,38238888,GGA,G,2
NC_037334.1,NC_032656.1,38999571,38999572,38340820,CA,C,1
NC_037334.1,NC_032656.1,39086402,39086404,38427499,GGA,G,2
NC_037334.1,NC_032656.1,39344043,39344044,38690930,GC,G,1
NC_037334.1,NC_032656.1,39542146,39542147,38887770,AC,A,1
NC_037334.1,NC_032656.1,39591865,39591866,38933970,AG,A,1
NC_037334.1,NC_032656.1,40135758,40135759,39460808,CT,C,1
NC_037334.1,NC_032656.1,40210257,40210258,39527145,TC,T,1
NC_037334.1,NC_032656.1,40300194,40300250,39677836,CTGTGTTTTCTACTGGACATAAATCTACAAGTTAACATGGAACTTCACAGGGCCTGG,C,56
NC_037334.1,NC_032656.1,40353512,40353523,39731407,CCGGGCCCTCCT,C,11
NC_037334.1,NC_032656.1,40369399,40369400,39747277,GC,G,1
NC_037334.1,NC_032656.1,40369424,40369425,39747301,TA,T,1
NC_037334.1,NC_032656.1,40501169,40501170,39886585,TG,T,1
NC_037334.1,NC_032656.1,40563907,40563909,39935841,CCT,C,2
NC_037334.1,NC_032656.1,40564679,40564680,39936445,CT,C,1
NC_037334.1,NC_032656.1,40903192,40903194,40284660,TTG,T,2
NC_037334.1,NC_032656.1,40903205,40903207,40284671,TTC,T,2
NC_037334.1,NC_032656.1,40925326,40925327,40306796,AT,A,1
NC_037334.1,NC_032656.1,40972160,40972161,40353702,CA,C,1
NC_037334.1,NC_032656.1,41005362,41005366,40384479,ATACT,A,4
NC_037334.1,NC_032656.1,41219334,41219335,40568046,AT,A,1
NC_037334.1,NC_032656.1,41410891,41410892,40729097,AT,A,1
NC_037334.1,NC_032656.1,41417054,41417055,40794405,CT,C,1
NC_037334.1,NC_032656.1,41425638,41425639,40802988,TG,T,1
NC_037334.1,NC_032656.1,41456776,41456777,40835003,AG,A,1
NC_037334.1,NC_032656.1,41505085,41505086,40883526,AT,A,1
NC_037334.1,NC_032656.1,41505698,41505702,40884139,AATCT,A,4
NC_037334.1,NC_032656.1,41506088,41506089,40884525,TC,T,1
NC_037334.1,NC_032656.1,41520317,41520318,40898785,TA,T,1
NC_037334.1,NC_032656.1,41529048,41529049,40777501,TG,T,1
NC_037334.1,NC_032656.1,41532947,41532948,40773624,AC,A,1
NC_037334.1,NC_032656.1,41547845,41547846,40758269,AT,A,1
NC_037334.1,NC_032656.1,41547845,41547846,40926103,AT,A,1
NC_037334.1,NC_032656.1,41547996,41547998,40758118,CAA,C,2
NC_037334.1,NC_032656.1,41547996,41547998,40926254,CAA,C,2
NC_037334.1,NC_032656.1,41807566,41807568,41187733,CTA,C,2
NC_037334.1,NC_032656.1,41982525,41982526,41384271,TG,T,1
NC_037334.1,NC_032656.1,42050785,42050786,41452732,GT,G,1
NC_037334.1,NC_032656.1,42131489,42131490,41530319,GC,G,1
NC_037334.1,NC_032656.1,42131748,42131749,41530577,CA,C,1
NC_037334.1,NC_032656.1,42131964,42131965,41530791,GT,G,1
NC_037334.1,NC_032656.1,42131969,42131970,41530795,TA,T,1
NC_037334.1,NC_032656.1,42150168,42150169,41548684,AC,A,1
NC_037334.1,NC_032656.1,42151012,42151013,41549529,CT,C,1
NC_037334.1,NC_032656.1,42151027,42151028,41549543,TA,T,1
NC_037334.1,NC_032656.1,42151036,42151038,41549551,AAC,A,2
NC_037334.1,NC_032656.1,42153802,42153803,41552250,TC,T,1
NC_037334.1,NC_032656.1,42175404,42175405,41572822,GC,G,1
NC_037334.1,NC_032656.1,42446344,42446345,41842606,GA,G,1
NC_037334.1,NC_032656.1,43084883,43084884,42240151,GA,G,1
NC_037334.1,NC_032656.1,43087706,43087707,42242973,CT,C,1
NC_037334.1,NC_032656.1,43146449,43146450,42302222,GA,G,1
NC_037334.1,NC_032656.1,43176784,43176785,42332558,GT,G,1
NC_037334.1,NC_032656.1,43307577,43307578,42463812,AT,A,1
NC_037334.1,NC_032656.1,43465105,43465106,42520450,AC,A,1
NC_037334.1,NC_032656.1,43568460,43568461,42623982,GA,G,1
NC_037334.1,NC_032656.1,43568463,43568464,42623984,TG,T,1
NC_037334.1,NC_032656.1,43792359,43792361,42847045,AAC,A,2
NC_037334.1,NC_032656.1,43792371,43792372,42847055,AC,A,1
NC_037334.1,NC_032656.1,43792438,43792439,42847120,TG,T,1
NC_037334.1,NC_032656.1,43792447,43792448,42847128,AG,A,1
NC_037334.1,NC_032656.1,44114668,44114669,43795016,AG,A,1
NC_037334.1,NC_032656.1,44121144,44121145,43801485,AG,A,1
NC_037334.1,NC_032656.1,44121149,44121150,43801489,AC,A,1
NC_037334.1,NC_032656.1,44121155,44121156,43801494,AG,A,1
NC_037334.1,NC_032656.1,44548101,44548103,44227780,CTT,C,2
NC_037334.1,NC_032656.1,44578925,44578926,44261906,TG,T,1
NC_037334.1,NC_032656.1,44684075,44684081,44367022,AGGATTG,A,6
NC_037334.1,NC_032656.1,44684075,44684081,43714455,AGGATTG,A,6
NC_037334.1,NC_032656.1,44724039,44724042,43580051,AGTT,A,3
NC_037334.1,NC_032656.1,44732371,44732375,43588443,ACTGT,A,4
NC_037334.1,NC_032656.1,44878044,44878045,43168324,TG,T,1
NC_037334.1,NC_032656.1,44904422,44904423,43194569,TG,T,1
NC_037334.1,NC_032656.1,44905020,44905029,43195042,TTCCGCCTTG,T,9
NC_037334.1,NC_032656.1,44907900,44907901,43197909,AC,A,1
NC_037334.1,NC_032656.1,44907911,44907912,43197919,GC,G,1
NC_037334.1,NC_032656.1,44947632,44947633,43237635,GC,G,1
NC_037334.1,NC_032656.1,44974502,44974503,43264505,AG,A,1
NC_037334.1,NC_032656.1,45040866,45040868,43330892,TTC,T,2
NC_037334.1,NC_032656.1,45089329,45089332,43378580,TCCC,T,3
NC_037334.1,NC_032656.1,45249166,45249167,43540769,AG,A,1
NC_037334.1,NC_032656.1,45451080,45451081,44589395,GA,G,1
NC_037334.1,NC_032656.1,45451750,45451751,44590065,GC,G,1
NC_037334.1,NC_032656.1,45512492,45512493,44652274,CT,C,1
NC_037334.1,NC_032656.1,45516585,45516586,44656389,AG,A,1
NC_037334.1,NC_032656.1,45517990,45518000,44657927,ACTCTGTCTAT,A,10
NC_037334.1,NC_032656.1,45523722,45523723,44663649,GA,G,1
NC_037334.1,NC_032656.1,45581817,45581818,44721922,CT,C,1
NC_037334.1,NC_032656.1,45640538,45640539,44786983,AT,A,1
NC_037334.1,NC_032656.1,45681857,45681858,44830187,CG,C,1
NC_037334.1,NC_032656.1,45785984,45785986,44934537,GAC,G,2
NC_037334.1,NC_032656.1,46267952,46267953,45427925,AT,A,1
NC_037334.1,NC_032656.1,46434430,46434432,45593689,TTA,T,2
NC_037334.1,NC_032656.1,46438649,46438651,45597908,GTA,G,2
NC_037334.1,NC_032656.1,46490092,46490093,45650169,GA,G,1
NC_037334.1,NC_032656.1,46775814,46775815,45935932,AG,A,1
NC_037334.1,NC_032656.1,46777191,46777192,45937308,AG,A,1
NC_037334.1,NC_032656.1,47139458,47139459,46303960,AT,A,1
NC_037334.1,NC_032656.1,47144785,47144786,46309290,CG,C,1
NC_037334.1,NC_032656.1,47149644,47149645,46314148,AC,A,1
NC_037334.1,NC_032656.1,47247353,47247354,46415621,TC,T,1
NC_037334.1,NC_032656.1,47304384,47304385,46472543,GT,G,1
NC_037334.1,NC_032656.1,47368167,47368168,46536348,AC,A,1
NC_037334.1,NC_032656.1,47368174,47368175,46536354,TA,T,1
NC_037334.1,NC_032656.1,47368231,47368232,46536408,AT,A,1
NC_037334.1,NC_032656.1,47372527,47372528,46540702,TC,T,1
NC_037334.1,NC_032656.1,47767436,47767438,46936245,TTC,T,2
NC_037334.1,NC_032656.1,47767447,47767449,46936254,AAT,A,2
NC_037334.1,NC_032656.1,47767460,47767461,46936265,AT,A,1
NC_037334.1,NC_032656.1,47800871,47800872,46969669,CT,C,1
NC_037334.1,NC_032656.1,47940935,47940936,47110748,CA,C,1
NC_037334.1,NC_032656.1,47940983,47941030,47110795,AACTAGTTTCCATCCGGCTGTCTGAATGATTGTTCCAAAACATAAATC,A,47
NC_037334.1,NC_032656.1,48127064,48127079,47296919,GATTCTAACTAAATGA,G,15
NC_037334.1,NC_032656.1,48127137,48127138,47296977,TG,T,1
NC_037334.1,NC_032656.1,48270544,48270560,47460815,AGATGCACATTCCAGCT,A,16
NC_037334.1,NC_032656.1,48315619,48315620,47505879,GT,G,1
NC_037334.1,NC_032656.1,48484772,48484773,47677388,GA,G,1
NC_037334.1,NC_032656.1,48484787,48484788,47677402,GA,G,1
NC_037334.1,NC_032656.1,48760210,48760211,47952350,TG,T,1
NC_037334.1,NC_032656.1,48760254,48760255,47952393,CT,C,1
NC_037334.1,NC_032656.1,49672190,49672192,48953490,CCT,C,2
NC_037334.1,NC_032656.1,49832688,49832689,49114032,CT,C,1
NC_037334.1,NC_032656.1,49965415,49965416,49247044,GT,G,1
NC_037334.1,NC_032656.1,50823978,50823979,50101843,AT,A,1
NC_037334.1,NC_032656.1,50833216,50833217,50110857,AT,A,1
NC_037334.1,NC_032656.1,50858133,50858135,50136220,AAG,A,2
NC_037334.1,NC_032656.1,50858147,50858148,50136232,CA,C,1
NC_037334.1,NC_032656.1,50858151,50858152,50136235,AG,A,1
NC_037334.1,NC_032656.1,50863880,50863881,50141962,TA,T,1
NC_037334.1,NC_032656.1,50864124,50864125,50142366,AC,A,1
NC_037334.1,NC_032656.1,51012436,51012438,50289360,CCT,C,2
NC_037334.1,NC_032656.1,51012462,51012463,50289384,GA,G,1
NC_037334.1,NC_032656.1,51700979,51700980,50987707,AT,A,1
NC_037334.1,NC_032656.1,51703651,51703652,50990367,GA,G,1
NC_037334.1,NC_032656.1,52055294,52055295,51455744,TG,T,1
NC_037334.1,NC_032656.1,52233811,52233812,51634286,GA,G,1
NC_037334.1,NC_032656.1,52239803,52239805,51640399,CCA,C,2
NC_037334.1,NC_032656.1,52239836,52239837,51640430,AT,A,1
NC_037334.1,NC_032656.1,52239869,52239870,51640462,AT,A,1
NC_037334.1,NC_032656.1,52349080,52349081,51748461,AG,A,1
NC_037334.1,NC_032656.1,52543900,52543901,51941561,TG,T,1
NC_037334.1,NC_032656.1,52562770,52562771,51960428,GC,G,1
NC_037334.1,NC_032656.1,52562817,52562818,51960474,TC,T,1
NC_037334.1,NC_032656.1,52763428,52763429,52161329,CA,C,1
NC_037334.1,NC_032656.1,52839382,52839384,52239344,TTA,T,2
NC_037334.1,NC_032656.1,52842964,52842965,52242923,AG,A,1
NC_037334.1,NC_032656.1,53459991,53459992,52902597,GT,G,1
NC_037334.1,NC_032656.1,54141046,54141047,53591018,GA,G,1
NC_037334.1,NC_032656.1,54265672,54265673,53751223,TA,T,1
NC_037334.1,NC_032656.1,54296817,54296818,53782364,CT,C,1
NC_037334.1,NC_032656.1,54568769,54568770,54055731,TG,T,1
NC_037334.1,NC_032656.1,55084410,55084411,54578284,AG,A,1
NC_037334.1,NC_032656.1,55811171,55811172,55451436,GT,G,1
NC_037334.1,NC_032656.1,55964456,55964457,55603992,AT,A,1
NC_037334.1,NC_032656.1,56006058,56006063,55645638,GCAGAC,G,5
NC_037334.1,NC_032656.1,56400089,56400090,56240009,CT,C,1
NC_037334.1,NC_032656.1,56623121,56623122,56543761,AG,A,1
NC_037334.1,NC_032656.1,56926445,56926446,56795049,AC,A,1
NC_037334.1,NC_032656.1,57181010,57181011,57088280,TC,T,1
NC_037334.1,NC_032656.1,57181030,57181031,57088299,TA,T,1
NC_037334.1,NC_032656.1,57182487,57182488,57089755,AC,A,1
NC_037334.1,NC_032656.1,57670412,57670416,57588574,CAATT,C,4
NC_037334.1,NC_032656.1,58103818,58103825,58064740,AAATACTG,A,7
NC_037334.1,NC_032656.1,58116418,58116419,58077392,CT,C,1
NC_037334.1,NC_032656.1,58116423,58116424,58077396,AG,A,1
NC_037334.1,NC_032656.1,58116437,58116438,58077409,GT,G,1
NC_037334.1,NC_032656.1,59654586,59654587,58322840,CA,C,1
NC_037334.1,NC_032656.1,59654586,59654587,58512763,CA,C,1
NC_037334.1,NC_032656.1,60104746,60104747,59410448,AG,A,1
NC_037334.1,NC_032656.1,60104872,60104873,59410573,TG,T,1
NC_037334.1,NC_032656.1,60156575,60156576,59460444,GC,G,1
NC_037334.1,NC_032656.1,60222793,60222794,59541360,GT,G,1
NC_037334.1,NC_032656.1,60229188,60229189,59549630,AG,A,1
NC_037334.1,NC_032656.1,60574275,60574277,59900932,AAG,A,2
NC_037334.1,NC_032656.1,60574288,60574289,59900943,TG,T,1
NC_037334.1,NC_032656.1,60574319,60574320,59900972,TC,T,1
NC_037334.1,NC_032656.1,60574394,60574395,59901045,CA,C,1
NC_037334.1,NC_032656.1,60825269,60825270,60152433,GT,G,1
NC_037334.1,NC_032656.1,60973504,60973511,60301071,ATCCTGGG,A,7
NC_037334.1,NC_032656.1,61144591,61144594,60475267,CATA,C,3
NC_037334.1,NC_032656.1,61153393,61153395,60484070,CGG,C,2
NC_037334.1,NC_032656.1,61178157,61178158,60508815,TG,T,1
NC_037334.1,NC_032656.1,61178163,61178164,60508820,GT,G,1
NC_037334.1,NC_032656.1,61178183,61178184,60508839,GC,G,1
NC_037334.1,NC_032656.1,61194470,61194471,60525129,GA,G,1
NC_037334.1,NC_032656.1,61239289,61239290,60579513,AG,A,1
NC_037334.1,NC_032656.1,61354547,61354549,60694070,ACT,A,2
NC_037334.1,NC_032656.1,61397427,61397428,60736955,CG,C,1
NC_037334.1,NC_032656.1,61592101,61592102,60931092,CA,C,1
NC_037334.1,NC_032656.1,61619439,61619440,60958426,AG,A,1
NC_037334.1,NC_032656.1,61619444,61619445,60958430,AC,A,1
NC_037334.1,NC_032656.1,61619564,61619565,60958544,CT,C,1
NC_037334.1,NC_032656.1,62001645,62001646,61340630,CT,C,1
NC_037334.1,NC_032656.1,62191253,62191254,61677254,CT,C,1
NC_037334.1,NC_032656.1,62250613,62250614,61736868,TC,T,1
NC_037334.1,NC_032656.1,62250623,62250625,61736877,TTC,T,2
NC_037334.1,NC_032656.1,62286907,62286908,61776060,GA,G,1
NC_037334.1,NC_032656.1,62325919,62325920,61815075,CG,C,1
NC_037334.1,NC_032656.1,62368720,62368721,61857893,TA,T,1
NC_037334.1,NC_032656.1,62412168,62412171,61903904,AGAT,A,3
NC_037334.1,NC_032656.1,62459279,62459280,61995202,CA,C,1
NC_037334.1,NC_032656.1,62702565,62702567,62334822,CAT,C,2
NC_037334.1,NC_032656.1,62924008,62924009,62555472,CT,C,1
NC_037334.1,NC_032656.1,63008749,63008750,62643451,GA,G,1
NC_037334.1,NC_032656.1,63030574,63030575,62665271,CA,C,1
NC_037334.1,NC_032656.1,63030595,63030596,62665291,AT,A,1
NC_037334.1,NC_032656.1,63030600,63030602,62665295,CCT,C,2
NC_037334.1,NC_032656.1,63045282,63045289,62679807,ATTTGGTT,A,7
NC_037334.1,NC_032656.1,63093865,63093866,62739163,TC,T,1
NC_037334.1,NC_032656.1,63101170,63101171,62746502,CG,C,1
NC_037334.1,NC_032656.1,63134862,63134863,62784359,TG,T,1
NC_037334.1,NC_032656.1,63159433,63159434,62808962,GT,G,1
NC_037334.1,NC_032656.1,63251805,63251806,62901560,CT,C,1
NC_037334.1,NC_032656.1,63324761,63324762,62971321,TC,T,1
NC_037334.1,NC_032656.1,63394224,63394225,63049069,GC,G,1
NC_037334.1,NC_032656.1,63578571,63578574,63225449,ATGC,A,3
NC_037334.1,NC_032656.1,63681582,63681583,63328422,TG,T,1
NC_037334.1,NC_032656.1,63692969,63692970,63339686,AG,A,1
NC_037334.1,NC_032656.1,63941829,63941835,63587157,AAGTTAG,A,6
NC_037334.1,NC_032656.1,64174491,64174492,63830068,AG,A,1
NC_037334.1,NC_032656.1,64285599,64285601,63944373,AAT,A,2
NC_037334.1,NC_032656.1,64285606,64285607,63944378,TC,T,1
NC_037334.1,NC_032656.1,64299627,64299628,63958304,CG,C,1
NC_037334.1,NC_032656.1,64396564,64396565,64055891,GA,G,1
NC_037334.1,NC_032656.1,64396749,64396751,64056075,AAT,A,2
NC_037334.1,NC_032656.1,64682972,64682973,64359264,AC,A,1
NC_037334.1,NC_032656.1,64775278,64775279,64451755,AT,A,1
NC_037334.1,NC_032656.1,64836548,64836550,64512685,ACC,A,2
NC_037334.1,NC_032656.1,65029670,65029671,64723183,TA,T,1
NC_037334.1,NC_032656.1,65477312,65477313,65166098,CG,C,1
NC_037334.1,NC_032656.1,65509575,65509576,65197922,AG,A,1
NC_037334.1,NC_032656.1,65589186,65589187,65277541,CT,C,1
NC_037334.1,NC_032656.1,65635169,65635170,65316658,CT,C,1
NC_037334.1,NC_032656.1,65997170,65997171,65683613,CA,C,1
NC_037334.1,NC_032656.1,66091853,66091854,65782378,CA,C,1
NC_037334.1,NC_032656.1,66114843,66114844,65805457,GA,G,1
NC_037334.1,NC_032656.1,66423471,66423472,66109035,CA,C,1
NC_037334.1,NC_032656.1,66468308,66468309,66153417,CA,C,1
NC_037334.1,NC_032656.1,66647355,66647356,66324409,AG,A,1
NC_037334.1,NC_032656.1,66656494,66656495,66333551,GT,G,1
NC_037334.1,NC_032656.1,66674682,66674683,66351745,AT,A,1
NC_037334.1,NC_032656.1,66750386,66750387,66428406,CT,C,1
NC_037334.1,NC_032656.1,66771075,66771076,66449095,CA,C,1
NC_037334.1,NC_032656.1,67157751,67157752,66766406,TA,T,1
NC_037334.1,NC_032656.1,67299274,67299275,66907785,TC,T,1
NC_037334.1,NC_032656.1,67417414,67417416,67026686,GCA,G,2
NC_037334.1,NC_032656.1,67417581,67417582,67026852,TG,T,1
NC_037334.1,NC_032656.1,67418798,67418799,67028063,TG,T,1
NC_037334.1,NC_032656.1,67461258,67461259,67070543,TA,T,1
NC_037334.1,NC_032656.1,67595279,67595280,67204687,CT,C,1
NC_037334.1,NC_032656.1,67613875,67613876,67223295,GC,G,1
NC_037334.1,NC_032656.1,68279239,68279240,68032384,GT,G,1
NC_037334.1,NC_032656.1,68279245,68279246,68032389,TG,T,1
NC_037334.1,NC_032656.1,68279251,68279252,68032394,AT,A,1
NC_037334.1,NC_032656.1,68279273,68279275,68032415,TTG,T,2
NC_037334.1,NC_032656.1,68544922,68544925,68370304,AAAG,A,3
NC_037334.1,NC_032656.1,68550346,68550347,68375727,GT,G,1
NC_037334.1,NC_032656.1,68674844,68674845,68385229,CA,C,1
NC_037334.1,NC_032656.1,68763996,68763997,68395992,CA,C,1
NC_037334.1,NC_032656.1,68878931,68878939,68511227,CTGGAAGGT,C,8
NC_037334.1,NC_032656.1,69364279,69364280,68996608,CA,C,1
NC_037334.1,NC_032656.1,69670583,69670584,69313264,TC,T,1
NC_037334.1,NC_032656.1,69732913,69732914,69375616,AC,A,1
NC_037334.1,NC_032656.1,69732976,69732977,69375678,GC,G,1
NC_037334.1,NC_032656.1,69749608,69749609,69392311,TG,T,1
NC_037334.1,NC_032656.1,69851623,69851624,69494321,TA,T,1
NC_037334.1,NC_032656.1,70347416,70347417,70019770,AG,A,1
NC_037334.1,NC_032656.1,70493915,70493916,70166303,GA,G,1
NC_037334.1,NC_032656.1,70493932,70493933,70166319,GA,G,1
NC_037334.1,NC_032656.1,70649996,70649997,70335344,TA,T,1
NC_037334.1,NC_032656.1,70650004,70650005,70335351,AG,A,1
NC_037334.1,NC_032656.1,70905079,70905080,70590557,AC,A,1
NC_037334.1,NC_032656.1,71479381,71479382,71166543,GC,G,1
NC_037334.1,NC_032656.1,71667539,71667541,71354269,CCT,C,2
NC_037334.1,NC_032656.1,71782549,71782566,71469600,ACCAAACTTGGTGGTCTC,A,17
NC_037334.1,NC_032656.1,71783873,71783874,71470909,AT,A,1
NC_037334.1,NC_032656.1,71793074,71793075,71480129,GA,G,1
NC_037334.1,NC_032656.1,71978891,71978892,71714544,AT,A,1
NC_037334.1,NC_032656.1,72026817,72026819,71761303,TTC,T,2
NC_037334.1,NC_032656.1,72216675,72216676,71950005,CT,C,1
NC_037334.1,NC_032656.1,72287255,72287256,72020449,GC,G,1
NC_037334.1,NC_032656.1,72497598,72497599,72230646,TC,T,1
NC_037334.1,NC_032656.1,72501623,72501624,72234673,GA,G,1
NC_037334.1,NC_032656.1,72561962,72561963,72294880,AG,A,1
NC_037334.1,NC_032656.1,72581284,72581285,72314200,AT,A,1
NC_037334.1,NC_032656.1,72589929,72589950,72322570,CTGGGGGTGATAATCTCCCAAT,C,21
NC_037334.1,NC_032656.1,72776321,72776322,72492069,TC,T,1
NC_037334.1,NC_032656.1,72820886,72820887,72582389,CA,C,1
NC_037334.1,NC_032656.1,72910754,72910755,72674689,TG,T,1
NC_037334.1,NC_032656.1,72910765,72910766,72674699,AT,A,1
NC_037334.1,NC_032656.1,73071888,73071889,72834978,TC,T,1
NC_037334.1,NC_032656.1,73583341,73583342,73393617,TA,T,1
NC_037334.1,NC_032656.1,73600501,73600502,73410616,GC,G,1
NC_037334.1,NC_032656.1,74222868,74222870,74071793,CCT,C,2
NC_037334.1,NC_032656.1,74509347,74509348,74453158,CA,C,1
NC_037334.1,NC_032656.1,74595706,74595714,74538789,TGTATGAAG,T,8
NC_037334.1,NC_032656.1,74595716,74595717,74538791,AT,A,1
NC_037334.1,NC_032656.1,74856304,74856305,74883003,GA,G,1
NC_037334.1,NC_032656.1,74861867,74861868,74888594,TG,T,1
NC_037334.1,NC_032656.1,74869514,74869517,74896241,CTTT,C,3
NC_037334.1,NC_032656.1,75023928,75023929,75051358,AC,A,1
NC_037334.1,NC_032656.1,75063731,75063732,75091172,AG,A,1
NC_037334.1,NC_032656.1,75138041,75138043,75166089,ATT,A,2
NC_037334.1,NC_032656.1,75138157,75138158,75166204,GT,G,1
NC_037334.1,NC_032656.1,75138172,75138173,75166218,TA,T,1
NC_037334.1,NC_032656.1,75439115,75439116,75528472,TG,T,1
NC_037334.1,NC_032656.1,75475161,75475162,75565558,TC,T,1
NC_037334.1,NC_032656.1,75477657,75477658,75568053,GC,G,1
NC_037334.1,NC_032656.1,75626682,75626684,75717823,GGT,G,2
NC_037334.1,NC_032656.1,75626695,75626696,75717834,GA,G,1
NC_037334.1,NC_032656.1,75642339,75642343,75733484,CACTG,C,4
NC_037334.1,NC_032656.1,75820961,75820966,75912126,ATGGTG,A,5
NC_037334.1,NC_032656.1,76422817,76422824,76517544,GGAGCCAC,G,7
NC_037334.1,NC_032656.1,76428026,76428031,76522692,TCCTCA,T,5
NC_037334.1,NC_032656.1,76442002,76442003,76537500,CA,C,1
NC_037334.1,NC_032656.1,76442002,76442003,76748517,CA,C,1
NC_037334.1,NC_032656.1,76445431,76445432,76540930,AC,A,1
NC_037334.1,NC_032656.1,76484952,76484953,76792075,AC,A,1
NC_037334.1,NC_032656.1,76484952,76484953,76581767,AC,A,1
NC_037334.1,NC_032656.1,76521333,76521334,76612248,CT,C,1
NC_037334.1,NC_032656.1,76692239,76692240,77380560,GA,G,1
NC_037334.1,NC_032656.1,76694144,76694145,77382463,AT,A,1
NC_037334.1,NC_032656.1,76765317,76765319,77453676,TTA,T,2
NC_037334.1,NC_032656.1,76765323,76765324,77453680,GA,G,1
NC_037334.1,NC_032656.1,76778923,76778924,77468248,TC,T,1
NC_037334.1,NC_032656.1,76881357,76881358,77586214,TG,T,1
NC_037334.1,NC_032656.1,76898542,76898543,77603871,CA,C,1
NC_037334.1,NC_032656.1,76905615,76905624,77610947,CCAACGGCCA,C,9
NC_037334.1,NC_032656.1,76908128,76908129,77613459,GC,G,1
NC_037334.1,NC_032656.1,76939457,76939458,77641771,CT,C,1
NC_037334.1,NC_032656.1,77064441,77064442,77786408,GA,G,1
NC_037334.1,NC_032656.1,77232525,77232526,77961850,CA,C,1
NC_037334.1,NC_032656.1,77281880,77281882,78011229,TAA,T,2
NC_037334.1,NC_032656.1,77380248,77380249,78134995,GT,G,1
NC_037334.1,NC_032656.1,77449294,77449315,78204086,TAAGATGGCAGGGAAGGGGGTG,T,21
NC_037334.1,NC_032656.1,77612465,77612466,78367344,AC,A,1
NC_037334.1,NC_032656.1,77614063,77614064,78368944,CA,C,1
NC_037334.1,NC_032656.1,77826704,77826708,78496919,CCAGT,C,4
NC_037334.1,NC_032656.1,77844111,77844112,78514325,CA,C,1
NC_037334.1,NC_032656.1,77844134,77844135,78514347,CA,C,1
NC_037334.1,NC_032656.1,77844144,77844145,78514356,GA,G,1
NC_037334.1,NC_032656.1,77899721,77899722,78572469,AT,A,1
NC_037334.1,NC_032656.1,78165034,78165035,78844679,TA,T,1
NC_037334.1,NC_032656.1,78411058,78411059,79095182,TA,T,1
NC_037334.1,NC_032656.1,78549054,78549055,79248247,TA,T,1
NC_037334.1,NC_032656.1,78549061,78549062,79248253,GA,G,1
NC_037334.1,NC_032656.1,78868460,78868462,79567540,TTC,T,2
NC_037334.1,NC_032656.1,79194670,79194671,79894344,CA,C,1
NC_037334.1,NC_032656.1,79383633,79383634,80081762,GA,G,1
NC_037334.1,NC_032656.1,79383643,79383708,80081771,ACCTAATACATCCCCATGCATCCTTCAAGGACCTATAAAACTCTCGTATTTCTCTGTAGTTCTTTT,A,65
NC_037334.1,NC_032656.1,79441395,79441396,80139473,CA,C,1
NC_037334.1,NC_032656.1,79492206,79492207,80190245,TG,T,1
NC_037334.1,NC_032656.1,79492213,79492214,80190251,GA,G,1
NC_037334.1,NC_032656.1,79534211,79534213,80232277,TCA,T,2
NC_037334.1,NC_032656.1,79771005,79771006,80469550,TG,T,1
NC_037334.1,NC_032656.1,80019544,80019545,80718137,AG,A,1
NC_037334.1,NC_032656.1,80083521,80083522,80781787,TG,T,1
NC_037334.1,NC_032656.1,80086911,80086912,80785174,GT,G,1
NC_037334.1,NC_032656.1,80138515,80138516,80836836,TA,T,1
NC_037334.1,NC_032656.1,80138622,80138623,80836941,TG,T,1
NC_037334.1,NC_032656.1,80493149,80493150,81243900,CA,C,1
NC_037334.1,NC_032656.1,80554846,80554847,81305629,GA,G,1
NC_037334.1,NC_032656.1,80682544,80682545,81442637,GC,G,1
NC_037334.1,NC_032656.1,80682754,80682755,81442846,AG,A,1
NC_037334.1,NC_032656.1,80684365,80684380,81444457,GAAGACAGATGCTGAC,G,15
NC_037334.1,NC_032656.1,80691466,80691467,81451545,CA,C,1
NC_037334.1,NC_032656.1,80692566,80692567,81452666,TG,T,1
NC_037334.1,NC_032656.1,80695588,80695589,81455686,CT,C,1
NC_037334.1,NC_032656.1,81012097,81012098,81803322,GT,G,1
NC_037334.1,NC_032656.1,81019861,81019863,81811082,TTG,T,2
NC_037334.1,NC_032656.1,81179373,81179376,82015378,TCTC,T,3
NC_037334.1,NC_032656.1,81285485,81285486,82123701,TA,T,1
NC_037334.1,NC_032656.1,81370684,81370685,82208882,GA,G,1
NC_037334.1,NC_032656.1,81964812,81964813,82817998,CT,C,1
NC_037334.1,NC_032656.1,81983250,81983251,82836425,GT,G,1
NC_037334.1,NC_032656.1,82624457,82624461,83482596,CCAAT,C,4
NC_037334.1,NC_032656.1,83336470,83336472,84271137,CTG,C,2
NC_037334.1,NC_032656.1,83926933,83926934,84868994,AG,A,1
NC_037334.1,NC_032656.1,84147521,84147522,85087935,AC,A,1
NC_037334.1,NC_032656.1,84158265,84158268,85098679,CCTT,C,3
NC_037334.1,NC_032656.1,84234350,84234351,85177196,CT,C,1
NC_037334.1,NC_032656.1,84492887,84492888,85475014,CT,C,1
NC_037334.1,NC_032656.1,84606110,84606111,85619719,GT,G,1
NC_037334.1,NC_032656.1,84664778,84664779,85680423,CA,C,1
NC_037334.1,NC_032656.1,84664792,84664793,85680436,TA,T,1
NC_037334.1,NC_032656.1,84819771,84819772,85837327,CT,C,1
NC_037334.1,NC_032656.1,84819777,84819778,85837332,CA,C,1
NC_037334.1,NC_032656.1,84819782,84819783,85837336,GC,G,1
NC_037334.1,NC_032656.1,84954645,84954646,85972226,AC,A,1
NC_037334.1,NC_032656.1,85010693,85010694,86027468,AC,A,1
NC_037334.1,NC_032656.1,85112535,85112536,86129663,TA,T,1
NC_037334.1,NC_032656.1,85144238,85144239,86147482,CG,C,1
NC_037334.1,NC_032656.1,85227740,85227741,86247202,AG,A,1
NC_037334.1,NC_032656.1,85305287,85305291,86327246,AAGAG,A,4
NC_037334.1,NC_032656.1,85357151,85357152,86379398,TA,T,1
NC_037334.1,NC_032656.1,85357326,85357328,86379572,CTT,C,2
NC_037334.1,NC_032656.1,85367136,85367137,86389396,AG,A,1
NC_037334.1,NC_032656.1,85367510,85367511,86389768,GA,G,1
NC_037334.1,NC_032656.1,85372861,85372864,86395132,AGTT,A,3
NC_037334.1,NC_032656.1,85380931,85380970,86403166,GAGGACTGATGCTACCCAGTCTCAAGACTTACTACAAAGA,G,39
NC_037334.1,NC_032656.1,85381671,85381673,86403889,CTG,C,2
NC_037334.1,NC_032656.1,85573579,85573580,86600752,AC,A,1
NC_037334.1,NC_032656.1,85597599,85597600,86624810,CT,C,1
NC_037334.1,NC_032656.1,85605527,85605528,86632733,CT,C,1
NC_037334.1,NC_032656.1,85852094,85852095,86880413,TA,T,1
NC_037334.1,NC_032656.1,85957542,85957545,86996907,AGAT,A,3
NC_037334.1,NC_032656.1,85957858,85957860,86997220,CTT,C,2
NC_037334.1,NC_032656.1,85958833,85958837,86998189,ACTCT,A,4
NC_037334.1,NC_032656.1,85967333,85967334,87011375,TA,T,1
NC_037334.1,NC_032656.1,85980345,85980346,87024389,AG,A,1
NC_037334.1,NC_032656.1,86097860,86097862,87142174,AAG,A,2
NC_037334.1,NC_032656.1,86114222,86114223,87158869,GT,G,1
NC_037334.1,NC_032656.1,86248429,86248431,87338832,CTT,C,2
NC_037334.1,NC_032656.1,86289674,86289675,87379719,TA,T,1
NC_037334.1,NC_032656.1,86305977,86305980,87407616,TACA,T,3
NC_037334.1,NC_032656.1,86317006,86317007,87418651,AG,A,1
NC_037334.1,NC_032656.1,86326520,86326521,87428175,AG,A,1
NC_037334.1,NC_032656.1,86326538,86326539,87428192,GA,G,1
NC_037334.1,NC_032656.1,86326806,86326807,87428460,AG,A,1
NC_037334.1,NC_032656.1,86329336,86329337,87430985,TC,T,1
NC_037334.1,NC_032656.1,86378250,86378251,87479835,AG,A,1
NC_037334.1,NC_032656.1,86639336,86639345,87746335,ATTTCAAGAC,A,9
NC_037334.1,NC_032656.1,86784515,86784516,87891538,CT,C,1
NC_037334.1,NC_032656.1,86869500,86869501,87976565,GA,G,1
NC_037334.1,NC_032656.1,86869558,86869560,87976622,TTA,T,2
NC_037334.1,NC_032656.1,87069586,87069587,88177053,CA,C,1
NC_037334.1,NC_032656.1,87237369,87237370,88344920,CA,C,1
NC_037334.1,NC_032656.1,87237419,87237420,88344968,TA,T,1
NC_037334.1,NC_032656.1,87294891,87294892,88401822,CT,C,1
NC_037334.1,NC_032656.1,87354837,87354838,88461773,CA,C,1
NC_037334.1,NC_032656.1,87354848,87354849,88461783,AT,A,1
NC_037334.1,NC_032656.1,87403478,87403479,88510420,GC,G,1
NC_037334.1,NC_032656.1,87463798,87463800,88570727,TAG,T,2
NC_037334.1,NC_032656.1,87471100,87471101,88578025,TA,T,1
NC_037334.1,NC_032656.1,87618232,87618233,88726482,AG,A,1
NC_037334.1,NC_032656.1,87652065,87652066,88760332,GA,G,1
NC_037334.1,NC_032656.1,87652072,87652073,88760338,CA,C,1
NC_037334.1,NC_032656.1,87652082,87652083,88760347,AT,A,1
NC_037334.1,NC_032656.1,87652090,87652091,88760354,GT,G,1
NC_037334.1,NC_032656.1,87661000,87661001,88769263,CT,C,1
NC_037334.1,NC_032656.1,87678743,87678744,88787052,AG,A,1
NC_037334.1,NC_032656.1,87847935,87847936,88958167,GC,G,1
NC_037334.1,NC_032656.1,88243378,88243379,89355182,TC,T,1
NC_037334.1,NC_032656.1,88413953,88413954,89525622,AT,A,1
NC_037334.1,NC_032656.1,88413961,88413962,89525629,CT,C,1
NC_037334.1,NC_032656.1,88501069,88501070,89612628,TG,T,1
NC_037334.1,NC_032656.1,88559717,88559718,89670372,TA,T,1
NC_037334.1,NC_032656.1,88559733,88559734,89670387,AT,A,1
NC_037334.1,NC_032656.1,88571673,88571701,89682326,TTGAGATTAGGGCTGTGGAAGTTCTCAGG,T,28
NC_037334.1,NC_032656.1,88779277,88779278,89889958,CT,C,1
NC_037334.1,NC_032656.1,88779304,88779306,89889984,TTC,T,2
NC_037334.1,NC_032656.1,90233028,90233029,91284151,AC,A,1
NC_037334.1,NC_032656.1,90663367,90663369,91747795,TTA,T,2
NC_037334.1,NC_032656.1,90684667,90684668,91769825,CT,C,1
NC_037334.1,NC_032656.1,90775001,90775002,91860063,GA,G,1
NC_037334.1,NC_032656.1,90775077,90775078,91860134,GT,G,1
NC_037334.1,NC_032656.1,90775086,90775087,91860142,CT,C,1
NC_037334.1,NC_032656.1,91358930,91358931,92483136,TA,T,1
NC_037334.1,NC_032656.1,91759823,91759824,92931587,TA,T,1
NC_037334.1,NC_032656.1,91759947,91759948,92931709,CA,C,1
NC_037334.1,NC_032656.1,92399778,92399779,93565201,GA,G,1
NC_037334.1,NC_032656.1,92563123,92563124,93728729,AT,A,1
NC_037334.1,NC_032656.1,92728609,92728611,93894582,CCA,C,2
NC_037334.1,NC_032656.1,92740209,92740210,93908006,TC,T,1
NC_037334.1,NC_032656.1,93388179,93388180,94595898,CA,C,1
NC_037334.1,NC_032656.1,93388204,93388206,94595922,AAT,A,2
NC_037334.1,NC_032656.1,93660458,93660460,94868189,AAC,A,2
NC_037334.1,NC_032656.1,93660469,93660470,94868198,GT,G,1
NC_037334.1,NC_032656.1,93677474,93677475,94885199,TA,T,1
NC_037334.1,NC_032656.1,93817609,93817611,95024963,TTG,T,2
NC_037334.1,NC_032656.1,94345833,94345861,95565915,AATATACCAGCTTGCTATGAGTTCTTGTG,A,28
NC_037334.1,NC_032656.1,94985677,94985678,96205436,TC,T,1
NC_037334.1,NC_032656.1,94985684,94985685,96205442,GC,G,1
NC_037334.1,NC_032656.1,95463457,95463459,96735058,GGT,G,2
NC_037334.1,NC_032656.1,95463461,95463462,96735060,AT,A,1
NC_037334.1,NC_032656.1,95463468,95463469,96735066,TA,T,1
NC_037334.1,NC_032656.1,95534810,95534811,96809700,CA,C,1
NC_037334.1,NC_032656.1,95534820,95534821,96809709,AG,A,1
NC_037334.1,NC_032656.1,95534828,95534829,96809716,AG,A,1
NC_037334.1,NC_032656.1,95681756,95681774,96956618,GTACCTTCCCCTAGCCCCA,G,18
NC_037334.1,NC_032656.1,95755629,95755632,97031401,AACT,A,3
NC_037334.1,NC_032656.1,96037986,96037988,97313721,AAT,A,2
NC_037334.1,NC_032656.1,96037997,96037998,97313730,CT,C,1
NC_037334.1,NC_032656.1,96038015,96038016,97313747,AT,A,1
NC_037334.1,NC_032656.1,96038021,96038022,97313752,GA,G,1
NC_037334.1,NC_032656.1,96082768,96082771,97359015,ACGT,A,3
NC_037334.1,NC_032656.1,96087999,96088000,97364241,TC,T,1
NC_037334.1,NC_032656.1,96088013,96088014,97364254,TA,T,1
NC_037334.1,NC_032656.1,96088035,96088037,97364275,AAG,A,2
NC_037334.1,NC_032656.1,96088046,96088047,97364284,TG,T,1
NC_037334.1,NC_032656.1,96088057,96088058,97364294,GT,G,1
NC_037334.1,NC_032656.1,96096367,96096368,97372604,AG,A,1
NC_037334.1,NC_032656.1,96132536,96132538,97408105,TAA,T,2
NC_037334.1,NC_032656.1,96540422,96540423,97829992,AG,A,1
NC_037334.1,NC_032656.1,96752212,96752213,98078990,TA,T,1
NC_037334.1,NC_032656.1,96901149,96901150,98224159,CT,C,1
NC_037334.1,NC_032656.1,98792109,98792110,100175450,CT,C,1
NC_037334.1,NC_032656.1,98792129,98792130,100175469,TC,T,1
NC_037334.1,NC_032656.1,99139887,99139888,100527345,GA,G,1
NC_037334.1,NC_032656.1,99873340,99873341,101300784,GA,G,1
NC_037334.1,NC_032656.1,100174135,100174136,101599326,CT,C,1
NC_037334.1,NC_032656.1,100266635,100266636,101692143,TG,T,1
NC_037334.1,NC_032656.1,100337377,100337378,101926803,AG,A,1
NC_037334.1,NC_032656.1,100374125,100374126,101746538,TA,T,1
NC_037334.1,NC_032656.1,101338591,101338592,102942003,TG,T,1
NC_037334.1,NC_032656.1,101440825,101440827,103044290,AAT,A,2
NC_037334.1,NC_032656.1,101440833,101440834,103044296,TA,T,1
NC_037334.1,NC_032656.1,101440845,101440846,103044307,TA,T,1
NC_037334.1,NC_032656.1,101440885,101440886,103044345,AT,A,1
NC_037334.1,NC_032656.1,101443410,101443411,103046638,AT,A,1
NC_037334.1,NC_032656.1,105644176,105644177,107290492,TG,T,1
NC_037334.1,NC_032656.1,105701185,105701186,107384443,TG,T,1
NC_037334.1,NC_032656.1,105770445,105770446,107456942,AC,A,1
NC_037334.1,NC_032656.1,105821425,105821426,107408297,CT,C,1
NC_037334.1,NC_032656.1,106022162,106022163,107677940,TA,T,1
NC_037334.1,NC_032656.1,106146795,106146797,107803177,TTA,T,2
NC_037334.1,NC_032656.1,106328505,106328506,107988938,GC,G,1
NC_037334.1,NC_032656.1,106396827,106396828,108056650,GA,G,1
NC_037334.1,NC_032656.1,106451556,106451557,108110863,GT,G,1
NC_037334.1,NC_032656.1,106478901,106478902,108138223,AG,A,1
NC_037334.1,NC_032656.1,106497708,106497709,108157052,CA,C,1
NC_037334.1,NC_032656.1,106534252,106534253,108193598,CG,C,1
NC_037334.1,NC_032656.1,106588088,106588091,108246626,CATA,C,3
NC_037334.1,NC_032656.1,106591094,106591095,108249631,AG,A,1
NC_037334.1,NC_032656.1,106651731,106651732,108310273,TC,T,1
NC_037334.1,NC_032656.1,106651755,106651756,108310296,AT,A,1
NC_037334.1,NC_032656.1,106720171,106720173,108378508,TAA,T,2
NC_037334.1,NC_032656.1,106779407,106779408,108437742,AG,A,1
NC_037334.1,NC_032656.1,106887419,106887427,108545612,ATGATATGT,A,8
NC_037334.1,NC_032656.1,106926613,106926658,108584823,ATTAGTGAGTTTGGATAAGCAAGGGAGTCTCTCCCTTCCCCACAAC,A,45
NC_037334.1,NC_032656.1,107023502,107023507,108681403,AAGGTC,A,5
NC_037334.1,NC_032656.1,107049178,107049179,108707083,TG,T,1
NC_037334.1,NC_032656.1,107050555,107050563,108708463,CAACACGAT,C,8
NC_037334.1,NC_032656.1,107056046,107056069,108716195,AGGGGCTGGAGGGGACATGGCGGG,A,23
NC_037334.1,NC_032656.1,107056549,107056550,108716674,CT,C,1
NC_037334.1,NC_032656.1,107065517,107065518,108725644,CA,C,1
NC_037334.1,NC_032656.1,107082490,107082491,108742710,TC,T,1
NC_037334.1,NC_032656.1,107431714,107431718,109180420,AAGCC,A,4
NC_037334.1,NC_032656.1,107707211,107707220,109455111,AAGACTCGGC,A,9
NC_037334.1,NC_032656.1,107941617,107941619,109792085,TGC,T,2
NC_037334.1,NC_032656.1,108009374,108009375,109859831,GT,G,1
NC_037334.1,NC_032656.1,108011198,108011199,109861655,CA,C,1
NC_037334.1,NC_032656.1,108011311,108011312,109861766,TC,T,1
NC_037334.1,NC_032656.1,108011319,108011320,109861773,TG,T,1
NC_037334.1,NC_032656.1,108011339,108011340,109861792,GA,G,1
NC_037334.1,NC_032656.1,108011353,108011354,109861805,CT,C,1
NC_037334.1,NC_032656.1,108011367,108011368,109861818,CT,C,1
NC_037334.1,NC_032656.1,108047893,108047895,109898338,CAG,C,2
NC_037334.1,NC_032656.1,108072183,108072184,109922622,CT,C,1
NC_037334.1,NC_032656.1,108080177,108080178,109930621,TC,T,1
NC_037334.1,NC_032656.1,108112030,108112031,109979487,AT,A,1
NC_037334.1,NC_032656.1,108120559,108120560,109988014,TC,T,1
NC_037334.1,NC_032656.1,108172610,108172611,110039922,GA,G,1
NC_037334.1,NC_032656.1,108172654,108172663,110039965,GGTACCCTGT,G,9
NC_037334.1,NC_032656.1,108264478,108264479,110131534,GC,G,1
NC_037334.1,NC_032656.1,108430329,108430330,110312273,AG,A,1
NC_037334.1,NC_032656.1,108479831,108479832,110361508,CT,C,1
NC_037334.1,NC_032656.1,108493844,108493845,110375521,CA,C,1
NC_037334.1,NC_032656.1,108581464,108581465,110463188,CT,C,1
NC_037334.1,NC_032656.1,108679056,108679057,110563077,GC,G,1
NC_037334.1,NC_032656.1,108823432,108823433,110708046,GC,G,1
NC_037334.1,NC_032656.1,108855661,108855662,110740276,AT,A,1
NC_037334.1,NC_032656.1,108858034,108858062,110742649,GCTGTTAGGACTTCAACGTATGCATTTCA,G,28
NC_037334.1,NC_032656.1,108949836,108949837,110834444,CG,C,1
NC_037334.1,NC_032656.1,109004088,109004089,110888719,GC,G,1
NC_037334.1,NC_032656.1,109122524,109122525,111008169,TG,T,1
NC_037334.1,NC_032656.1,109125468,109125469,111011109,CA,C,1
NC_037334.1,NC_032656.1,109126056,109126057,111011696,AT,A,1
NC_037334.1,NC_032656.1,109137584,109137585,111023067,TA,T,1
NC_037334.1,NC_032656.1,109312612,109312625,111198748,AGGAGGGTTATATT,A,13
NC_037334.1,NC_032656.1,109394558,109394559,111280072,CA,C,1
NC_037334.1,NC_032656.1,109475753,109475754,111361224,AC,A,1
NC_037334.1,NC_032656.1,109475760,109475761,111361230,AT,A,1
NC_037334.1,NC_032656.1,109475778,109475779,111361247,TC,T,1
NC_037334.1,NC_032656.1,109667323,109667324,111575545,GA,G,1
NC_037334.1,NC_032656.1,109695762,109695763,111603987,AT,A,1
NC_037334.1,NC_032656.1,109696437,109696438,111604639,CA,C,1
