Reference ID,Query ID,Reference POS,Query POS,Query END,REF,ALT,SVLEN
NC_037330.1,NC_032652.1,1068,492269,492270,t,tc,1
NC_037330.1,NC_032652.1,1243,492441,492442,G,GA,1
NC_037330.1,NC_032652.1,1320,492519,492520,a,ag,1
NC_037330.1,NC_032652.1,1891,493089,493090,A,AG,1
NC_037330.1,NC_032652.1,1896,493095,493096,T,TC,1
NC_037330.1,NC_032652.1,66658,588397,588398,a,ac,1
NC_037330.1,NC_032652.1,71460,593200,593201,C,CG,1
NC_037330.1,NC_032652.1,129992,651987,651990,G,GAAA,3
NC_037330.1,NC_032652.1,192209,714208,714209,G,GC,1
NC_037330.1,NC_032652.1,389026,941455,941457,a,aNN,2
NC_037330.1,NC_032652.1,403781,956388,956389,g,ga,1
NC_037330.1,NC_032652.1,403792,956400,956401,t,ta,1
NC_037330.1,NC_032652.1,467336,1019955,1019956,T,TY,1
NC_037330.1,NC_032652.1,549164,1099754,1099755,C,CG,1
NC_037330.1,NC_032652.1,802923,1353487,1353488,g,gc,1
NC_037330.1,NC_032652.1,1095296,1657513,1657514,a,ag,1
NC_037330.1,NC_032652.1,1352819,1920412,1920413,t,ta,1
NC_037330.1,NC_032652.1,1370027,1937691,1937692,C,CT,1
NC_037330.1,NC_032652.1,1599699,2194462,2194466,C,CCAGT,4
NC_037330.1,NC_032652.1,1684250,2279230,2279231,a,at,1
NC_037330.1,NC_032652.1,1743835,2333699,2333704,a,atgttt,5
NC_037330.1,NC_032652.1,1743891,2333760,2333762,c,ctg,2
NC_037330.1,NC_032652.1,1743988,2333859,2333860,a,ag,1
NC_037330.1,NC_032652.1,1762523,2352396,2352398,t,ttg,2
NC_037330.1,NC_032652.1,1878551,2468429,2468430,c,ct,1
NC_037330.1,NC_032652.1,1933365,2523163,2523164,t,tc,1
NC_037330.1,NC_032652.1,2083392,2673807,2673808,G,GC,1
NC_037330.1,NC_032652.1,2091978,2682394,2682396,a,aNN,2
NC_037330.1,NC_032652.1,2170162,2761680,2761682,t,taa,2
NC_037330.1,NC_032652.1,2327718,2995264,2995265,g,gc,1
NC_037330.1,NC_032652.1,2328195,2995742,2995746,a,agaat,4
NC_037330.1,NC_032652.1,2402210,3069763,3069764,g,gc,1
NC_037330.1,NC_032652.1,2408526,3076080,3076081,a,at,1
NC_037330.1,NC_032652.1,2447198,3116277,3116283,a,atatatg,6
NC_037330.1,NC_032652.1,2453367,3122452,3122457,a,aaaaag,5
NC_037330.1,NC_032652.1,2496252,3223709,3223710,C,CA,1
NC_037330.1,NC_032652.1,2766636,3493250,3493255,t,tgcaag,5
NC_037330.1,NC_032652.1,2816788,3543406,3543407,G,GR,1
NC_037330.1,NC_032652.1,2820934,3547554,3547555,T,TC,1
NC_037330.1,NC_032652.1,2870472,3597093,3597094,A,AM,1
NC_037330.1,NC_032652.1,2885224,3611788,3611789,C,CA,1
NC_037330.1,NC_032652.1,2925294,3651859,3651866,g,ggaggagt,7
NC_037330.1,NC_032652.1,3120181,3846583,3846584,g,gc,1
NC_037330.1,NC_032652.1,3122050,3848453,3848454,t,tc,1
NC_037330.1,NC_032652.1,3122104,3848508,3848509,c,ct,1
NC_037330.1,NC_032652.1,3123225,3849629,3849630,G,GT,1
NC_037330.1,NC_032652.1,3123580,3849985,3849986,A,AT,1
NC_037330.1,NC_032652.1,3124038,3850440,3850441,t,tY,1
NC_037330.1,NC_032652.1,3124055,3850458,3850459,a,at,1
NC_037330.1,NC_032652.1,3124269,3850669,3850670,A,AT,1
NC_037330.1,NC_032652.1,3124373,3850773,3850774,g,ga,1
NC_037330.1,NC_032652.1,3124476,3850876,3850877,C,CA,1
NC_037330.1,NC_032652.1,3144220,3841317,3841318,C,CT,1
NC_037330.1,NC_032652.1,3147228,3844321,3844322,t,tg,1
NC_037330.1,NC_032652.1,3237405,3934974,3934975,t,ta,1
NC_037330.1,NC_032652.1,3440401,4137974,4138000,G,GAGAGAGATCATAGAGAGAGAGAATCA,26
NC_037330.1,NC_032652.1,3485484,4183050,4183051,a,at,1
NC_037330.1,NC_032652.1,3506848,4204415,4204417,G,GTT,2
NC_037330.1,NC_032652.1,3507089,4204658,4204659,G,GT,1
NC_037330.1,NC_032652.1,3512459,4210001,4210002,G,GT,1
NC_037330.1,NC_032652.1,3514651,4212192,4212196,t,ttaaa,4
NC_037330.1,NC_032652.1,3525551,4223099,4223102,t,ttgg,3
NC_037330.1,NC_032652.1,3553744,4251291,4251292,t,tg,1
NC_037330.1,NC_032652.1,3555338,4252891,4252892,C,CS,1
NC_037330.1,NC_032652.1,3721536,4429474,4429475,A,AT,1
NC_037330.1,NC_032652.1,3730015,4437954,4437975,A,ANNNNNNNNNNNNNNNNNNNNN,21
NC_037330.1,NC_032652.1,3793764,4500770,4500771,t,tg,1
NC_037330.1,NC_032652.1,3805277,4512284,4512285,C,CT,1
NC_037330.1,NC_032652.1,3807805,4514813,4514814,c,ct,1
NC_037330.1,NC_032652.1,3824399,4531417,4531418,G,GS,1
NC_037330.1,NC_032652.1,3824430,4531449,4531450,G,GA,1
NC_037330.1,NC_032652.1,3900897,4650001,4650002,c,ct,1
NC_037330.1,NC_032652.1,3939052,4687925,4687935,t,ttagcatagca,10
NC_037330.1,NC_032652.1,3939236,4688119,4688121,t,tac,2
NC_037330.1,NC_032652.1,3941575,4690460,4690464,a,aNNNN,4
NC_037330.1,NC_032652.1,3947478,4696367,4696368,T,TA,1
NC_037330.1,NC_032652.1,3967894,4716787,4716788,G,GC,1
NC_037330.1,NC_032652.1,3978693,4727586,4727592,a,aNNNNNN,6
NC_037330.1,NC_032652.1,4142864,4890719,4890723,C,CTCCA,4
NC_037330.1,NC_032652.1,4143174,4891033,4891034,A,AG,1
NC_037330.1,NC_032652.1,4205000,4952922,4952923,a,ag,1
NC_037330.1,NC_032652.1,4228639,4976557,4976558,T,TC,1
NC_037330.1,NC_032652.1,4231980,4979900,4979901,g,ga,1
NC_037330.1,NC_032652.1,4242765,4990687,4990689,t,ttg,2
NC_037330.1,NC_032652.1,4295601,5043507,5043513,A,ACCCTAC,6
NC_037330.1,NC_032652.1,4312149,5060065,5060066,T,TW,1
NC_037330.1,NC_032652.1,4332050,5079968,5079974,A,ATACTGG,6
NC_037330.1,NC_032652.1,4342970,5090898,5090904,G,GATTGAT,6
NC_037330.1,NC_032652.1,4365564,5113503,5113507,t,tatta,4
NC_037330.1,NC_032652.1,4397816,5145758,5145760,A,AGG,2
NC_037330.1,NC_032652.1,4404343,5152291,5152292,A,AC,1
NC_037330.1,NC_032652.1,4525740,5273660,5273661,t,ta,1
NC_037330.1,NC_032652.1,4535337,5283264,5283265,t,tc,1
NC_037330.1,NC_032652.1,4576251,5325999,5326000,g,gc,1
NC_037330.1,NC_032652.1,4582434,5332183,5332195,A,AAGCTTTCCCCTC,12
NC_037330.1,NC_032652.1,4605161,5354920,5354924,g,gtTTA,4
NC_037330.1,NC_032652.1,4605186,5354949,5354950,t,tc,1
NC_037330.1,NC_032652.1,4605241,5355004,5355005,t,ta,1
NC_037330.1,NC_032652.1,4610890,5360645,5360646,T,TA,1
NC_037330.1,NC_032652.1,4614660,5364015,5364016,c,ct,1
NC_037330.1,NC_032652.1,4643471,5392832,5392833,A,AM,1
NC_037330.1,NC_032652.1,4650141,5399501,5399502,T,TK,1
NC_037330.1,NC_032652.1,4653460,5402823,5402824,T,TA,1
NC_037330.1,NC_032652.1,4679117,5428481,5428482,a,aM,1
NC_037330.1,NC_032652.1,4705808,5455229,5455230,G,GC,1
NC_037330.1,NC_032652.1,4727044,5476294,5476295,t,ta,1
NC_037330.1,NC_032652.1,4741768,5489349,5489353,t,ttata,4
NC_037330.1,NC_032652.1,4744508,5492095,5492098,c,caga,3
NC_037330.1,NC_032652.1,4747927,5495517,5495518,t,ta,1
NC_037330.1,NC_032652.1,4749686,5497279,5497280,G,GC,1
NC_037330.1,NC_032652.1,4749686,5294647,5294648,G,GC,1
NC_037330.1,NC_032652.1,4823535,5581971,5581972,t,ta,1
NC_037330.1,NC_032652.1,4823548,5581985,5581986,t,ta,1
NC_037330.1,NC_032652.1,4829270,5587705,5587708,a,attt,3
NC_037330.1,NC_032652.1,4829336,5587774,5587775,T,TC,1
NC_037330.1,NC_032652.1,4837094,5594950,5594955,T,TATTTC,5
NC_037330.1,NC_032652.1,4867211,5625091,5625092,t,tg,1
NC_037330.1,NC_032652.1,4869472,5627356,5627357,T,TC,1
NC_037330.1,NC_032652.1,4873750,5631633,5631634,T,TA,1
NC_037330.1,NC_032652.1,4921954,5679863,5679890,t,tcacctccactagctttgatcttagtaa,27
NC_037330.1,NC_032652.1,4936570,5694519,5694520,t,tN,1
NC_037330.1,NC_032652.1,4938294,5696244,5696245,a,ag,1
NC_037330.1,NC_032652.1,4949104,5707097,5707102,T,TGGGGG,5
NC_037330.1,NC_032652.1,4949831,5707829,5707833,t,ttgtg,4
NC_037330.1,NC_032652.1,4951072,5709074,5709075,c,cg,1
NC_037330.1,NC_032652.1,4951876,5709880,5709881,A,AG,1
NC_037330.1,NC_032652.1,4968321,5726312,5726313,T,TW,1
NC_037330.1,NC_032652.1,4969216,5727207,5727208,g,ga,1
NC_037330.1,NC_032652.1,4994197,5735968,5735969,t,tg,1
NC_037330.1,NC_032652.1,4994848,5736622,5736625,a,aatt,3
NC_037330.1,NC_032652.1,5153780,5905950,5905952,C,CCT,2
NC_037330.1,NC_032652.1,5209741,5965621,5965623,a,aNN,2
NC_037330.1,NC_032652.1,5231456,5987337,5987340,g,gtga,3
NC_037330.1,NC_032652.1,5281960,6038079,6038080,t,tc,1
NC_037330.1,NC_032652.1,5335097,6103050,6103057,a,aaaaaaag,7
NC_037330.1,NC_032652.1,5339359,6107319,6107320,t,tN,1
NC_037330.1,NC_032652.1,5389942,6157662,6157663,C,CT,1
NC_037330.1,NC_032652.1,5407871,6175634,6175635,g,ga,1
NC_037330.1,NC_032652.1,5546219,6317383,6317384,c,ca,1
NC_037330.1,NC_032652.1,5565742,6336903,6336906,a,actt,3
NC_037330.1,NC_032652.1,5565763,6336927,6336932,c,cctttt,5
NC_037330.1,NC_032652.1,5639385,6410564,6410565,a,at,1
NC_037330.1,NC_032652.1,5703787,6473570,6473572,A,AAT,2
NC_037330.1,NC_032652.1,5715256,6485043,6485044,g,gt,1
NC_037330.1,NC_032652.1,5772973,6567463,6567464,C,CY,1
NC_037330.1,NC_032652.1,5778266,6572760,6572762,A,AGT,2
NC_037330.1,NC_032652.1,5816939,6611463,6611470,A,ACAAGGAG,7
NC_037330.1,NC_032652.1,5824570,6618594,6618595,a,ag,1
NC_037330.1,NC_032652.1,5827472,6621497,6621498,g,gc,1
NC_037330.1,NC_032652.1,5833650,6627677,6627678,g,ga,1
NC_037330.1,NC_032652.1,5833659,6627687,6627688,c,ca,1
NC_037330.1,NC_032652.1,5834630,6628663,6628664,A,AT,1
NC_037330.1,NC_032652.1,5864462,6658500,6658502,g,gaa,2
NC_037330.1,NC_032652.1,5910699,6704743,6704744,A,AW,1
NC_037330.1,NC_032652.1,5914452,6709353,6709354,T,TA,1
NC_037330.1,NC_032652.1,5926784,6721697,6721699,g,gtt,2
NC_037330.1,NC_032652.1,5932466,6727381,6727383,g,gta,2
NC_037330.1,NC_032652.1,6083994,6886400,6886403,t,tttc,3
NC_037330.1,NC_032652.1,6102689,6904922,6904928,c,ctttttt,6
NC_037330.1,NC_032652.1,6104509,6906760,6906761,t,ta,1
NC_037330.1,NC_032652.1,6104522,6906774,6906775,a,ac,1
NC_037330.1,NC_032652.1,6104593,6906846,6906850,c,ccgaa,4
NC_037330.1,NC_032652.1,6115535,6917789,6917790,t,ta,1
NC_037330.1,NC_032652.1,6116367,6918620,6918621,C,CA,1
NC_037330.1,NC_032652.1,6129083,6931325,6931326,g,ga,1
NC_037330.1,NC_032652.1,6131352,6933598,6933599,a,ac,1
NC_037330.1,NC_032652.1,6146194,6948485,6948487,t,ttg,2
NC_037330.1,NC_032652.1,6174221,6976203,6976207,c,ctgtg,4
NC_037330.1,NC_032652.1,6174275,6976261,6976263,a,atg,2
NC_037330.1,NC_032652.1,6181407,6983409,6983410,T,TC,1
NC_037330.1,NC_032652.1,6205626,7007639,7007643,a,aatat,4
NC_037330.1,NC_032652.1,6471757,7052251,7052252,a,at,1
NC_037330.1,NC_032652.1,6475598,7056094,7056095,c,ca,1
NC_037330.1,NC_032652.1,6521137,7101637,7101638,c,ca,1
NC_037330.1,NC_032652.1,6598733,7188313,7188314,C,CT,1
NC_037330.1,NC_032652.1,6611656,7202031,7202033,c,cca,2
NC_037330.1,NC_032652.1,6760372,7350656,7350657,T,TA,1
NC_037330.1,NC_032652.1,6913115,7504869,7504870,T,TG,1
NC_037330.1,NC_032652.1,7190439,7783262,7783263,T,TC,1
NC_037330.1,NC_032652.1,7223264,7816082,7816083,G,GS,1
NC_037330.1,NC_032652.1,7299782,7892603,7892616,a,aattcctggagatc,13
NC_037330.1,NC_032652.1,7325742,7918576,7918577,t,tc,1
NC_037330.1,NC_032652.1,7349974,7942810,7942811,c,ct,1
NC_037330.1,NC_032652.1,7501120,8185869,8185870,t,ta,1
NC_037330.1,NC_032652.1,7506793,8196375,8196376,A,AM,1
NC_037330.1,NC_032652.1,7774203,8463372,8463374,G,GGT,2
NC_037330.1,NC_032652.1,8062673,8779786,8779788,c,cca,2
NC_037330.1,NC_032652.1,8294965,9221603,9221605,g,gaa,2
NC_037330.1,NC_032652.1,8297244,9223884,9223885,G,GC,1
NC_037330.1,NC_032652.1,8301786,9228431,9228432,c,ca,1
NC_037330.1,NC_032652.1,8599621,9530047,9530048,t,tc,1
NC_037330.1,NC_032652.1,8600153,9530576,9530577,C,CA,1
NC_037330.1,NC_032652.1,8605450,9535925,9535926,C,CT,1
NC_037330.1,NC_032652.1,8605733,9536207,9536208,T,TC,1
NC_037330.1,NC_032652.1,8607448,9537923,9537926,a,aNNN,3
NC_037330.1,NC_032652.1,8653576,9584049,9584050,G,GM,1
NC_037330.1,NC_032652.1,8691331,9621662,9621664,a,aNN,2
NC_037330.1,NC_032652.1,8855432,9786040,9786042,G,GGR,2
NC_037330.1,NC_032652.1,8926386,9857227,9857228,T,TG,1
NC_037330.1,NC_032652.1,9290744,10263255,10263258,C,CCTG,3
NC_037330.1,NC_032652.1,9462014,10434550,10434551,T,TK,1
NC_037330.1,NC_032652.1,9466841,10439350,10439351,t,tg,1
NC_037330.1,NC_032652.1,9472222,10444762,10444763,C,CT,1
NC_037330.1,NC_032652.1,9472224,10444765,10444766,A,AT,1
NC_037330.1,NC_032652.1,9472228,10444770,10444771,A,AG,1
NC_037330.1,NC_032652.1,9501850,10474391,10474392,C,CA,1
NC_037330.1,NC_032652.1,9501968,10474510,10474511,G,GA,1
NC_037330.1,NC_032652.1,9553119,10525661,10525662,g,gt,1
NC_037330.1,NC_032652.1,9790817,10763623,10763624,T,TA,1
NC_037330.1,NC_032652.1,9865642,10838448,10838449,G,GT,1
NC_037330.1,NC_032652.1,9865823,10838627,10838628,g,gR,1
NC_037330.1,NC_032652.1,10048072,11020563,11020564,G,GC,1
NC_037330.1,NC_032652.1,10053785,11026276,11026277,t,tg,1
NC_037330.1,NC_032652.1,10168975,11140914,11140915,g,gt,1
NC_037330.1,NC_032652.1,10190822,11162830,11162831,C,CG,1
NC_037330.1,NC_032652.1,10314631,11286633,11286637,c,ctgag,4
NC_037330.1,NC_032652.1,10598445,11570493,11570496,t,tagc,3
NC_037330.1,NC_032652.1,10638905,11610912,11610942,t,taNNNNNNNNNNNNNNNNNNNNNNNNNNNNN,30
NC_037330.1,NC_032652.1,10704109,11675896,11675898,t,taa,2
NC_037330.1,NC_032652.1,10760518,11732878,11732905,T,TNNNNNNNNNNNNNNNNNNNNNNNNNNN,27
NC_037330.1,NC_032652.1,10816484,11789200,11789201,C,CG,1
NC_037330.1,NC_032652.1,10816820,11789534,11789536,g,gca,2
NC_037330.1,NC_032652.1,10820196,11792947,11792951,c,catat,4
NC_037330.1,NC_032652.1,10832278,11805032,11805035,G,GAAA,3
NC_037330.1,NC_032652.1,10835797,11808555,11808557,C,CTG,2
NC_037330.1,NC_032652.1,10862767,11835533,11835538,G,GCACGC,5
NC_037330.1,NC_032652.1,10872427,11845196,11845198,C,CAA,2
NC_037330.1,NC_032652.1,10874065,11846845,11846846,a,ag,1
NC_037330.1,NC_032652.1,10877305,11850087,11850088,T,TA,1
NC_037330.1,NC_032652.1,10878660,11851443,11851447,t,tatta,4
NC_037330.1,NC_032652.1,10881440,11854216,11854217,C,CA,1
NC_037330.1,NC_032652.1,10887882,11860659,11860660,A,AR,1
NC_037330.1,NC_032652.1,10919302,11892080,11892084,t,taaaa,4
NC_037330.1,NC_032652.1,10952195,11924979,11924980,c,ca,1
NC_037330.1,NC_032652.1,10953319,11926104,11926105,t,ta,1
NC_037330.1,NC_032652.1,10957830,11930618,11930619,t,tc,1
NC_037330.1,NC_032652.1,10958290,11931079,11931080,a,ag,1
NC_037330.1,NC_032652.1,11033845,12008572,12008573,a,ac,1
NC_037330.1,NC_032652.1,11033861,12008589,12008590,t,tg,1
NC_037330.1,NC_032652.1,11034638,12009367,12009368,t,ta,1
NC_037330.1,NC_032652.1,11034843,12009573,12009574,g,ga,1
NC_037330.1,NC_032652.1,11035069,12009800,12009801,t,tN,1
NC_037330.1,NC_032652.1,11064845,12040921,12040922,t,tg,1
NC_037330.1,NC_032652.1,11090878,12066952,12066954,a,att,2
NC_037330.1,NC_032652.1,11093569,12069645,12069646,c,cY,1
NC_037330.1,NC_032652.1,11162909,12138379,12138380,a,ag,1
NC_037330.1,NC_032652.1,11169200,12144674,12144679,a,aacttt,5
NC_037330.1,NC_032652.1,11316439,12289148,12289149,a,ac,1
NC_037330.1,NC_032652.1,11365373,12338113,12338189,T,TTAAAAAGATATGGAAACACATTCTTTGGCCGAATAGTTCGAGNNNNNNNNNNNNNNNNNNNNNNNNNNNNCACCGG,76
NC_037330.1,NC_032652.1,11472942,12446208,12446209,A,AT,1
NC_037330.1,NC_032652.1,11482761,12456023,12456024,c,ca,1
NC_037330.1,NC_032652.1,11494424,12467687,12467688,t,ta,1
NC_037330.1,NC_032652.1,11645657,12700950,12700951,a,at,1
NC_037330.1,NC_032652.1,11848773,12953711,12953713,g,gca,2
NC_037330.1,NC_032652.1,11856931,12961871,12961872,T,TA,1
NC_037330.1,NC_032652.1,11861662,12966613,12966631,A,AATAGATAACACTGAATAT,18
NC_037330.1,NC_032652.1,11862504,12967473,12967487,g,gcgcacacacacaca,14
NC_037330.1,NC_032652.1,11863504,12968486,12968493,a,acacacac,7
NC_037330.1,NC_032652.1,11863635,12968624,12968626,g,gga,2
NC_037330.1,NC_032652.1,11865958,12970948,12970949,g,ga,1
NC_037330.1,NC_032652.1,11868692,12973679,12973680,c,ct,1
NC_037330.1,NC_032652.1,11868749,12973737,12973738,A,AR,1
NC_037330.1,NC_032652.1,11938365,13166319,13166320,a,ag,1
NC_037330.1,NC_032652.1,11938625,13166057,13166059,a,att,2
NC_037330.1,NC_032652.1,11985435,13229742,13229743,G,GT,1
NC_037330.1,NC_032652.1,11986872,13228316,13228317,c,ca,1
NC_037330.1,NC_032652.1,11986918,13228265,13228270,g,gaagtc,5
NC_037330.1,NC_032652.1,11990093,13225806,13225809,a,aagg,3
NC_037330.1,NC_032652.1,11997445,13008862,13008863,A,AC,1
NC_037330.1,NC_032652.1,11999343,13216555,13216556,a,ag,1
NC_037330.1,NC_032652.1,11999343,13010731,13010732,a,ag,1
NC_037330.1,NC_032652.1,11999601,13216296,13216297,T,TA,1
NC_037330.1,NC_032652.1,11999601,13010990,13010991,T,TA,1
NC_037330.1,NC_032652.1,12003540,13212340,13212341,a,ag,1
NC_037330.1,NC_032652.1,12003540,13014926,13014927,a,ag,1
NC_037330.1,NC_032652.1,12007922,13019307,13019309,a,aag,2
NC_037330.1,NC_032652.1,12009253,13020642,13020643,t,ta,1
NC_037330.1,NC_032652.1,12018065,13029461,13029462,c,ct,1
NC_037330.1,NC_032652.1,12018123,13029520,13029521,a,at,1
NC_037330.1,NC_032652.1,12018475,13029873,13029876,C,CAGA,3
NC_037330.1,NC_032652.1,12018527,13029928,13029929,A,AC,1
NC_037330.1,NC_032652.1,12149024,13249787,13249788,t,tc,1
NC_037330.1,NC_032652.1,12150014,13250778,13250779,g,gt,1
NC_037330.1,NC_032652.1,12150581,13251346,13251348,C,CCA,2
NC_037330.1,NC_032652.1,12151147,13251914,13251915,A,AT,1
NC_037330.1,NC_032652.1,12152391,13253159,13253160,a,ac,1
NC_037330.1,NC_032652.1,12158659,13259437,13259438,a,aN,1
NC_037330.1,NC_032652.1,12161344,13262124,13262125,a,ac,1
NC_037330.1,NC_032652.1,12162705,13263485,13263488,c,cctt,3
NC_037330.1,NC_032652.1,12218839,13457986,13457987,G,GR,1
NC_037330.1,NC_032652.1,12248852,13487997,13487998,G,GS,1
NC_037330.1,NC_032652.1,12412635,13651662,13651663,T,TA,1
NC_037330.1,NC_032652.1,12722130,13960723,13960724,t,ta,1
NC_037330.1,NC_032652.1,12742310,13980906,13980907,a,at,1
NC_037330.1,NC_032652.1,12761131,13999731,13999733,a,aag,2
NC_037330.1,NC_032652.1,12928098,14171916,14171917,C,CM,1
NC_037330.1,NC_032652.1,12928283,14172102,14172103,T,TC,1
NC_037330.1,NC_032652.1,12951788,14195587,14195588,t,ta,1
NC_037330.1,NC_032652.1,12966799,14210599,14210600,A,AG,1
NC_037330.1,NC_032652.1,13145603,14390050,14390051,a,ac,1
NC_037330.1,NC_032652.1,13180154,14417143,14417144,T,TC,1
NC_037330.1,NC_032652.1,13274680,14510796,14510797,g,gt,1
NC_037330.1,NC_032652.1,13457690,14780263,14780267,C,CTAAG,4
NC_037330.1,NC_032652.1,13471685,14794271,14794287,a,acaaaactaaccaaatc,16
NC_037330.1,NC_032652.1,13471691,14794293,14794298,g,gtggaa,5
NC_037330.1,NC_032652.1,13709352,15131424,15131425,g,ga,1
NC_037330.1,NC_032652.1,13722612,15144684,15144685,c,ca,1
NC_037330.1,NC_032652.1,13966031,15388016,15388017,C,CT,1
NC_037330.1,NC_032652.1,14119172,15540418,15540419,G,GR,1
NC_037330.1,NC_032652.1,14159522,15580774,15580775,T,TG,1
NC_037330.1,NC_032652.1,14214977,15667832,15667847,A,AGNNNNNNNNNNNNNN,15
NC_037330.1,NC_032652.1,14285290,15738384,15738385,C,CY,1
NC_037330.1,NC_032652.1,14285310,15738405,15738406,C,CT,1
NC_037330.1,NC_032652.1,14549057,15885340,15885341,G,GC,1
NC_037330.1,NC_032652.1,14692023,16028784,16028787,T,TANN,3
NC_037330.1,NC_032652.1,14721751,16058515,16058516,G,GK,1
NC_037330.1,NC_032652.1,14760299,16097065,16097067,C,CCA,2
NC_037330.1,NC_032652.1,14790178,16127111,16127112,C,CT,1
NC_037330.1,NC_032652.1,14826025,16162981,16162982,C,CT,1
NC_037330.1,NC_032652.1,14889240,16227729,16227731,g,gta,2
NC_037330.1,NC_032652.1,14899045,16237307,16237308,t,tK,1
NC_037330.1,NC_032652.1,15203605,16543914,16543975,A,ACTTACTGAAANNNNNNNNNNNNNNNNNNNNNNNNNNNNNNNNNNNNNNNNNNNNNNNNNNN,61
NC_037330.1,NC_032652.1,15352638,16747156,16747157,G,GT,1
NC_037330.1,NC_032652.1,15374401,16768936,16768940,T,TGTTG,4
NC_037330.1,NC_032652.1,15375094,16769633,16769637,T,TCTAC,4
NC_037330.1,NC_032652.1,15413887,16793727,16793728,C,CA,1
NC_037330.1,NC_032652.1,15413928,16793769,16793770,C,CA,1
NC_037330.1,NC_032652.1,15492238,16872231,16872233,t,tNN,2
NC_037330.1,NC_032652.1,15765471,17148265,17148287,C,CTCTAGGACTCTGCTTGCAAGTa,22
NC_037330.1,NC_032652.1,15858388,17241579,17241580,A,AC,1
NC_037330.1,NC_032652.1,15869786,17252978,17252979,A,AM,1
NC_037330.1,NC_032652.1,15967332,17350494,17350509,c,cgGTCGGGCACGAAAN,15
NC_037330.1,NC_032652.1,15967375,17350552,17350553,C,CA,1
NC_037330.1,NC_032652.1,15969932,17353109,17353110,G,GA,1
NC_037330.1,NC_032652.1,15970074,17353252,17353254,a,aat,2
NC_037330.1,NC_032652.1,15971462,17354643,17354652,a,acactgtttc,9
NC_037330.1,NC_032652.1,16013918,17397109,17397110,g,gt,1
NC_037330.1,NC_032652.1,16027730,17410967,17410969,T,TTC,2
NC_037330.1,NC_032652.1,16247650,17630916,17630920,a,aNNNN,4
NC_037330.1,NC_032652.1,16251224,17634495,17634497,C,CAA,2
NC_037330.1,NC_032652.1,16443377,17826380,17826387,g,gtcggAGA,7
NC_037330.1,NC_032652.1,16488377,17871407,17871408,C,CG,1
NC_037330.1,NC_032652.1,16492781,17875901,17875921,G,GGCTAGATTTNNNNNNNNNNN,20
NC_037330.1,NC_032652.1,16507282,17890423,17890432,g,gggcggAATC,9
NC_037330.1,NC_032652.1,16756958,18155398,18155399,A,AT,1
NC_037330.1,NC_032652.1,16777648,18176089,18176090,c,ct,1
NC_037330.1,NC_032652.1,16804966,18203104,18203105,G,GT,1
NC_037330.1,NC_032652.1,16806989,18205128,18205129,G,GA,1
NC_037330.1,NC_032652.1,16853362,18251508,18251509,G,GC,1
NC_037330.1,NC_032652.1,16941231,18337975,18337976,A,AT,1
NC_037330.1,NC_032652.1,17126560,18522581,18522582,c,ct,1
NC_037330.1,NC_032652.1,17126584,18522606,18522607,T,TC,1
NC_037330.1,NC_032652.1,17134036,18530067,18530073,t,tWtttta,6
NC_037330.1,NC_032652.1,17143291,18539330,18539331,a,at,1
NC_037330.1,NC_032652.1,17143356,18539396,18539397,G,GA,1
NC_037330.1,NC_032652.1,17154361,18550403,18550408,T,TCATGC,5
NC_037330.1,NC_032652.1,17161664,18557718,18557719,t,ta,1
NC_037330.1,NC_032652.1,17202926,18598851,18598852,g,ga,1
NC_037330.1,NC_032652.1,17302263,18698203,18698204,T,TY,1
NC_037330.1,NC_032652.1,17366624,18919225,18919229,A,AACAG,4
NC_037330.1,NC_032652.1,17366633,18919213,18919216,G,GTTC,3
NC_037330.1,NC_032652.1,17366691,18919154,18919155,G,GA,1
NC_037330.1,NC_032652.1,17366778,18919066,18919067,A,AC,1
NC_037330.1,NC_032652.1,17369779,18800051,18800052,a,ac,1
NC_037330.1,NC_032652.1,17371402,18914411,18914415,G,GGATT,4
NC_037330.1,NC_032652.1,17371402,18801675,18801679,G,GGATT,4
NC_037330.1,NC_032652.1,17371640,18801917,18801920,g,gaca,3
NC_037330.1,NC_032652.1,17372093,18802373,18802376,a,aaag,3
NC_037330.1,NC_032652.1,17372700,18913106,18913107,C,CT,1
NC_037330.1,NC_032652.1,17372700,18802983,18802984,C,CT,1
NC_037330.1,NC_032652.1,17377349,18807637,18807638,g,gt,1
NC_037330.1,NC_032652.1,17389439,18811733,18811734,G,GC,1
NC_037330.1,NC_032652.1,17389973,18812290,18812293,A,AAAC,3
NC_037330.1,NC_032652.1,17389981,18812301,18812302,T,TC,1
NC_037330.1,NC_032652.1,17392967,18815310,18815320,A,AATTTAGGTTG,10
NC_037330.1,NC_032652.1,17393249,18815602,18815604,A,AAC,2
NC_037330.1,NC_032652.1,17393386,18815741,18815758,C,CCACCACCCACCATGGTG,17
NC_037330.1,NC_032652.1,17393725,18816097,18816100,c,caaa,3
NC_037330.1,NC_032652.1,17394372,18816755,18816756,a,ac,1
NC_037330.1,NC_032652.1,17395519,18817908,18817909,C,CT,1
NC_037330.1,NC_032652.1,17395594,18817987,18817988,g,ga,1
NC_037330.1,NC_032652.1,17395603,18817997,18817998,C,CT,1
NC_037330.1,NC_032652.1,17395613,18818008,18818010,C,CTT,2
NC_037330.1,NC_032652.1,17395664,18818061,18818062,A,AT,1
NC_037330.1,NC_032652.1,17395695,18818093,18818094,A,AR,1
NC_037330.1,NC_032652.1,17395705,18818104,18818107,C,CTGT,3
NC_037330.1,NC_032652.1,17395785,18818187,18818188,T,TA,1
NC_037330.1,NC_032652.1,17395791,18818194,18818196,C,CAG,2
NC_037330.1,NC_032652.1,17395834,18818239,18818240,G,GK,1
NC_037330.1,NC_032652.1,17395971,18818377,18818379,a,aag,2
NC_037330.1,NC_032652.1,17396012,18818420,18818422,A,AAT,2
NC_037330.1,NC_032652.1,17396085,18818495,18818496,T,TG,1
NC_037330.1,NC_032652.1,17396138,18818549,18818551,A,ATG,2
NC_037330.1,NC_032652.1,17396244,18818660,18818662,T,TAG,2
NC_037330.1,NC_032652.1,17428185,18824424,18824425,T,TG,1
NC_037330.1,NC_032652.1,17428354,18824594,18824595,T,TC,1
NC_037330.1,NC_032652.1,17429026,18825271,18825272,T,TC,1
NC_037330.1,NC_032652.1,17429034,18825280,18825281,t,ta,1
NC_037330.1,NC_032652.1,17429325,18825570,18825571,t,ta,1
NC_037330.1,NC_032652.1,17435486,18831754,18831755,g,ga,1
NC_037330.1,NC_032652.1,17437782,18834051,18834052,t,ta,1
NC_037330.1,NC_032652.1,17439622,18835907,18835909,A,ACG,2
NC_037330.1,NC_032652.1,17443669,18839955,18839957,A,AAT,2
NC_037330.1,NC_032652.1,17445563,18841850,18841851,a,at,1
NC_037330.1,NC_032652.1,17446075,18842361,18842363,A,ATC,2
NC_037330.1,NC_032652.1,17446112,18842400,18842402,G,GTA,2
NC_037330.1,NC_032652.1,17446191,18842481,18842489,t,taaaaaaaa,8
NC_037330.1,NC_032652.1,17452869,18932545,18932547,c,caa,2
NC_037330.1,NC_032652.1,17453140,18932818,18932819,A,AC,1
NC_037330.1,NC_032652.1,17457894,18942357,18942369,C,CGCATCCGCATCA,12
NC_037330.1,NC_032652.1,17470957,18955433,18955436,a,aaGT,3
NC_037330.1,NC_032652.1,17475262,18959758,18959759,A,AC,1
NC_037330.1,NC_032652.1,17577307,19018490,19018492,G,GTC,2
NC_037330.1,NC_032652.1,17605541,19046007,19046008,T,TA,1
NC_037330.1,NC_032652.1,17627031,19067498,19067499,g,gc,1
NC_037330.1,NC_032652.1,17647412,19087915,19087920,c,caaaca,5
NC_037330.1,NC_032652.1,17651750,19104379,19104380,g,gt,1
NC_037330.1,NC_032652.1,17652525,19093033,19093034,t,ta,1
NC_037330.1,NC_032652.1,17664470,19117101,19117102,C,CA,1
NC_037330.1,NC_032652.1,17679276,19115481,19115490,a,actgctgctg,9
NC_037330.1,NC_032652.1,17679585,19115799,19115800,c,ct,1
NC_037330.1,NC_032652.1,17684182,19120394,19120398,g,gcaca,4
NC_037330.1,NC_032652.1,17704454,19140671,19140681,g,gcacacacaca,10
NC_037330.1,NC_032652.1,17711437,19147633,19147634,T,TK,1
NC_037330.1,NC_032652.1,17860267,19296156,19296158,A,ARG,2
NC_037330.1,NC_032652.1,17907087,19342981,19342982,t,tg,1
NC_037330.1,NC_032652.1,17914148,19350042,19350057,a,aaaggttcatctagtc,15
NC_037330.1,NC_032652.1,17953288,19389197,19389199,t,tta,2
NC_037330.1,NC_032652.1,18057937,19488505,19488507,a,aNN,2
NC_037330.1,NC_032652.1,18358669,19796448,19796449,c,ct,1
NC_037330.1,NC_032652.1,18390179,19828559,19828560,c,ct,1
NC_037330.1,NC_032652.1,18399815,19838197,19838198,G,GA,1
NC_037330.1,NC_032652.1,18472323,20161205,20161206,C,CT,1
NC_037330.1,NC_032652.1,18481205,20170089,20170090,t,ta,1
NC_037330.1,NC_032652.1,18522707,19957824,19957825,a,at,1
NC_037330.1,NC_032652.1,18524223,19959335,19959336,a,ac,1
NC_037330.1,NC_032652.1,18526947,19962061,19962062,C,CT,1
NC_037330.1,NC_032652.1,18654153,20089737,20089739,a,aaN,2
NC_037330.1,NC_032652.1,18795910,20305014,20305036,C,CNNNNNNNNNNNNNNNNNNNNNN,22
NC_037330.1,NC_032652.1,18845126,20354254,20354255,T,TC,1
NC_037330.1,NC_032652.1,19311192,20821157,20821171,C,CNNNNNNNNNNNNNN,14
NC_037330.1,NC_032652.1,19610267,21120624,21120636,A,AAGAGGTTATggt,12
NC_037330.1,NC_032652.1,19638214,21148527,21148529,G,GAT,2
NC_037330.1,NC_032652.1,19644737,21155052,21155066,C,CTGCGGCGAAGAAGG,14
NC_037330.1,NC_032652.1,19654300,21164628,21164631,T,TCTY,3
NC_037330.1,NC_032652.1,19784400,21294787,21294788,T,TY,1
NC_037330.1,NC_032652.1,20074381,21609146,21609147,g,ga,1
NC_037330.1,NC_032652.1,20205433,21740153,21740154,A,AG,1
NC_037330.1,NC_032652.1,20214257,21749142,21749143,A,AW,1
NC_037330.1,NC_032652.1,20372482,21907363,21907364,a,ac,1
NC_037330.1,NC_032652.1,20448135,21983053,21983054,t,ta,1
NC_037330.1,NC_032652.1,20489966,22024885,22024886,T,TW,1
NC_037330.1,NC_032652.1,20737445,22273831,22273852,T,TGGCCCGGCATCTTTACCANNN,21
NC_037330.1,NC_032652.1,20923239,22520869,22520870,G,GA,1
NC_037330.1,NC_032652.1,20942912,22540545,22540557,G,GACTACatacaaa,12
NC_037330.1,NC_032652.1,20957250,22554895,22554896,A,AC,1
NC_037330.1,NC_032652.1,20978461,22586139,22586140,G,GA,1
NC_037330.1,NC_032652.1,20983311,22602790,22602791,T,TA,1
NC_037330.1,NC_032652.1,20984059,22603539,22603540,T,TA,1
NC_037330.1,NC_032652.1,20992202,22586870,22586871,G,GA,1
NC_037330.1,NC_032652.1,20992503,22587172,22587173,t,tc,1
NC_037330.1,NC_032652.1,20994348,22589004,22589010,a,ataactt,6
NC_037330.1,NC_032652.1,20995441,22590103,22590104,G,GA,1
NC_037330.1,NC_032652.1,20998506,22593166,22593169,c,cttt,3
NC_037330.1,NC_032652.1,21001825,22596475,22596476,A,AC,1
NC_037330.1,NC_032652.1,21002505,22597156,22597158,c,ctt,2
NC_037330.1,NC_032652.1,21003621,22598271,22598278,A,AACAAGCC,7
NC_037330.1,NC_032652.1,21017168,22626839,22626840,t,ta,1
NC_037330.1,NC_032652.1,21017168,22678019,22678020,t,ta,1
NC_037330.1,NC_032652.1,21019692,22680515,22680516,C,CG,1
NC_037330.1,NC_032652.1,21020129,22680953,22680956,T,TAGC,3
NC_037330.1,NC_032652.1,21021148,22922532,22922533,G,GC,1
NC_037330.1,NC_032652.1,21021148,22681920,22681921,G,GC,1
NC_037330.1,NC_032652.1,21021262,22682035,22682045,T,TAACTCTCNNN,10
NC_037330.1,NC_032652.1,21021474,22682257,22682267,t,tcacatacaca,10
NC_037330.1,NC_032652.1,21021663,22682456,22682457,t,ta,1
NC_037330.1,NC_032652.1,21021694,22682488,22682491,A,AAAC,3
NC_037330.1,NC_032652.1,21021953,22682750,22682756,C,CTTAAAG,6
NC_037330.1,NC_032652.1,21022422,22683225,22683230,g,gagttc,5
NC_037330.1,NC_032652.1,21027565,22688371,22688372,A,AN,1
NC_037330.1,NC_032652.1,21029679,22690490,22690495,A,AAGTAC,5
NC_037330.1,NC_032652.1,21030303,22691119,22691120,T,TC,1
NC_037330.1,NC_032652.1,21031377,22692194,22692195,A,AG,1
NC_037330.1,NC_032652.1,21043017,22619246,22619247,G,GA,1
NC_037330.1,NC_032652.1,21043303,22619533,22619534,c,ct,1
NC_037330.1,NC_032652.1,21044419,22620650,22620659,t,tgtccatcta,9
NC_037330.1,NC_032652.1,21046230,22622470,22622474,a,acaag,4
NC_037330.1,NC_032652.1,21047194,22623438,22623439,G,GT,1
NC_037330.1,NC_032652.1,21051874,22628119,22628120,a,at,1
NC_037330.1,NC_032652.1,21052693,22628939,22628940,T,TA,1
NC_037330.1,NC_032652.1,21052742,22628989,22629009,t,tttttgttttgtttcgttttg,20
NC_037330.1,NC_032652.1,21052977,22629244,22629245,T,TG,1
NC_037330.1,NC_032652.1,21053098,22629366,22629377,T,TCAGTCTAGAGC,11
NC_037330.1,NC_032652.1,21053742,22630017,22630039,C,CCACCAACACTCAGCTTCTTGAG,22
NC_037330.1,NC_032652.1,21053905,22630202,22630225,a,atgtgttttttttttttttttttt,23
NC_037330.1,NC_032652.1,21055576,22631868,22631869,T,TA,1
NC_037330.1,NC_032652.1,21056593,22632881,22632882,t,ta,1
NC_037330.1,NC_032652.1,21076561,22909128,22909130,t,tac,2
NC_037330.1,NC_032652.1,21076561,22852773,22852775,t,tac,2
NC_037330.1,NC_032652.1,21076758,22908930,22908931,C,CT,1
NC_037330.1,NC_032652.1,21076758,22852972,22852973,C,CT,1
NC_037330.1,NC_032652.1,21077018,22908668,22908669,t,ta,1
NC_037330.1,NC_032652.1,21077018,22853234,22853235,t,ta,1
NC_037330.1,NC_032652.1,21078523,22907159,22907161,C,CCA,2
NC_037330.1,NC_032652.1,21078523,22854742,22854744,C,CCA,2
NC_037330.1,NC_032652.1,21080129,22856350,22856351,t,tN,1
NC_037330.1,NC_032652.1,21081929,22903751,22903752,c,ca,1
NC_037330.1,NC_032652.1,21081929,22858151,22858152,c,ca,1
NC_037330.1,NC_032652.1,21081958,22903701,22903722,a,aaaaccatagccttgactagat,21
NC_037330.1,NC_032652.1,21081958,22858181,22858202,a,aaaaccatagccttgactagat,21
NC_037330.1,NC_032652.1,21082130,22903527,22903529,c,cca,2
NC_037330.1,NC_032652.1,21082130,22858374,22858376,c,cca,2
NC_037330.1,NC_032652.1,21113226,22925103,22925105,A,ACT,2
NC_037330.1,NC_032652.1,21120974,22932846,22932849,T,TTGC,3
NC_037330.1,NC_032652.1,21302090,23092594,23092602,t,ttgagcaca,8
NC_037330.1,NC_032652.1,21528318,23398598,23398599,C,CA,1
NC_037330.1,NC_032652.1,21554186,23424466,23424467,T,TC,1
NC_037330.1,NC_032652.1,21555224,23425505,23425506,T,TW,1
NC_037330.1,NC_032652.1,21646490,23516719,23516723,t,taaca,4
NC_037330.1,NC_032652.1,21830125,23698808,23698810,a,aag,2
NC_037330.1,NC_032652.1,21844620,23713307,23713308,t,tg,1
NC_037330.1,NC_032652.1,21889074,23757768,23757769,A,AC,1
NC_037330.1,NC_032652.1,21889637,23758331,23758333,A,AGT,2
NC_037330.1,NC_032652.1,22371856,24225771,24225773,g,gac,2
NC_037330.1,NC_032652.1,22394217,24248134,24248135,T,TG,1
NC_037330.1,NC_032652.1,22414295,24268217,24268219,c,ctt,2
NC_037330.1,NC_032652.1,22576272,24430756,24430758,C,CCA,2
NC_037330.1,NC_032652.1,22787458,24641541,24641542,C,CT,1
NC_037330.1,NC_032652.1,22800795,24654880,24654897,T,TAGNNNNNNNNNNNNNNN,17
NC_037330.1,NC_032652.1,22887169,24738846,24738847,T,TK,1
NC_037330.1,NC_032652.1,22985107,24836792,24836795,C,CATG,3
NC_037330.1,NC_032652.1,22998232,24849918,24849919,g,gt,1
NC_037330.1,NC_032652.1,23168421,25102507,25102521,c,cgactgaagcgactt,14
NC_037330.1,NC_032652.1,23445946,25394043,25394044,A,AG,1
NC_037330.1,NC_032652.1,23550147,25561390,25561391,c,ca,1
NC_037330.1,NC_032652.1,23611831,25623082,25623083,A,AC,1
NC_037330.1,NC_032652.1,23617852,25629104,25629105,G,GK,1
NC_037330.1,NC_032652.1,23630486,25641742,25641743,A,AW,1
NC_037330.1,NC_032652.1,23876913,25888207,25888208,c,ct,1
NC_037330.1,NC_032652.1,23937175,25947302,25947303,G,GR,1
NC_037330.1,NC_032652.1,23969775,25979903,25979904,T,TG,1
NC_037330.1,NC_032652.1,24080474,26090593,26090594,t,tc,1
NC_037330.1,NC_032652.1,24136195,26150129,26150153,T,TGAAATGCTTAACCTGGGAGCTAAA,24
NC_037330.1,NC_032652.1,24192688,26206648,26206649,C,CA,1
NC_037330.1,NC_032652.1,24220872,26234836,26234842,t,ttaNNNN,6
NC_037330.1,NC_032652.1,24241250,26255017,26255018,G,GC,1
NC_037330.1,NC_032652.1,24292992,26306920,26306921,T,TG,1
NC_037330.1,NC_032652.1,24306553,26319581,26319582,c,ct,1
NC_037330.1,NC_032652.1,24537448,26549111,26549113,T,TNN,2
NC_037330.1,NC_032652.1,24678947,26630302,26630303,c,ct,1
NC_037330.1,NC_032652.1,24678947,26768523,26768524,c,ct,1
NC_037330.1,NC_032652.1,24760056,27112406,27112407,C,CT,1
NC_037330.1,NC_032652.1,24978344,27331597,27331598,C,CG,1
NC_037330.1,NC_032652.1,25102473,27452482,27452483,t,ta,1
NC_037330.1,NC_032652.1,25253913,27530605,27530607,G,GGC,2
NC_037330.1,NC_032652.1,25256527,27533223,27533224,T,TG,1
NC_037330.1,NC_032652.1,25407931,27707407,27707408,g,ga,1
NC_037330.1,NC_032652.1,25456296,27756139,27756141,g,gga,2
NC_037330.1,NC_032652.1,25456539,27756384,27756388,T,TAACA,4
NC_037330.1,NC_032652.1,25549203,27849066,27849067,T,TR,1
NC_037330.1,NC_032652.1,25591322,27891182,27891183,C,CG,1
NC_037330.1,NC_032652.1,25691734,27992001,27992004,a,aRct,3
NC_037330.1,NC_032652.1,25820879,28145925,28145926,a,ag,1
NC_037330.1,NC_032652.1,25899567,28224702,28224703,T,TA,1
NC_037330.1,NC_032652.1,25932171,28257310,28257314,t,tctaa,4
NC_037330.1,NC_032652.1,25932180,28257323,28257324,t,tc,1
NC_037330.1,NC_032652.1,25932271,28257415,28257419,a,acggt,4
NC_037330.1,NC_032652.1,26034974,28383224,28383229,T,TACAAC,5
NC_037330.1,NC_032652.1,26135546,28483811,28483812,T,TG,1
NC_037330.1,NC_032652.1,26323377,28670196,28670197,a,at,1
NC_037330.1,NC_032652.1,26376877,28723699,28723700,T,TG,1
NC_037330.1,NC_032652.1,26409891,28756706,28756707,A,AT,1
NC_037330.1,NC_032652.1,26411316,28758151,28758152,t,ta,1
NC_037330.1,NC_032652.1,26411782,28758618,28758623,t,tattag,5
NC_037330.1,NC_032652.1,26418218,28765020,28765021,G,GR,1
NC_037330.1,NC_032652.1,26419847,28766665,28766666,c,ct,1
NC_037330.1,NC_032652.1,26421468,28768288,28768300,c,caagctctgggag,12
NC_037330.1,NC_032652.1,26461970,28808828,28808838,t,ttttttttttc,10
NC_037330.1,NC_032652.1,26467292,28814204,28814205,T,TA,1
NC_037330.1,NC_032652.1,26602310,28948936,28948937,T,TY,1
NC_037330.1,NC_032652.1,26622981,28969609,28969610,T,TC,1
NC_037330.1,NC_032652.1,26715225,29061869,29061870,G,GA,1
NC_037330.1,NC_032652.1,26860304,29294981,29294982,g,gc,1
NC_037330.1,NC_032652.1,26957756,29440417,29440418,c,ct,1
NC_037330.1,NC_032652.1,26957983,29440645,29440646,a,ag,1
NC_037330.1,NC_032652.1,26963665,29446328,29446329,g,ga,1
NC_037330.1,NC_032652.1,26971255,29453912,29453913,t,tg,1
NC_037330.1,NC_032652.1,27130942,29614269,29614270,C,CS,1
NC_037330.1,NC_032652.1,27212343,29696438,29696440,A,AMC,2
NC_037330.1,NC_032652.1,27223809,29707825,29707826,C,CA,1
NC_037330.1,NC_032652.1,27224841,29708858,29708877,A,ACAAAAAAGGAATTGCAAAT,19
NC_037330.1,NC_032652.1,27517769,30001757,30001758,T,TY,1
NC_037330.1,NC_032652.1,27677609,30160357,30160359,C,CAT,2
NC_037330.1,NC_032652.1,27719017,30201767,30201768,A,AC,1
NC_037330.1,NC_032652.1,27729879,30212386,30212387,A,AT,1
NC_037330.1,NC_032652.1,27926933,30409763,30409764,a,ac,1
NC_037330.1,NC_032652.1,28017957,30500490,30500491,g,gc,1
NC_037330.1,NC_032652.1,28144883,30615675,30615676,c,ct,1
NC_037330.1,NC_032652.1,28145409,30616202,30616204,g,gta,2
NC_037330.1,NC_032652.1,28145760,30616555,30616556,t,tg,1
NC_037330.1,NC_032652.1,28162499,30633295,30633296,g,gt,1
NC_037330.1,NC_032652.1,28163162,30633959,30633965,a,atgaact,6
NC_037330.1,NC_032652.1,28164790,30635593,30635609,t,ttattgcaATATTNNNa,16
NC_037330.1,NC_032652.1,28165033,30635852,30635853,g,gt,1
NC_037330.1,NC_032652.1,28366563,63490672,63490674,g,gac,2
NC_037330.1,NC_032652.1,28367172,63491279,63491281,t,tcc,2
NC_037330.1,NC_032652.1,28411672,30864063,30864065,a,aNN,2
NC_037330.1,NC_032652.1,28463181,30915599,30915600,t,tc,1
NC_037330.1,NC_032652.1,28674113,31122068,31122069,g,ga,1
NC_037330.1,NC_032652.1,28674135,31122091,31122092,g,ga,1
NC_037330.1,NC_032652.1,28934775,31382463,31382464,a,at,1
NC_037330.1,NC_032652.1,29239578,31684992,31684993,A,AC,1
NC_037330.1,NC_032652.1,29258611,31703877,31703878,g,gc,1
NC_037330.1,NC_032652.1,29342333,31787393,31787406,G,GCTANNNNNNNNNN,13
NC_037330.1,NC_032652.1,29509213,31967080,31967105,A,ANNNNNNNNNNNNNNNNNNNNNNNNN,25
NC_037330.1,NC_032652.1,29961476,32419401,32419402,A,AC,1
NC_037330.1,NC_032652.1,30140332,32599618,32599620,c,cca,2
NC_037330.1,NC_032652.1,30337942,32793214,32793215,g,gc,1
NC_037330.1,NC_032652.1,30337957,32793230,32793231,t,tc,1
NC_037330.1,NC_032652.1,30558157,33079731,33079732,T,TS,1
NC_037330.1,NC_032652.1,30619898,33141639,33141640,C,CT,1
NC_037330.1,NC_032652.1,30619936,33141678,33141679,T,TC,1
NC_037330.1,NC_032652.1,30661928,33183685,33183687,g,gta,2
NC_037330.1,NC_032652.1,30704808,33226392,33226394,C,CTG,2
NC_037330.1,NC_032652.1,30868570,33387898,33387899,A,AG,1
NC_037330.1,NC_032652.1,30883676,33403174,33403175,G,GA,1
NC_037330.1,NC_032652.1,30950695,33469890,33469894,t,tgtgc,4
NC_037330.1,NC_032652.1,31010015,33529513,33529514,t,ta,1
NC_037330.1,NC_032652.1,31018345,33537841,33537845,c,cagat,4
NC_037330.1,NC_032652.1,31027380,33546882,33546884,a,aag,2
NC_037330.1,NC_032652.1,31081201,33600652,33600654,c,cca,2
NC_037330.1,NC_032652.1,31090648,33610100,33610101,a,ac,1
NC_037330.1,NC_032652.1,31104888,33624340,33624341,T,TG,1
NC_037330.1,NC_032652.1,31206758,33726676,33726677,a,aR,1
NC_037330.1,NC_032652.1,31281559,33802212,33802213,a,at,1
NC_037330.1,NC_032652.1,31302546,33823206,33823207,T,TY,1
NC_037330.1,NC_032652.1,31345626,33866137,33866147,T,TCTTTGGGCTA,10
NC_037330.1,NC_032652.1,31426239,33995123,33995124,t,ta,1
NC_037330.1,NC_032652.1,31431308,33998496,33998497,t,tc,1
NC_037330.1,NC_032652.1,31523219,34090396,34090397,a,ag,1
NC_037330.1,NC_032652.1,31613712,34181077,34181078,T,TK,1
NC_037330.1,NC_032652.1,31663033,34219894,34219899,c,cgactg,5
NC_037330.1,NC_032652.1,31861290,34435836,34435837,A,AR,1
NC_037330.1,NC_032652.1,31897070,34471631,34471635,a,actgt,4
NC_037330.1,NC_032652.1,31899418,34473983,34473985,a,aat,2
NC_037330.1,NC_032652.1,31902528,34477094,34477095,C,CY,1
NC_037330.1,NC_032652.1,31902930,34477497,34477500,g,gtgt,3
NC_037330.1,NC_032652.1,31903633,34478203,34478205,G,GAT,2
NC_037330.1,NC_032652.1,31905370,34479942,34479943,G,GR,1
NC_037330.1,NC_032652.1,31910318,34484889,34484890,a,ac,1
NC_037330.1,NC_032652.1,31913871,34488403,34488404,A,AT,1
NC_037330.1,NC_032652.1,31914339,34488872,34488873,C,CA,1
NC_037330.1,NC_032652.1,31919562,34494097,34494098,a,ac,1
NC_037330.1,NC_032652.1,31923096,34497632,34497636,t,tgaga,4
NC_037330.1,NC_032652.1,31924153,34498693,34498694,T,TA,1
NC_037330.1,NC_032652.1,31926274,34500816,34500819,A,AAGT,3
NC_037330.1,NC_032652.1,31928362,34502910,34502911,G,GR,1
NC_037330.1,NC_032652.1,31936261,34510886,34510888,c,caa,2
NC_037330.1,NC_032652.1,31947644,34530516,34530518,g,gga,2
NC_037330.1,NC_032652.1,31950092,34532965,34532973,G,GGAATTTTA,8
NC_037330.1,NC_032652.1,31951793,34534695,34534697,T,TTC,2
NC_037330.1,NC_032652.1,31989162,34571481,34571483,a,agt,2
NC_037330.1,NC_032652.1,31990609,34572929,34572930,g,gt,1
NC_037330.1,NC_032652.1,31991122,34573443,34573445,t,tta,2
NC_037330.1,NC_032652.1,31991643,34573961,34573962,t,tc,1
NC_037330.1,NC_032652.1,31992561,34574879,34574880,t,ta,1
NC_037330.1,NC_032652.1,31993146,34575465,34575466,a,at,1
NC_037330.1,NC_032652.1,31993401,34575721,34575722,a,ag,1
NC_037330.1,NC_032652.1,31995527,34577848,34577849,t,tg,1
NC_037330.1,NC_032652.1,31995900,34578222,34578224,a,aac,2
NC_037330.1,NC_032652.1,31996159,34578483,34578486,g,gaaa,3
NC_037330.1,NC_032652.1,31997202,34579542,34579543,a,ag,1
NC_037330.1,NC_032652.1,32000003,34582344,34582345,a,ag,1
NC_037330.1,NC_032652.1,32000525,34582861,34582873,a,agtatgtgtcttg,12
NC_037330.1,NC_032652.1,32011431,34594390,34594391,G,GT,1
NC_037330.1,NC_032652.1,32016952,34599906,34599907,g,ga,1
NC_037330.1,NC_032652.1,32023026,34606201,34606202,G,GC,1
NC_037330.1,NC_032652.1,32023325,34606501,34606502,A,AG,1
NC_037330.1,NC_032652.1,32023451,34606628,34606629,C,CA,1
NC_037330.1,NC_032652.1,32023797,34606977,34606978,T,TA,1
NC_037330.1,NC_032652.1,32023843,34607024,34607025,T,TA,1
NC_037330.1,NC_032652.1,32029214,34612926,34612927,g,gc,1
NC_037330.1,NC_032652.1,32031288,34615001,34615002,g,gt,1
NC_037330.1,NC_032652.1,32031898,34615613,34615615,g,gaa,2
NC_037330.1,NC_032652.1,32036726,34620443,34620444,A,AG,1
NC_037330.1,NC_032652.1,32046662,34628806,34628807,A,AM,1
NC_037330.1,NC_032652.1,32058415,34640576,34640577,T,TA,1
NC_037330.1,NC_032652.1,32066918,34649127,34649128,G,GR,1
NC_037330.1,NC_032652.1,32079656,34661871,34661873,c,ccg,2
NC_037330.1,NC_032652.1,32081251,34663469,34663470,A,AW,1
NC_037330.1,NC_032652.1,32135746,34726503,34726504,a,at,1
NC_037330.1,NC_032652.1,32143673,34734421,34734423,A,AAG,2
NC_037330.1,NC_032652.1,32183110,34773873,34773874,C,CA,1
NC_037330.1,NC_032652.1,32186152,34776917,34776918,g,ga,1
NC_037330.1,NC_032652.1,32192487,34783257,34783258,C,CG,1
NC_037330.1,NC_032652.1,32206776,34797560,34797563,t,tgtc,3
NC_037330.1,NC_032652.1,32215473,34806266,34806268,t,tta,2
NC_037330.1,NC_032652.1,32219163,34809959,34809960,C,CA,1
NC_037330.1,NC_032652.1,32242641,34833441,34833444,T,TTAA,3
NC_037330.1,NC_032652.1,32294103,34876278,34876279,T,TC,1
NC_037330.1,NC_032652.1,32367839,34947197,34947198,a,at,1
NC_037330.1,NC_032652.1,32436962,35077738,35077739,a,at,1
NC_037330.1,NC_032652.1,32438828,35079615,35079616,c,ct,1
NC_037330.1,NC_032652.1,32481098,35123174,35123175,t,ta,1
NC_037330.1,NC_032652.1,32609935,35252844,35252845,g,ga,1
NC_037330.1,NC_032652.1,32617553,35260463,35260464,t,tc,1
NC_037330.1,NC_032652.1,32617590,35260501,35260502,g,gt,1
NC_037330.1,NC_032652.1,32684035,35326950,35326965,a,aggcctccctgtccat,15
NC_037330.1,NC_032652.1,32733898,35376841,35376849,g,gaggaacta,8
NC_037330.1,NC_032652.1,32735951,35400559,35400561,a,act,2
NC_037330.1,NC_032652.1,32735963,35400573,35400574,a,ac,1
NC_037330.1,NC_032652.1,32924036,35598709,35598710,G,GS,1
NC_037330.1,NC_032652.1,32936885,35611559,35611565,c,ccccccg,6
NC_037330.1,NC_032652.1,32967612,35642074,35642075,G,GR,1
NC_037330.1,NC_032652.1,33034139,35707340,35707344,a,acttt,4
NC_037330.1,NC_032652.1,33175902,35849369,35849370,C,CT,1
NC_037330.1,NC_032652.1,33241068,35914540,35914541,G,GA,1
NC_037330.1,NC_032652.1,33308219,35981698,35981699,a,ag,1
NC_037330.1,NC_032652.1,33331945,36005426,36005427,a,ac,1
NC_037330.1,NC_032652.1,33336457,36009939,36009940,C,CM,1
NC_037330.1,NC_032652.1,33337064,36010548,36010550,c,cca,2
NC_037330.1,NC_032652.1,33533758,36208743,36208744,G,GT,1
NC_037330.1,NC_032652.1,33535773,36210759,36210760,G,GS,1
NC_037330.1,NC_032652.1,33677121,36358539,36358545,a,aNNNNNN,6
NC_037330.1,NC_032652.1,33765908,36447163,36447164,G,GS,1
NC_037330.1,NC_032652.1,33785466,36466698,36466699,t,tK,1
NC_037330.1,NC_032652.1,33953984,36634572,36634573,G,GC,1
NC_037330.1,NC_032652.1,33954114,36634704,36634705,T,TY,1
NC_037330.1,NC_032652.1,33959554,36640145,36640162,G,GTGAGCCTCTCTGTGAGS,17
NC_037330.1,NC_032652.1,34015414,36696604,36696605,A,AW,1
NC_037330.1,NC_032652.1,34035212,36716606,36716619,A,ATTACAGAGTTATT,13
NC_037330.1,NC_032652.1,34096173,36777572,36777574,a,aac,2
NC_037330.1,NC_032652.1,34096257,36777660,36777661,A,AW,1
NC_037330.1,NC_032652.1,34322710,37022978,37022979,c,ct,1
NC_037330.1,NC_032652.1,34410238,37098056,37098057,A,AT,1
NC_037330.1,NC_032652.1,34413700,37101517,37101518,t,tg,1
NC_037330.1,NC_032652.1,34777808,37467352,37467353,G,GA,1
NC_037330.1,NC_032652.1,34884940,37577046,37577047,c,ct,1
NC_037330.1,NC_032652.1,34976038,37668901,37668902,t,ta,1
NC_037330.1,NC_032652.1,34976380,37669245,37669256,t,ttttttttttgc,11
NC_037330.1,NC_032652.1,34976392,37669268,37669270,a,agg,2
NC_037330.1,NC_032652.1,34978983,37671851,37671853,a,agt,2
NC_037330.1,NC_032652.1,34979667,37672537,37672539,g,gaa,2
NC_037330.1,NC_032652.1,34980674,37673546,37673548,a,agg,2
NC_037330.1,NC_032652.1,35139437,37860586,37860587,t,ta,1
NC_037330.1,NC_032652.1,35255280,37978730,37978733,T,TACA,3
NC_037330.1,NC_032652.1,35255288,37978741,37978742,A,AG,1
NC_037330.1,NC_032652.1,35309151,38032528,38032529,t,tg,1
NC_037330.1,NC_032652.1,35496327,38109911,38109912,c,cT,1
NC_037330.1,NC_032652.1,35520280,38133794,38133795,T,TA,1
NC_037330.1,NC_032652.1,35561791,38392458,38392459,t,ta,1
NC_037330.1,NC_032652.1,35954556,38787467,38787473,G,GGCCACA,6
NC_037330.1,NC_032652.1,35955036,38787952,38787955,A,AGNN,3
NC_037330.1,NC_032652.1,36220098,39115252,39115253,g,gt,1
NC_037330.1,NC_032652.1,36298132,39193292,39193305,a,atgaaagtgaaaag,13
NC_037330.1,NC_032652.1,36304570,39199745,39199750,c,caactg,5
NC_037330.1,NC_032652.1,36305390,39200571,39200572,C,CG,1
NC_037330.1,NC_032652.1,36307701,39202884,39202898,A,ATGAAGGCAATTTCT,14
NC_037330.1,NC_032652.1,36378621,39273823,39273824,t,tc,1
NC_037330.1,NC_032652.1,36452271,39375254,39375255,a,ag,1
NC_037330.1,NC_032652.1,36785888,39706985,39706987,A,ACC,2
NC_037330.1,NC_032652.1,36909945,39829879,39829880,c,cg,1
NC_037330.1,NC_032652.1,36934830,39854987,39854988,a,ac,1
NC_037330.1,NC_032652.1,36934836,39854994,39854995,t,ta,1
NC_037330.1,NC_032652.1,37056306,39976892,39976893,a,at,1
NC_037330.1,NC_032652.1,37190848,40115880,40115881,T,TA,1
NC_037330.1,NC_032652.1,37233597,40158640,40158641,t,tg,1
NC_037330.1,NC_032652.1,37242216,40167259,40167260,t,tc,1
NC_037330.1,NC_032652.1,37265097,40189827,40189829,g,gga,2
NC_037330.1,NC_032652.1,37265102,40189834,40189835,g,ga,1
NC_037330.1,NC_032652.1,37343729,40268477,40268501,t,ttgactatgccaaagcctttgactg,24
NC_037330.1,NC_032652.1,37581910,40507081,40507092,t,tttttaatttta,11
NC_037330.1,NC_032652.1,37669287,40594818,40594819,T,TC,1
NC_037330.1,NC_032652.1,37690231,40611157,40611164,c,ctttcact,7
NC_037330.1,NC_032652.1,37692351,40613271,40613272,a,at,1
NC_037330.1,NC_032652.1,37699015,40619933,40619940,g,gaagggaa,7
NC_037330.1,NC_032652.1,37737792,40658733,40658738,c,ctgatg,5
NC_037330.1,NC_032652.1,37737938,40658883,40658884,A,AT,1
NC_037330.1,NC_032652.1,37747746,40668156,40668157,A,AM,1
NC_037330.1,NC_032652.1,37848770,40768894,40768910,t,ttctgggggGGGGggtc,16
NC_037330.1,NC_032652.1,37848862,40769002,40769006,c,cagcg,4
NC_037330.1,NC_032652.1,38141056,41048797,41048798,a,ag,1
NC_037330.1,NC_032652.1,38254342,41102921,41102922,G,GT,1
NC_037330.1,NC_032652.1,38254462,41103040,41103041,C,CT,1
NC_037330.1,NC_032652.1,38268791,41117371,41117372,G,GS,1
NC_037330.1,NC_032652.1,38330022,41177992,41177993,t,ta,1
NC_037330.1,NC_032652.1,38351872,41199857,41199858,c,ca,1
NC_037330.1,NC_032652.1,38363379,41211958,41211960,g,gga,2
NC_037330.1,NC_032652.1,38554138,41403145,41403146,a,at,1
NC_037330.1,NC_032652.1,38574142,41423149,41423150,g,ga,1
NC_037330.1,NC_032652.1,38687277,41536604,41536610,t,tNNNNNN,6
NC_037330.1,NC_032652.1,38825831,41675234,41675239,A,ACTTTT,5
NC_037330.1,NC_032652.1,39047732,41904667,41904670,c,caat,3
NC_037330.1,NC_032652.1,39161711,42020479,42020480,g,ga,1
NC_037330.1,NC_032652.1,39168846,42027614,42027616,a,att,2
NC_037330.1,NC_032652.1,39249813,42106856,42106857,c,cg,1
NC_037330.1,NC_032652.1,39357785,42220076,42220077,a,at,1
NC_037330.1,NC_032652.1,39363646,42225939,42225951,a,aaaagagagagag,12
NC_037330.1,NC_032652.1,39364655,42226960,42226961,t,ta,1
NC_037330.1,NC_032652.1,39427041,42287037,42287038,g,gt,1
NC_037330.1,NC_032652.1,39764993,42624523,42624526,g,gtct,3
NC_037330.1,NC_032652.1,39825653,42704020,42704021,t,ta,1
NC_037330.1,NC_032652.1,39843285,42721656,42721657,a,ag,1
NC_037330.1,NC_032652.1,39878348,42756707,42756714,T,TAATCTAA,7
NC_037330.1,NC_032652.1,39904498,42782865,42782866,T,TK,1
NC_037330.1,NC_032652.1,39907245,42785616,42785617,T,TA,1
NC_037330.1,NC_032652.1,39909178,42787550,42787560,g,gggacaacaga,10
NC_037330.1,NC_032652.1,39909970,42788352,42788354,a,aac,2
NC_037330.1,NC_032652.1,39910870,42789263,42789264,t,ta,1
NC_037330.1,NC_032652.1,39911617,42790011,42790012,T,TK,1
NC_037330.1,NC_032652.1,39911911,42790308,42790309,g,ga,1
NC_037330.1,NC_032652.1,39954903,42833310,42833313,c,cttt,3
NC_037330.1,NC_032652.1,39965079,42844458,42844483,t,ttctagctctgtgaagaatactgttg,25
NC_037330.1,NC_032652.1,39965280,42844684,42844687,a,attc,3
NC_037330.1,NC_032652.1,39965320,42844727,42844731,c,ctctt,4
NC_037330.1,NC_032652.1,39965422,42844833,42844834,t,tc,1
NC_037330.1,NC_032652.1,39968232,42847643,42847644,c,ct,1
NC_037330.1,NC_032652.1,39968304,42847716,42847717,c,ct,1
NC_037330.1,NC_032652.1,39987870,42867315,42867317,t,tta,2
NC_037330.1,NC_032652.1,39987914,42867361,42867362,c,ct,1
NC_037330.1,NC_032652.1,39999940,42879373,42879374,c,ct,1
NC_037330.1,NC_032652.1,39999940,42884812,42884813,c,ct,1
NC_037330.1,NC_032652.1,40017265,42901969,42901970,A,AG,1
NC_037330.1,NC_032652.1,40017609,42902316,42902317,T,TC,1
NC_037330.1,NC_032652.1,40018971,42903679,42903681,t,tta,2
NC_037330.1,NC_032652.1,40019495,42904204,42904205,t,tc,1
NC_037330.1,NC_032652.1,40019531,42904241,42904242,A,AG,1
NC_037330.1,NC_032652.1,40023626,42905508,42905509,C,CT,1
NC_037330.1,NC_032652.1,40032640,42914517,42914518,c,ct,1
NC_037330.1,NC_032652.1,40032731,42914610,42914611,t,tg,1
NC_037330.1,NC_032652.1,40032753,42914633,42914634,t,tg,1
NC_037330.1,NC_032652.1,40042028,42927631,42927632,t,tg,1
NC_037330.1,NC_032652.1,40046189,42931797,42931798,a,ag,1
NC_037330.1,NC_032652.1,40052867,42938478,42938479,c,ct,1
NC_037330.1,NC_032652.1,40066373,42951661,42951667,a,aNNNNNN,6
NC_037330.1,NC_032652.1,40091208,42987023,42987024,t,ta,1
NC_037330.1,NC_032652.1,40101019,42996824,42996838,C,CAGTGCCTGATATAT,14
NC_037330.1,NC_032652.1,40123553,43019712,43019715,C,CCAA,3
NC_037330.1,NC_032652.1,40140315,43036480,43036487,t,taagtttg,7
NC_037330.1,NC_032652.1,40146688,43042914,43042915,A,AT,1
NC_037330.1,NC_032652.1,40162870,43059107,43059108,t,ta,1
NC_037330.1,NC_032652.1,40206019,43102250,43102251,G,GR,1
NC_037330.1,NC_032652.1,40276952,43175107,43175108,C,CA,1
NC_037330.1,NC_032652.1,40306013,43204172,43204177,t,tgtgtg,5
NC_037330.1,NC_032652.1,40323352,43221519,43221520,t,tc,1
NC_037330.1,NC_032652.1,40331157,43229326,43229329,a,attt,3
NC_037330.1,NC_032652.1,40342479,43240511,43240512,c,cg,1
NC_037330.1,NC_032652.1,40345102,43243135,43243137,a,aac,2
NC_037330.1,NC_032652.1,40348114,43246150,43246151,t,tc,1
NC_037330.1,NC_032652.1,40381167,43279884,43279885,a,at,1
NC_037330.1,NC_032652.1,40381968,43280686,43280688,C,CTT,2
NC_037330.1,NC_032652.1,40386264,43284985,43284986,t,ta,1
NC_037330.1,NC_032652.1,40387390,43286112,43286116,a,aacac,4
NC_037330.1,NC_032652.1,40393557,43292278,43292279,A,AR,1
NC_037330.1,NC_032652.1,40421707,43320416,43320425,t,tatatatata,9
NC_037330.1,NC_032652.1,40429250,43327965,43327966,A,AG,1
NC_037330.1,NC_032652.1,40444949,43343662,43343666,C,CAGAT,4
NC_037330.1,NC_032652.1,40494100,43392817,43392819,t,tNN,2
NC_037330.1,NC_032652.1,40546407,43445135,43445136,C,CA,1
NC_037330.1,NC_032652.1,40619905,43522458,43522459,c,ct,1
NC_037330.1,NC_032652.1,40817508,43727068,43727069,g,gc,1
NC_037330.1,NC_032652.1,40954018,43859734,43859735,g,ga,1
NC_037330.1,NC_032652.1,40955827,43861544,43861546,t,tgg,2
NC_037330.1,NC_032652.1,41031661,43937406,43937407,T,TA,1
NC_037330.1,NC_032652.1,41064752,43970432,43970433,C,CA,1
NC_037330.1,NC_032652.1,41159404,44064285,44064286,a,ag,1
NC_037330.1,NC_032652.1,41432607,44337240,44337241,T,TA,1
NC_037330.1,NC_032652.1,41601169,44512046,44512047,a,ag,1
NC_037330.1,NC_032652.1,41601849,44512727,44512728,a,ac,1
NC_037330.1,NC_032652.1,41723500,44633497,44633499,g,ggt,2
NC_037330.1,NC_032652.1,41818779,44767612,44767613,c,ca,1
NC_037330.1,NC_032652.1,41852809,44801587,44801589,a,aat,2
NC_037330.1,NC_032652.1,41915593,44864372,44864373,t,ta,1
NC_037330.1,NC_032652.1,41957564,44906300,44906302,c,cct,2
NC_037330.1,NC_032652.1,42135301,45084896,45084898,a,atg,2
NC_037330.1,NC_032652.1,42234162,45183900,45183901,g,gt,1
NC_037330.1,NC_032652.1,42234182,45183921,45183922,a,ag,1
NC_037330.1,NC_032652.1,42234195,45183935,45183936,t,tg,1
NC_037330.1,NC_032652.1,42234204,45183945,45183946,t,tA,1
NC_037330.1,NC_032652.1,42325916,45276718,45276719,G,GA,1
NC_037330.1,NC_032652.1,42326043,45276847,45276848,C,CA,1
NC_037330.1,NC_032652.1,42505684,45456625,45456626,C,CM,1
NC_037330.1,NC_032652.1,42508684,45459624,45459625,t,tg,1
NC_037330.1,NC_032652.1,42513137,45464078,45464079,a,ag,1
NC_037330.1,NC_032652.1,42780383,45731334,45731335,t,tW,1
NC_037330.1,NC_032652.1,43120119,46069883,46069884,G,GA,1
NC_037330.1,NC_032652.1,43378040,46342701,46342702,g,ga,1
NC_037330.1,NC_032652.1,43411954,46376349,46376350,A,AR,1
NC_037330.1,NC_032652.1,43463976,46440163,46440164,A,AN,1
NC_037330.1,NC_032652.1,43463996,46440184,46440185,C,CA,1
NC_037330.1,NC_032652.1,43492280,46468471,46468473,t,tNN,2
NC_037330.1,NC_032652.1,43657922,46634749,46634750,t,ta,1
NC_037330.1,NC_032652.1,43675287,46652147,46652148,A,AR,1
NC_037330.1,NC_032652.1,43748452,46725219,46725220,t,tc,1
NC_037330.1,NC_032652.1,43803359,46780127,46780128,t,ta,1
NC_037330.1,NC_032652.1,43825645,46802415,46802417,g,gtc,2
NC_037330.1,NC_032652.1,43825693,46802465,46802468,a,aacc,3
NC_037330.1,NC_032652.1,43925982,46902757,46902758,A,AT,1
NC_037330.1,NC_032652.1,44032850,47009705,47009706,t,ta,1
NC_037330.1,NC_032652.1,44095677,47072533,47072534,g,gt,1
NC_037330.1,NC_032652.1,44345101,47320253,47320254,A,AR,1
NC_037330.1,NC_032652.1,44345193,47320346,47320347,G,GR,1
NC_037330.1,NC_032652.1,44390625,47364545,47364546,T,TK,1
NC_037330.1,NC_032652.1,44401696,47375616,47375617,c,ca,1
NC_037330.1,NC_032652.1,44401737,47375658,47375659,a,at,1
NC_037330.1,NC_032652.1,44605957,47582210,47582211,g,ga,1
NC_037330.1,NC_032652.1,44665216,47641427,47641428,t,tg,1
NC_037330.1,NC_032652.1,44683794,47660005,47660009,a,agaag,4
NC_037330.1,NC_032652.1,44684378,47660593,47660594,g,gt,1
NC_037330.1,NC_032652.1,44745097,47721312,47721313,C,CA,1
NC_037330.1,NC_032652.1,44887278,47853266,47853268,G,GTC,2
NC_037330.1,NC_032652.1,44975285,47941050,47941052,t,tNN,2
NC_037330.1,NC_032652.1,44981194,47946956,47946957,A,AR,1
NC_037330.1,NC_032652.1,45101371,48067876,48067879,t,tagc,3
NC_037330.1,NC_032652.1,45135407,48101916,48101917,t,tc,1
NC_037330.1,NC_032652.1,45259614,48249598,48249599,T,TA,1
NC_037330.1,NC_032652.1,45510507,48506237,48506238,T,TW,1
NC_037330.1,NC_032652.1,45709191,48704926,48704927,C,CM,1
NC_037330.1,NC_032652.1,45856263,48945144,48945145,T,TC,1
NC_037330.1,NC_032652.1,46219037,49313230,49313231,a,at,1
NC_037330.1,NC_032652.1,46251792,49345986,49345990,t,tNNNN,4
NC_037330.1,NC_032652.1,46507972,49601898,49601899,A,AT,1
NC_037330.1,NC_032652.1,46560623,49656473,49656474,c,ct,1
NC_037330.1,NC_032652.1,46560707,49656558,49656559,g,ga,1
NC_037330.1,NC_032652.1,46581079,49676942,49676944,a,aac,2
NC_037330.1,NC_032652.1,46605986,49701850,49701851,t,tK,1
NC_037330.1,NC_032652.1,46615708,49711569,49711570,a,at,1
NC_037330.1,NC_032652.1,46630409,49726271,49726276,T,TTATGC,5
NC_037330.1,NC_032652.1,46655199,49751267,49751272,g,gaaaaa,5
NC_037330.1,NC_032652.1,46681451,49777516,49777517,T,TW,1
NC_037330.1,NC_032652.1,46686481,49782546,49782547,C,CG,1
NC_037330.1,NC_032652.1,46686706,49782772,49782773,a,aR,1
NC_037330.1,NC_032652.1,46713755,49809766,49809767,C,CA,1
NC_037330.1,NC_032652.1,46719303,49815316,49815319,g,gggc,3
NC_037330.1,NC_032652.1,46750145,49846167,49846168,g,gt,1
NC_037330.1,NC_032652.1,46777829,49873867,49873868,c,ca,1
NC_037330.1,NC_032652.1,46780373,49876412,49876413,G,GT,1
NC_037330.1,NC_032652.1,46780390,49876430,49876431,T,TY,1
NC_037330.1,NC_032652.1,46782198,49878237,49878238,A,AT,1
NC_037330.1,NC_032652.1,46782265,49878305,49878306,C,CT,1
NC_037330.1,NC_032652.1,46782373,49878414,49878415,C,CT,1
NC_037330.1,NC_032652.1,46783004,49879041,49879042,a,at,1
NC_037330.1,NC_032652.1,46783056,49879093,49879094,c,ct,1
NC_037330.1,NC_032652.1,46783354,49879392,49879393,a,at,1
NC_037330.1,NC_032652.1,46783400,49879439,49879440,A,AY,1
NC_037330.1,NC_032652.1,46783710,49879748,49879750,c,cag,2
NC_037330.1,NC_032652.1,46811739,49890106,49890116,A,AATTTGAAAAC,10
NC_037330.1,NC_032652.1,46812840,49891218,49891221,g,ggaa,3
NC_037330.1,NC_032652.1,46813508,49891891,49891894,T,TGTG,3
NC_037330.1,NC_032652.1,46815558,49893944,49893945,t,tc,1
NC_037330.1,NC_032652.1,46834762,49913160,49913161,c,ct,1
NC_037330.1,NC_032652.1,46879760,49958164,49958165,a,at,1
NC_037330.1,NC_032652.1,46897713,49976023,49976025,C,CCA,2
NC_037330.1,NC_032652.1,46981360,50058722,50058728,C,CAGTAGT,6
NC_037330.1,NC_032652.1,46988529,50065898,50065904,c,cacatat,6
NC_037330.1,NC_032652.1,46989730,50067105,50067106,A,AG,1
NC_037330.1,NC_032652.1,46992907,50070284,50070285,t,tY,1
NC_037330.1,NC_032652.1,47007004,50084383,50084384,G,GA,1
NC_037330.1,NC_032652.1,47007517,50084897,50084898,G,GA,1
NC_037330.1,NC_032652.1,47041405,50175497,50175498,g,gt,1
NC_037330.1,NC_032652.1,47051043,50111001,50111003,t,tta,2
NC_037330.1,NC_032652.1,47051061,50111021,50111022,T,TC,1
NC_037330.1,NC_032652.1,47051067,50111028,50111029,T,TA,1
NC_037330.1,NC_032652.1,47058466,50118427,50118428,T,TC,1
NC_037330.1,NC_032652.1,47060039,50120001,50120002,t,ta,1
NC_037330.1,NC_032652.1,47061561,50121524,50121536,T,TTTAAAAGTCTGA,12
NC_037330.1,NC_032652.1,47090901,50152825,50152826,C,CY,1
NC_037330.1,NC_032652.1,47178591,50272669,50272670,G,GT,1
NC_037330.1,NC_032652.1,47184433,50278512,50278513,A,AG,1
NC_037330.1,NC_032652.1,47185891,50279972,50279973,T,TY,1
NC_037330.1,NC_032652.1,47203828,50297910,50297913,c,cact,3
NC_037330.1,NC_032652.1,47204531,50298616,50298618,g,gca,2
NC_037330.1,NC_032652.1,47219850,50313930,50313932,G,GAC,2
NC_037330.1,NC_032652.1,47239568,50337284,50337285,t,ta,1
NC_037330.1,NC_032652.1,47244008,50341353,50341354,C,CT,1
NC_037330.1,NC_032652.1,47268970,50366317,50366318,A,AR,1
NC_037330.1,NC_032652.1,47317627,50414813,50414815,c,cta,2
NC_037330.1,NC_032652.1,47359285,50456533,50456534,T,TA,1
NC_037330.1,NC_032652.1,47361772,50459022,50459030,T,TTGAAATCA,8
NC_037330.1,NC_032652.1,47373800,50471056,50471057,t,tc,1
NC_037330.1,NC_032652.1,47375993,50473239,50473240,G,GC,1
NC_037330.1,NC_032652.1,47406649,50505396,50505397,t,ta,1
NC_037330.1,NC_032652.1,47429428,50528211,50528212,A,AG,1
NC_037330.1,NC_032652.1,47495882,50646600,50646601,A,AG,1
NC_037330.1,NC_032652.1,47498813,50649530,50649531,A,AW,1
NC_037330.1,NC_032652.1,47510710,50661431,50661433,G,GTA,2
NC_037330.1,NC_032652.1,47522391,50673117,50673118,A,AT,1
NC_037330.1,NC_032652.1,47561017,50711733,50711739,t,tgaagcc,6
NC_037330.1,NC_032652.1,47676109,50833165,50833167,G,GGR,2
NC_037330.1,NC_032652.1,47693816,50850774,50850776,a,aag,2
NC_037330.1,NC_032652.1,47745918,50902894,50902898,a,acaag,4
NC_037330.1,NC_032652.1,47828343,51000252,51000258,a,aNNNNNN,6
NC_037330.1,NC_032652.1,47865331,51037245,51037246,T,TW,1
NC_037330.1,NC_032652.1,47866455,51038369,51038370,T,TK,1
NC_037330.1,NC_032652.1,47931250,51139021,51139022,T,TW,1
NC_037330.1,NC_032652.1,47973234,51180114,51180115,C,CG,1
NC_037330.1,NC_032652.1,47974213,51181095,51181098,g,gtta,3
NC_037330.1,NC_032652.1,47976858,51183747,51183749,C,CCA,2
NC_037330.1,NC_032652.1,48076774,51283298,51283299,T,TG,1
NC_037330.1,NC_032652.1,48102163,51308509,51308510,A,AG,1
NC_037330.1,NC_032652.1,48111121,51317839,51317865,G,GAGCTTTGTGGGGCTTTATTCACTGTR,26
NC_037330.1,NC_032652.1,48113476,51320221,51320222,G,GC,1
NC_037330.1,NC_032652.1,48119561,51326303,51326309,A,ATCTAAG,6
NC_037330.1,NC_032652.1,48159496,51366172,51366173,t,ta,1
NC_037330.1,NC_032652.1,48175213,51381889,51381890,A,AG,1
NC_037330.1,NC_032652.1,48179914,51386591,51386592,c,ct,1
NC_037330.1,NC_032652.1,48244864,51451531,51451532,c,ct,1
NC_037330.1,NC_032652.1,48277120,51483982,51483983,g,gt,1
NC_037330.1,NC_032652.1,48306394,51513222,51513227,a,atatgc,5
NC_037330.1,NC_032652.1,48355814,51563203,51563206,G,GGGA,3
NC_037330.1,NC_032652.1,48433321,51640532,51640533,C,CA,1
NC_037330.1,NC_032652.1,48433324,51640536,51640539,G,GGAT,3
NC_037330.1,NC_032652.1,48433600,51640815,51640816,c,ct,1
NC_037330.1,NC_032652.1,48435627,51642843,51642844,G,GC,1
NC_037330.1,NC_032652.1,48488514,51696084,51696085,c,ca,1
NC_037330.1,NC_032652.1,48522195,51730391,51730395,c,ctcta,4
NC_037330.1,NC_032652.1,48708517,51931883,51931884,a,ag,1
NC_037330.1,NC_032652.1,49030946,52338222,52338223,g,ga,1
NC_037330.1,NC_032652.1,49089692,52396019,52396020,a,aN,1
NC_037330.1,NC_032652.1,49121166,52427498,52427499,A,AG,1
NC_037330.1,NC_032652.1,49165224,52471548,52471558,c,ccccccccccg,10
NC_037330.1,NC_032652.1,49388089,52677140,52677153,G,GTTCCAAGCCTCGA,13
NC_037330.1,NC_032652.1,49438307,52745735,52745743,C,CCCAGCAGG,8
NC_037330.1,NC_032652.1,49444823,52752259,52752261,c,ctg,2
NC_037330.1,NC_032652.1,49988403,53348406,53348408,c,cca,2
NC_037330.1,NC_032652.1,50064005,53423947,53423950,C,CCTT,3
NC_037330.1,NC_032652.1,50464144,53829229,53829230,A,AG,1
NC_037330.1,NC_032652.1,50475809,53840896,53840897,t,ta,1
NC_037330.1,NC_032652.1,50573387,53938084,53938085,t,tg,1
NC_037330.1,NC_032652.1,50618576,53982946,53982947,g,ga,1
NC_037330.1,NC_032652.1,50626176,53990549,53990555,t,tNNNNNN,6
NC_037330.1,NC_032652.1,50683118,54063714,54063715,c,ca,1
NC_037330.1,NC_032652.1,50819101,54192389,54192394,T,TAAGTA,5
NC_037330.1,NC_032652.1,50898322,54271629,54271630,t,tg,1
NC_037330.1,NC_032652.1,51105146,54540824,54540831,g,gggaggga,7
NC_037330.1,NC_032652.1,51203793,54639252,54639253,a,at,1
NC_037330.1,NC_032652.1,51402315,54837554,54837556,C,CCT,2
NC_037330.1,NC_032652.1,51449118,54884365,54884369,t,tNNNN,4
NC_037330.1,NC_032652.1,51454454,54889705,54889709,C,CTAGT,4
NC_037330.1,NC_032652.1,51592725,55027340,55027341,g,gt,1
NC_037330.1,NC_032652.1,51629529,55064252,55064253,a,at,1
NC_037330.1,NC_032652.1,51652403,55087128,55087136,A,AGAGGTCAT,8
NC_037330.1,NC_032652.1,51783960,55218702,55218703,c,ct,1
NC_037330.1,NC_032652.1,51793599,55228342,55228343,c,ca,1
NC_037330.1,NC_032652.1,51802251,55236995,55236996,C,CG,1
NC_037330.1,NC_032652.1,52005289,55439820,55439823,T,TAGG,3
NC_037330.1,NC_032652.1,52088491,55523192,55523194,C,CTG,2
NC_037330.1,NC_032652.1,52092765,55527468,55527472,C,CAACT,4
NC_037330.1,NC_032652.1,52153071,55587783,55587787,a,atatg,4
NC_037330.1,NC_032652.1,52247752,55682496,55682497,t,tN,1
NC_037330.1,NC_032652.1,52386612,55821215,55821216,t,ta,1
NC_037330.1,NC_032652.1,52431169,55865478,55865479,t,ta,1
NC_037330.1,NC_032652.1,52618843,56053508,56053509,a,ag,1
NC_037330.1,NC_032652.1,52824338,56217984,56217985,c,ct,1
NC_037330.1,NC_032652.1,52891086,56287941,56287942,G,GC,1
NC_037330.1,NC_032652.1,53444130,56832492,56832499,C,CACCCTNN,7
NC_037330.1,NC_032652.1,53503208,56902404,56902405,c,ca,1
NC_037330.1,NC_032652.1,53738879,57138563,57138567,c,ctcaa,4
NC_037330.1,NC_032652.1,53739078,57138767,57138769,c,ctt,2
NC_037330.1,NC_032652.1,53774225,57173915,57173916,A,AG,1
NC_037330.1,NC_032652.1,53841450,57241556,57241557,a,at,1
NC_037330.1,NC_032652.1,53896228,57296463,57296465,g,gct,2
NC_037330.1,NC_032652.1,53933533,57333771,57333772,a,ag,1
NC_037330.1,NC_032652.1,53933538,57333777,57333778,g,gc,1
NC_037330.1,NC_032652.1,53933555,57333795,57333796,t,tc,1
NC_037330.1,NC_032652.1,53965295,57365540,57365542,t,ttg,2
NC_037330.1,NC_032652.1,53968070,57368314,57368315,t,tg,1
NC_037330.1,NC_032652.1,54135966,57536167,57536180,g,gaTTGACTATCACC,13
NC_037330.1,NC_032652.1,54168769,57569092,57569093,g,ga,1
NC_037330.1,NC_032652.1,54206030,57623485,57623486,A,AG,1
NC_037330.1,NC_032652.1,54226816,57644269,57644270,T,TA,1
NC_037330.1,NC_032652.1,54227403,57644857,57644858,T,TA,1
NC_037330.1,NC_032652.1,54228775,57646215,57646216,T,TG,1
NC_037330.1,NC_032652.1,54229620,57647042,57647043,T,TW,1
NC_037330.1,NC_032652.1,54384544,58199063,58199064,G,GC,1
NC_037330.1,NC_032652.1,54385075,58199586,58199600,C,CCTTGACTGTTAAAA,14
NC_037330.1,NC_032652.1,54428488,58243121,58243122,A,AT,1
NC_037330.1,NC_032652.1,54433298,58247755,58247764,C,CGGAARGAGG,9
NC_037330.1,NC_032652.1,54448073,58262539,58262540,g,gc,1
NC_037330.1,NC_032652.1,54450777,58265265,58265267,g,gga,2
NC_037330.1,NC_032652.1,54453155,58267643,58267645,g,gaa,2
NC_037330.1,NC_032652.1,54453885,58268374,58268377,c,cttg,3
NC_037330.1,NC_032652.1,54455381,58269881,58269884,t,ttga,3
NC_037330.1,NC_032652.1,54455637,58270140,58270141,t,tc,1
NC_037330.1,NC_032652.1,54458479,58272981,58272982,T,TN,1
NC_037330.1,NC_032652.1,54458479,57643147,57643148,T,TN,1
NC_037330.1,NC_032652.1,54458571,58273074,58273075,a,at,1
NC_037330.1,NC_032652.1,54458571,57643240,57643241,a,at,1
NC_037330.1,NC_032652.1,54468516,57653202,57653203,a,at,1
NC_037330.1,NC_032652.1,54468579,57653266,57653267,C,CA,1
NC_037330.1,NC_032652.1,54469832,57654520,57654527,G,GGGTTAAA,7
NC_037330.1,NC_032652.1,54516396,57714903,57714904,G,GS,1
NC_037330.1,NC_032652.1,54524066,57722574,57722575,c,ca,1
NC_037330.1,NC_032652.1,54574116,57774663,57774665,a,aNN,2
NC_037330.1,NC_032652.1,54651013,57892771,57892772,t,tg,1
NC_037330.1,NC_032652.1,54651046,57892805,57892806,t,ta,1
NC_037330.1,NC_032652.1,54651061,57892821,57892826,a,aatttt,5
NC_037330.1,NC_032652.1,54655306,57897071,57897072,T,TA,1
NC_037330.1,NC_032652.1,54662726,57904492,57904493,a,at,1
NC_037330.1,NC_032652.1,54662740,57904507,57904509,t,ttc,2
NC_037330.1,NC_032652.1,54662750,57904519,57904524,a,atttat,5
NC_037330.1,NC_032652.1,54663511,57905285,57905286,A,AG,1
NC_037330.1,NC_032652.1,54663511,58123764,58123765,A,AG,1
NC_037330.1,NC_032652.1,54669268,58129523,58129524,a,ag,1
NC_037330.1,NC_032652.1,54852566,58106130,58106134,t,tcatc,4
NC_037330.1,NC_032652.1,54852683,58106251,58106252,g,ga,1
NC_037330.1,NC_032652.1,54858218,58111786,58111787,C,CT,1
NC_037330.1,NC_032652.1,54858696,58112265,58112266,A,AC,1
NC_037330.1,NC_032652.1,54858799,58112369,58112370,g,ga,1
NC_037330.1,NC_032652.1,54859018,58112590,58112591,t,ta,1
NC_037330.1,NC_032652.1,55155384,58575334,58575336,c,ctt,2
NC_037330.1,NC_032652.1,55272291,58739994,58740006,a,aggaAANNNNNNN,12
NC_037330.1,NC_032652.1,55299494,58767383,58767386,t,tcac,3
NC_037330.1,NC_032652.1,55383235,58850083,58850084,c,ct,1
NC_037330.1,NC_032652.1,55501136,58989496,58989498,g,gaa,2
NC_037330.1,NC_032652.1,55531589,59019972,59019974,C,CTA,2
NC_037330.1,NC_032652.1,55532493,59020878,59020880,t,taa,2
NC_037330.1,NC_032652.1,55532532,59020919,59020920,G,GA,1
NC_037330.1,NC_032652.1,55532534,59020922,59020923,A,AT,1
NC_037330.1,NC_032652.1,55536690,59025079,59025080,a,ag,1
NC_037330.1,NC_032652.1,55545495,59033885,59033886,g,ga,1
NC_037330.1,NC_032652.1,55545497,59033888,59033889,a,ag,1
NC_037330.1,NC_032652.1,55612346,59101088,59101089,g,gt,1
NC_037330.1,NC_032652.1,55697865,59189439,59189440,g,gt,1
NC_037330.1,NC_032652.1,56325046,59836537,59836538,g,gc,1
NC_037330.1,NC_032652.1,56332617,59844104,59844118,g,gagtatactacccaa,14
NC_037330.1,NC_032652.1,56333316,59844816,59844817,a,at,1
NC_037330.1,NC_032652.1,56529623,60017517,60017519,a,aNN,2
NC_037330.1,NC_032652.1,56955527,60442506,60442507,A,AG,1
NC_037330.1,NC_032652.1,56961805,60448784,60448788,T,TGTCA,4
NC_037330.1,NC_032652.1,56973030,60460014,60460015,c,ca,1
NC_037330.1,NC_032652.1,56985240,60472232,60472233,t,tc,1
NC_037330.1,NC_032652.1,56990947,60477938,60477939,T,TC,1
NC_037330.1,NC_032652.1,57055375,60544333,60544336,g,gaca,3
NC_037330.1,NC_032652.1,57064797,60553229,60553230,a,aK,1
NC_037330.1,NC_032652.1,57164046,60659128,60659129,g,gt,1
NC_037330.1,NC_032652.1,57251958,60747728,60747733,A,ATAAAT,5
NC_037330.1,NC_032652.1,57272568,60768746,60768747,t,tc,1
NC_037330.1,NC_032652.1,57272571,60768750,60768751,a,at,1
NC_037330.1,NC_032652.1,57332171,60835290,60835291,c,ca,1
NC_037330.1,NC_032652.1,57447776,60951743,60951744,c,ct,1
NC_037330.1,NC_032652.1,57467473,60971437,60971439,G,GNN,2
NC_037330.1,NC_032652.1,57819374,61385707,61385708,T,TW,1
NC_037330.1,NC_032652.1,57935219,61480952,61480953,t,tg,1
NC_037330.1,NC_032652.1,57958081,61503766,61503768,g,gaa,2
NC_037330.1,NC_032652.1,57963840,61510467,61510468,t,tg,1
NC_037330.1,NC_032652.1,57969832,61516460,61516466,g,gtgctgc,6
NC_037330.1,NC_032652.1,57978700,61525334,61525335,c,ct,1
NC_037330.1,NC_032652.1,58000972,61547607,61547619,g,gtttttttttttt,12
NC_037330.1,NC_032652.1,58005445,61552601,61552604,a,atag,3
NC_037330.1,NC_032652.1,58005518,61552680,61552689,c,cataaaaata,9
NC_037330.1,NC_032652.1,58017321,61564370,61564371,G,GC,1
NC_037330.1,NC_032652.1,58054459,61601516,61601519,C,CTTT,3
NC_037330.1,NC_032652.1,58092675,61641066,61641067,G,GS,1
NC_037330.1,NC_032652.1,58191289,61739689,61739690,c,ct,1
NC_037330.1,NC_032652.1,58201020,61749421,61749422,a,ag,1
NC_037330.1,NC_032652.1,58213229,61761628,61761629,A,AG,1
NC_037330.1,NC_032652.1,58282077,61830852,61830853,c,ct,1
NC_037330.1,NC_032652.1,58350362,61898904,61898909,a,aNNNNN,5
NC_037330.1,NC_032652.1,58428376,61977122,61977123,T,TA,1
NC_037330.1,NC_032652.1,58473958,62022718,62022719,T,TA,1
NC_037330.1,NC_032652.1,58517444,62066205,62066206,c,ca,1
NC_037330.1,NC_032652.1,58517484,62066246,62066248,c,ctt,2
NC_037330.1,NC_032652.1,59099898,62691279,62691283,t,tacaA,4
NC_037330.1,NC_032652.1,59247887,62990520,62990521,A,AY,1
NC_037330.1,NC_032652.1,59249407,62992041,62992049,c,ctgactctg,8
NC_037330.1,NC_032652.1,59249437,62992079,62992081,c,cct,2
NC_037330.1,NC_032652.1,59256284,62998907,62998963,A,AGTTACAGAGGTGCTGAGGTATGCAGGCCCCTCCATATGATGCTTAAAGAGGAATCT,56
NC_037330.1,NC_032652.1,59527971,63272788,63272790,t,tta,2
NC_037330.1,NC_032652.1,59532978,63277827,63277828,a,at,1
NC_037330.1,NC_032652.1,59556329,63524181,63524182,g,ga,1
NC_037330.1,NC_032652.1,59556352,63524205,63524206,a,at,1
NC_037330.1,NC_032652.1,59628314,63596170,63596171,A,AT,1
NC_037330.1,NC_032652.1,59633915,63601772,63601773,G,GR,1
NC_037330.1,NC_032652.1,59668344,63636628,63636629,A,AG,1
NC_037330.1,NC_032652.1,59746226,63714408,63714412,G,GCTGT,4
NC_037330.1,NC_032652.1,59814603,63782927,63782931,c,cacaa,4
NC_037330.1,NC_032652.1,59909796,63878127,63878131,a,agatt,4
NC_037330.1,NC_032652.1,59918403,63903646,63903647,G,GA,1
NC_037330.1,NC_032652.1,59928576,63913823,63913825,T,TTA,2
NC_037330.1,NC_032652.1,59932448,63918124,63918125,t,tc,1
NC_037330.1,NC_032652.1,59936487,63922165,63922166,A,AM,1
NC_037330.1,NC_032652.1,59940874,63926553,63926554,t,tg,1
NC_037330.1,NC_032652.1,59986436,63986826,63986827,A,AC,1
NC_037330.1,NC_032652.1,60037285,64038256,64038257,c,ct,1
NC_037330.1,NC_032652.1,60045041,64062049,64062050,a,ac,1
NC_037330.1,NC_032652.1,60050375,64067386,64067387,g,gc,1
NC_037330.1,NC_032652.1,60067571,64084585,64084589,t,tgttg,4
NC_037330.1,NC_032652.1,60079224,64096252,64096253,g,ga,1
NC_037330.1,NC_032652.1,60138442,64159451,64159452,T,TA,1
NC_037330.1,NC_032652.1,60188114,64208319,64208321,C,CTA,2
NC_037330.1,NC_032652.1,60207160,64227366,64227370,t,tKttg,4
NC_037330.1,NC_032652.1,60207166,64227376,64227377,g,gt,1
NC_037330.1,NC_032652.1,60210236,64230447,64230448,T,TA,1
NC_037330.1,NC_032652.1,60224451,64244668,64244669,c,ca,1
NC_037330.1,NC_032652.1,60233322,64253545,64253548,C,CTTA,3
NC_037330.1,NC_032652.1,60234346,64254572,64254574,a,aat,2
NC_037330.1,NC_032652.1,60237943,64258173,64258174,g,gt,1
NC_037330.1,NC_032652.1,60239480,64259713,64259714,a,at,1
NC_037330.1,NC_032652.1,60288022,64308699,64308701,c,cca,2
NC_037330.1,NC_032652.1,60297298,64317977,64317978,A,AG,1
NC_037330.1,NC_032652.1,60372402,64393122,64393125,g,gaaa,3
NC_037330.1,NC_032652.1,60399513,64419892,64419896,t,tNNNN,4
NC_037330.1,NC_032652.1,60406071,64426456,64426459,A,AGGT,3
NC_037330.1,NC_032652.1,60442873,64463249,64463274,C,CTTGGACTGGTCTccattgtggtggt,25
NC_037330.1,NC_032652.1,60455116,64475516,64475520,T,TAAAC,4
NC_037330.1,NC_032652.1,60485154,64505618,64505619,g,ga,1
NC_037330.1,NC_032652.1,60486603,64507067,64507069,a,att,2
NC_037330.1,NC_032652.1,60487851,64508314,64508315,T,TA,1
NC_037330.1,NC_032652.1,60490546,64511016,64511018,c,cta,2
NC_037330.1,NC_032652.1,60507430,64527904,64527905,A,AT,1
NC_037330.1,NC_032652.1,60531744,64552218,64552219,T,TA,1
NC_037330.1,NC_032652.1,60531941,64552414,64552415,T,TA,1
NC_037330.1,NC_032652.1,60547111,64567583,64567586,C,CCTT,3
NC_037330.1,NC_032652.1,60588220,64608696,64608697,T,TG,1
NC_037330.1,NC_032652.1,60588287,64608764,64608766,t,taa,2
NC_037330.1,NC_032652.1,60618651,64660835,64660839,t,tNNNN,4
NC_037330.1,NC_032652.1,60642503,64684694,64684700,t,tcagcag,6
NC_037330.1,NC_032652.1,60664374,64706575,64706576,g,gt,1
NC_037330.1,NC_032652.1,60688170,64730470,64730493,C,CCCTGCTAAGAGAAGAATTCAGAA,23
NC_037330.1,NC_032652.1,60694758,64737076,64737077,A,AT,1
NC_037330.1,NC_032652.1,60709407,64751718,64751720,g,gta,2
NC_037330.1,NC_032652.1,60720508,64762572,64762573,C,CT,1
NC_037330.1,NC_032652.1,60728659,64770882,64770883,A,AG,1
NC_037330.1,NC_032652.1,60740396,64782282,64782285,T,TTGA,3
NC_037330.1,NC_032652.1,60781624,64823048,64823049,A,AG,1
NC_037330.1,NC_032652.1,60787631,64829054,64829055,C,CA,1
NC_037330.1,NC_032652.1,60884514,64964123,64964124,a,ag,1
NC_037330.1,NC_032652.1,60889164,64968773,64968783,g,gaacaaacaaa,10
NC_037330.1,NC_032652.1,60899357,64978977,64978978,t,tc,1
NC_037330.1,NC_032652.1,60905438,64985059,64985060,t,ta,1
NC_037330.1,NC_032652.1,60926788,65095511,65095514,G,GTAS,3
NC_037330.1,NC_032652.1,60930519,65099079,65099080,A,AG,1
NC_037330.1,NC_032652.1,60936152,65104715,65104716,a,ac,1
NC_037330.1,NC_032652.1,60940513,65109076,65109083,g,gcaatggc,7
NC_037330.1,NC_032652.1,60945292,65113833,65113834,t,tc,1
NC_037330.1,NC_032652.1,60978513,65156092,65156094,A,AAT,2
NC_037330.1,NC_032652.1,60980915,65158497,65158499,a,aag,2
NC_037330.1,NC_032652.1,60999397,65176991,65176993,A,AAC,2
NC_037330.1,NC_032652.1,61021377,65198975,65198982,g,gaaagtga,7
NC_037330.1,NC_032652.1,61028952,65206561,65206562,A,AG,1
NC_037330.1,NC_032652.1,61048831,65226474,65226476,A,AAG,2
NC_037330.1,NC_032652.1,61070240,65247891,65247892,a,aN,1
NC_037330.1,NC_032652.1,61077964,65255616,65255648,c,ccagtattcttccatgcagaattccatggacag,32
NC_037330.1,NC_032652.1,61413566,65687206,65687210,a,aNNNN,4
NC_037330.1,NC_032652.1,61432702,65706332,65706333,A,AW,1
NC_037330.1,NC_032652.1,61515375,65789167,65789169,a,aNN,2
NC_037330.1,NC_032652.1,61629581,65867970,65867971,A,AR,1
NC_037330.1,NC_032652.1,61649474,65887874,65887892,T,TTACCAATTTGCAAGAGTW,18
NC_037330.1,NC_032652.1,61658055,65896318,65896320,c,cYt,2
NC_037330.1,NC_032652.1,61658074,65896339,65896340,c,cg,1
NC_037330.1,NC_032652.1,61665867,65904134,65904135,a,at,1
NC_037330.1,NC_032652.1,61700891,65938983,65938984,A,AR,1
NC_037330.1,NC_032652.1,61727164,65965343,65965348,G,GAAGGA,5
NC_037330.1,NC_032652.1,61744076,65982256,65982260,G,GTGTA,4
NC_037330.1,NC_032652.1,61759966,66001088,66001089,C,CA,1
NC_037330.1,NC_032652.1,61760224,66001347,66001349,g,gga,2
NC_037330.1,NC_032652.1,61762553,66003685,66003701,t,ttaaaaaaaaaaaaaag,16
NC_037330.1,NC_032652.1,61817663,66059150,66059153,a,aagg,3
NC_037330.1,NC_032652.1,61837110,66078621,66078623,a,aac,2
NC_037330.1,NC_032652.1,61968700,66219476,66219477,G,GK,1
NC_037330.1,NC_032652.1,61972352,66223132,66223133,c,cg,1
NC_037330.1,NC_032652.1,61982731,66233509,66233510,T,TC,1
NC_037330.1,NC_032652.1,61991328,66242118,66242126,t,tacacacac,8
NC_037330.1,NC_032652.1,62001777,66252474,66252475,A,AT,1
NC_037330.1,NC_032652.1,62109054,66359595,66359596,T,TC,1
NC_037330.1,NC_032652.1,62180390,66430960,66430961,t,tc,1
NC_037330.1,NC_032652.1,62189905,66440476,66440477,T,TG,1
NC_037330.1,NC_032652.1,62249056,66499622,66499623,t,tg,1
NC_037330.1,NC_032652.1,62268512,66519092,66519094,t,ttg,2
NC_037330.1,NC_032652.1,62280702,66531306,66531307,t,tc,1
NC_037330.1,NC_032652.1,62315289,66565927,66565931,A,ACAAG,4
NC_037330.1,NC_032652.1,62423259,66675730,66675731,A,AM,1
NC_037330.1,NC_032652.1,62432819,66685284,66685308,A,AANNNNNNNNNGCCTTTTACACATT,24
NC_037330.1,NC_032652.1,62455578,66708321,66708322,T,TK,1
NC_037330.1,NC_032652.1,62464377,66717121,66717123,T,TAC,2
NC_037330.1,NC_032652.1,62470263,66723010,66723011,T,TC,1
NC_037330.1,NC_032652.1,62531282,66843825,66843826,C,CT,1
NC_037330.1,NC_032652.1,62555079,66867641,66867642,G,GA,1
NC_037330.1,NC_032652.1,62644047,66992431,66992433,a,act,2
NC_037330.1,NC_032652.1,62766653,67115058,67115059,g,gt,1
NC_037330.1,NC_032652.1,62844397,67191926,67191927,C,CM,1
NC_037330.1,NC_032652.1,62942779,67290860,67290861,T,TC,1
NC_037330.1,NC_032652.1,62979446,67327534,67327535,A,AR,1
NC_037330.1,NC_032652.1,63089493,67438066,67438067,t,tg,1
NC_037330.1,NC_032652.1,63198064,67545601,67545603,t,taa,2
NC_037330.1,NC_032652.1,63280015,67627555,67627559,c,cctat,4
NC_037330.1,NC_032652.1,63344391,67692572,67692573,a,at,1
NC_037330.1,NC_032652.1,63344401,67692583,67692589,t,taaaaaa,6
NC_037330.1,NC_032652.1,63374703,67722924,67722930,t,taaatta,6
NC_037330.1,NC_032652.1,63386334,67734551,67734567,a,aaaaatataNNNNNNNN,16
NC_037330.1,NC_032652.1,63405051,67753685,67753691,T,TATTCTC,6
NC_037330.1,NC_032652.1,63453516,67802167,67802169,t,taa,2
NC_037330.1,NC_032652.1,63473411,67822070,67822071,T,TA,1
NC_037330.1,NC_032652.1,63518691,67867356,67867357,T,TW,1
NC_037330.1,NC_032652.1,63534445,67883112,67883114,A,AAT,2
NC_037330.1,NC_032652.1,63537356,67886025,67886026,G,GA,1
NC_037330.1,NC_032652.1,63545360,67894030,67894031,T,TC,1
NC_037330.1,NC_032652.1,63546137,67894808,67894809,A,AC,1
NC_037330.1,NC_032652.1,63580526,67927003,67927004,g,ga,1
NC_037330.1,NC_032652.1,63580770,67927248,67927249,t,tc,1
NC_037330.1,NC_032652.1,63580784,67927263,67927274,t,tatgtttttttc,11
NC_037330.1,NC_032652.1,63583735,67929949,67929950,T,TA,1
NC_037330.1,NC_032652.1,63617151,67966534,67966535,t,ta,1
NC_037330.1,NC_032652.1,63617156,67966540,67966541,t,tg,1
NC_037330.1,NC_032652.1,63664322,68014204,68014206,a,aat,2
NC_037330.1,NC_032652.1,63705972,68055862,68055863,t,ta,1
NC_037330.1,NC_032652.1,63711483,68061393,68061399,t,tcagcag,6
NC_037330.1,NC_032652.1,63712335,68062245,68062246,c,ct,1
NC_037330.1,NC_032652.1,63716008,68066032,68066033,a,at,1
NC_037330.1,NC_032652.1,63773775,68124058,68124069,c,ccaagggactct,11
NC_037330.1,NC_032652.1,63784735,68135560,68135561,c,ct,1
NC_037330.1,NC_032652.1,63810691,68161737,68161738,t,tg,1
NC_037330.1,NC_032652.1,63822609,68173660,68173662,g,gga,2
NC_037330.1,NC_032652.1,63841448,68192507,68192508,T,TG,1
NC_037330.1,NC_032652.1,63854671,68205736,68205737,A,AC,1
NC_037330.1,NC_032652.1,63857374,68208441,68208442,t,tc,1
NC_037330.1,NC_032652.1,63880042,68230991,68230994,T,TAGA,3
NC_037330.1,NC_032652.1,63890279,68241232,68241239,t,tgaaagag,7
NC_037330.1,NC_032652.1,63902705,68253606,68253607,G,GW,1
NC_037330.1,NC_032652.1,63903070,68253972,68253975,t,ttta,3
NC_037330.1,NC_032652.1,63909543,68260454,68260459,t,tttttc,5
NC_037330.1,NC_032652.1,63944711,68288166,68288167,t,tc,1
NC_037330.1,NC_032652.1,63973929,68364941,68364943,a,att,2
NC_037330.1,NC_032652.1,64023157,68414190,68414191,g,ga,1
NC_037330.1,NC_032652.1,64025012,68416046,68416050,a,aaaac,4
NC_037330.1,NC_032652.1,64052215,68443257,68443260,a,attt,3
NC_037330.1,NC_032652.1,64071370,68462856,68462859,T,TGTC,3
NC_037330.1,NC_032652.1,64121740,68513846,68513847,t,ta,1
NC_037330.1,NC_032652.1,64134949,68527087,68527088,T,TK,1
NC_037330.1,NC_032652.1,64151728,68543898,68543899,a,ag,1
NC_037330.1,NC_032652.1,64159755,68552477,68552478,a,at,1
NC_037330.1,NC_032652.1,64165363,68558083,68558084,t,ta,1
NC_037330.1,NC_032652.1,64174273,68566945,68566948,T,TATC,3
NC_037330.1,NC_032652.1,64230886,68633680,68633682,c,ctt,2
NC_037330.1,NC_032652.1,64318659,68721789,68721797,a,aNNNNNNNN,8
NC_037330.1,NC_032652.1,64381510,68784707,68784708,a,aN,1
NC_037330.1,NC_032652.1,64413368,68840012,68840013,C,CT,1
NC_037330.1,NC_032652.1,64478947,68897038,68897039,A,AR,1
NC_037330.1,NC_032652.1,64485096,68903192,68903193,a,ag,1
NC_037330.1,NC_032652.1,64489572,68907673,68907674,C,CY,1
NC_037330.1,NC_032652.1,64494765,68912863,68912864,g,ga,1
NC_037330.1,NC_032652.1,64494785,68912884,68912885,c,ca,1
NC_037330.1,NC_032652.1,64497296,68915388,68915391,a,agag,3
NC_037330.1,NC_032652.1,64497301,68915396,68915397,t,tc,1
NC_037330.1,NC_032652.1,64503580,68921671,68921674,t,tata,3
NC_037330.1,NC_032652.1,64503657,68921751,68921752,a,at,1
NC_037330.1,NC_032652.1,64503701,68921796,68921797,t,ta,1
NC_037330.1,NC_032652.1,64508956,68927051,68927052,C,CG,1
NC_037330.1,NC_032652.1,64526724,68944826,68944829,t,tcta,3
NC_037330.1,NC_032652.1,64644553,69062523,69062524,g,gc,1
NC_037330.1,NC_032652.1,64675196,69093756,69093757,g,ga,1
NC_037330.1,NC_032652.1,64682435,69100987,69100989,c,cat,2
NC_037330.1,NC_032652.1,64877869,69296338,69296339,T,TC,1
NC_037330.1,NC_032652.1,64913627,69332111,69332119,g,gctATATCT,8
NC_037330.1,NC_032652.1,64930333,69348830,69348831,t,ta,1
NC_037330.1,NC_032652.1,64988862,69407389,69407390,G,GT,1
NC_037330.1,NC_032652.1,65066535,69485320,69485321,c,ct,1
NC_037330.1,NC_032652.1,65080609,69499395,69499396,c,ct,1
NC_037330.1,NC_032652.1,65090421,69513854,69513855,c,ct,1
NC_037330.1,NC_032652.1,65100554,69526971,69526972,T,TC,1
NC_037330.1,NC_032652.1,65105843,69532260,69532264,A,AGTAG,4
NC_037330.1,NC_032652.1,65138421,69565199,69565200,t,tg,1
NC_037330.1,NC_032652.1,65138931,69565710,69565712,g,ggt,2
NC_037330.1,NC_032652.1,65156365,69583380,69583381,T,TG,1
NC_037330.1,NC_032652.1,65157234,69584250,69584251,T,TC,1
NC_037330.1,NC_032652.1,65179791,69606814,69606816,g,gga,2
NC_037330.1,NC_032652.1,65183281,69610306,69610307,T,TC,1
NC_037330.1,NC_032652.1,65208954,69634673,69634674,G,GC,1
NC_037330.1,NC_032652.1,65210050,69635592,69635598,a,aNNNNNN,6
NC_037330.1,NC_032652.1,65218043,69643597,69643601,T,TCTTA,4
NC_037330.1,NC_032652.1,65290753,69716330,69716332,C,CTG,2
NC_037330.1,NC_032652.1,65291890,69717469,69717482,c,cttcactttcactt,13
NC_037330.1,NC_032652.1,65310559,69736145,69736147,t,taa,2
NC_037330.1,NC_032652.1,65317155,69742744,69742745,T,TC,1
NC_037330.1,NC_032652.1,65531947,69958064,69958065,c,ca,1
NC_037330.1,NC_032652.1,65538586,69964721,69964722,t,tN,1
NC_037330.1,NC_032652.1,65560075,69998946,69998947,t,tY,1
NC_037330.1,NC_032652.1,65560219,69999091,69999092,t,tc,1
NC_037330.1,NC_032652.1,65566708,70005581,70005582,C,CT,1
NC_037330.1,NC_032652.1,65605556,70043560,70043561,g,gc,1
NC_037330.1,NC_032652.1,65610547,70048556,70048571,a,actgcagcctaccagg,15
NC_037330.1,NC_032652.1,65628938,70065885,70065887,a,aag,2
NC_037330.1,NC_032652.1,65746534,70183602,70183603,c,ct,1
NC_037330.1,NC_032652.1,65749375,70186443,70186445,c,cag,2
NC_037330.1,NC_032652.1,65762903,70199964,70199965,t,ta,1
NC_037330.1,NC_032652.1,65850586,70277490,70277491,A,AG,1
NC_037330.1,NC_032652.1,65855276,70285512,70285513,c,cg,1
NC_037330.1,NC_032652.1,65855660,70285901,70285902,A,AG,1
NC_037330.1,NC_032652.1,65856843,70287085,70287086,G,GC,1
NC_037330.1,NC_032652.1,65928560,70359870,70359871,c,ct,1
NC_037330.1,NC_032652.1,65942475,70373822,70373826,A,AGAAG,4
NC_037330.1,NC_032652.1,65943685,70375044,70375045,C,CA,1
NC_037330.1,NC_032652.1,65948395,70379755,70379756,A,AT,1
NC_037330.1,NC_032652.1,65948580,70379941,70379946,t,tctttc,5
NC_037330.1,NC_032652.1,65976904,70408288,70408290,c,ctt,2
NC_037330.1,NC_032652.1,65977925,70409312,70409313,A,AW,1
NC_037330.1,NC_032652.1,66028132,70459526,70459527,A,AR,1
NC_037330.1,NC_032652.1,66044324,70475720,70475722,A,AGT,2
NC_037330.1,NC_032652.1,66049313,70482996,70483000,a,aNNNN,4
NC_037330.1,NC_032652.1,66056664,70490355,70490357,a,aag,2
NC_037330.1,NC_032652.1,66057819,70491510,70491511,t,ta,1
NC_037330.1,NC_032652.1,66070039,70503886,70503887,a,at,1
NC_037330.1,NC_032652.1,66072847,70506621,70506623,g,gga,2
NC_037330.1,NC_032652.1,66085186,70518974,70518975,a,aN,1
NC_037330.1,NC_032652.1,66358261,70839705,70839706,g,ga,1
NC_037330.1,NC_032652.1,66369778,70851224,70851225,T,TW,1
NC_037330.1,NC_032652.1,66448809,70929504,70929513,A,ACCTAAAAGC,9
NC_037330.1,NC_032652.1,66477177,70957888,70957889,T,TK,1
NC_037330.1,NC_032652.1,66498024,70978736,70978737,t,tc,1
NC_037330.1,NC_032652.1,66499398,70980129,70980130,C,CT,1
NC_037330.1,NC_032652.1,66507763,70988484,70988485,a,at,1
NC_037330.1,NC_032652.1,66519607,71000345,71000346,T,TK,1
NC_037330.1,NC_032652.1,66522152,71002890,71002891,t,tc,1
NC_037330.1,NC_032652.1,66522210,71002949,71002950,c,ct,1
NC_037330.1,NC_032652.1,66522257,71002997,71002998,t,tg,1
NC_037330.1,NC_032652.1,66522269,71003010,71003012,t,ttc,2
NC_037330.1,NC_032652.1,66522295,71003038,71003039,a,at,1
NC_037330.1,NC_032652.1,66523756,71004501,71004502,t,tg,1
NC_037330.1,NC_032652.1,66524146,71004893,71004894,a,ac,1
NC_037330.1,NC_032652.1,66526529,71007299,71007300,T,TW,1
NC_037330.1,NC_032652.1,66532279,71013056,71013057,A,AR,1
NC_037330.1,NC_032652.1,66533014,71013792,71013793,G,GT,1
NC_037330.1,NC_032652.1,66536335,71017114,71017115,A,AT,1
NC_037330.1,NC_032652.1,66544534,71024856,71024857,A,AG,1
NC_037330.1,NC_032652.1,66544539,71024862,71024873,G,GCAGCCCTCAGA,11
NC_037330.1,NC_032652.1,66631384,71110651,71110653,G,GTC,2
NC_037330.1,NC_032652.1,66631942,71111211,71111212,T,TK,1
NC_037330.1,NC_032652.1,66632696,71111959,71111960,c,ca,1
NC_037330.1,NC_032652.1,66634288,71113552,71113553,G,GK,1
NC_037330.1,NC_032652.1,66656860,71136142,71136144,t,tta,2
NC_037330.1,NC_032652.1,66799563,71313548,71313549,T,TA,1
NC_037330.1,NC_032652.1,66801547,71315519,71315520,c,ct,1
NC_037330.1,NC_032652.1,66805316,71319290,71319292,G,GAY,2
NC_037330.1,NC_032652.1,66826035,71339987,71340001,A,AATGCTTGAGCCTCT,14
NC_037330.1,NC_032652.1,66830549,71344517,71344518,T,TA,1
NC_037330.1,NC_032652.1,66832894,71346862,71346863,G,GM,1
NC_037330.1,NC_032652.1,66835195,71349163,71349166,T,TTAY,3
NC_037330.1,NC_032652.1,66837644,71351615,71351616,G,GA,1
NC_037330.1,NC_032652.1,66840582,71354550,71354551,t,ta,1
NC_037330.1,NC_032652.1,66900553,71420416,71420418,c,cct,2
NC_037330.1,NC_032652.1,66902616,71422481,71422482,t,ta,1
NC_037330.1,NC_032652.1,66913070,71432940,71432944,A,AACTG,4
NC_037330.1,NC_032652.1,66936648,71479721,71479722,c,ct,1
NC_037330.1,NC_032652.1,67051316,71594566,71594567,T,TA,1
NC_037330.1,NC_032652.1,67057734,71600986,71600989,t,tagc,3
NC_037330.1,NC_032652.1,67061413,71604669,71604670,t,tc,1
NC_037330.1,NC_032652.1,67077333,71621013,71621017,C,CTTGG,4
NC_037330.1,NC_032652.1,67096150,71639837,71639839,C,CAT,2
NC_037330.1,NC_032652.1,67114999,71658461,71658462,T,TY,1
NC_037330.1,NC_032652.1,67163145,71706604,71706605,A,AC,1
NC_037330.1,NC_032652.1,67173862,71717322,71717326,t,tatta,4
NC_037330.1,NC_032652.1,67190589,71734040,71734041,A,AW,1
NC_037330.1,NC_032652.1,67194354,71737806,71737808,C,CTT,2
NC_037330.1,NC_032652.1,67201260,71744757,71744758,T,TC,1
NC_037330.1,NC_032652.1,67225486,71768989,71769000,a,atatgtatcatt,11
NC_037330.1,NC_032652.1,67244780,71789403,71789404,T,TK,1
NC_037330.1,NC_032652.1,67249281,71793905,71793915,g,gggagcctggt,10
NC_037330.1,NC_032652.1,67289176,71833810,71833811,A,AG,1
NC_037330.1,NC_032652.1,67289541,71834176,71834178,C,CAT,2
NC_037330.1,NC_032652.1,67293846,71838241,71838242,t,tc,1
NC_037330.1,NC_032652.1,67295037,71839427,71839428,A,AG,1
NC_037330.1,NC_032652.1,67320202,71864597,71864598,g,gc,1
NC_037330.1,NC_032652.1,67350752,71902576,71902577,c,cR,1
NC_037330.1,NC_032652.1,67435012,71986863,71986864,c,ct,1
NC_037330.1,NC_032652.1,67435355,71987041,71987042,C,CT,1
NC_037330.1,NC_032652.1,67461791,72015074,72015075,A,AG,1
NC_037330.1,NC_032652.1,67461791,72158581,72158582,A,AG,1
NC_037330.1,NC_032652.1,67464352,72017636,72017637,t,tc,1
NC_037330.1,NC_032652.1,67466679,72019964,72019965,T,TA,1
NC_037330.1,NC_032652.1,67466679,72163470,72163471,T,TA,1
NC_037330.1,NC_032652.1,67478585,72031848,72031849,T,TC,1
NC_037330.1,NC_032652.1,67478585,72175354,72175355,T,TC,1
NC_037330.1,NC_032652.1,67484318,72037587,72037588,c,ct,1
NC_037330.1,NC_032652.1,67484318,72181093,72181094,c,ct,1
NC_037330.1,NC_032652.1,67520496,72217272,72217274,t,tta,2
NC_037330.1,NC_032652.1,67552850,72249058,72249061,A,AATT,3
NC_037330.1,NC_032652.1,67552850,72104744,72104747,A,AATT,3
NC_037330.1,NC_032652.1,67612431,72316782,72316783,G,GR,1
NC_037330.1,NC_032652.1,67616512,72320863,72320864,T,TG,1
NC_037330.1,NC_032652.1,67658528,72362832,72362833,A,AT,1
NC_037330.1,NC_032652.1,67666539,72370848,72370850,C,CAA,2
NC_037330.1,NC_032652.1,67667808,72372119,72372120,G,GT,1
NC_037330.1,NC_032652.1,67674331,72378639,72378640,g,ga,1
NC_037330.1,NC_032652.1,67682085,72386392,72386393,T,TK,1
NC_037330.1,NC_032652.1,67711047,72415360,72415369,a,atatatNtat,9
NC_037330.1,NC_032652.1,67728874,72433204,72433206,C,CCT,2
NC_037330.1,NC_032652.1,67814264,72518597,72518598,T,TG,1
NC_037330.1,NC_032652.1,67908148,72624875,72624876,a,ac,1
NC_037330.1,NC_032652.1,67909929,72626657,72626658,t,ta,1
NC_037330.1,NC_032652.1,68017174,72793229,72793230,t,tg,1
NC_037330.1,NC_032652.1,68037177,72813231,72813232,G,GC,1
NC_037330.1,NC_032652.1,68092760,72868818,72868819,g,gc,1
NC_037330.1,NC_032652.1,68093579,72869638,72869643,a,aaagct,5
NC_037330.1,NC_032652.1,68103356,72879417,72879418,C,CY,1
NC_037330.1,NC_032652.1,68120913,72896973,72896974,a,ac,1
NC_037330.1,NC_032652.1,68121879,72897935,72897936,C,CY,1
NC_037330.1,NC_032652.1,68133577,72909630,72909631,t,tc,1
NC_037330.1,NC_032652.1,68182787,72958837,72958838,C,CT,1
NC_037330.1,NC_032652.1,68202466,72978838,72978850,A,ACCTAGCCTAGCT,12
NC_037330.1,NC_032652.1,68211355,72987742,72987743,A,AT,1
NC_037330.1,NC_032652.1,68212887,72989275,72989276,T,TG,1
NC_037330.1,NC_032652.1,68228132,73004130,73004131,A,AC,1
NC_037330.1,NC_032652.1,68290875,73066373,73066377,t,taaag,4
NC_037330.1,NC_032652.1,68344400,73119690,73119699,c,cataagcaaa,9
NC_037330.1,NC_032652.1,68345245,73120542,73120543,a,ac,1
NC_037330.1,NC_032652.1,68376571,73151872,73151873,T,TA,1
NC_037330.1,NC_032652.1,68440352,73215429,73215430,t,ta,1
NC_037330.1,NC_032652.1,68440365,73215443,73215444,g,gt,1
NC_037330.1,NC_032652.1,68440421,73215496,73215497,G,GT,1
NC_037330.1,NC_032652.1,68445903,73220978,73220979,a,aM,1
NC_037330.1,NC_032652.1,68452953,73227165,73227166,t,tc,1
NC_037330.1,NC_032652.1,68453549,73227762,73227763,t,ta,1
NC_037330.1,NC_032652.1,68454007,73228221,73228230,t,tgtggaaaca,9
NC_037330.1,NC_032652.1,68454034,73228257,73228258,c,ct,1
NC_037330.1,NC_032652.1,68456203,73230423,73230425,A,AGT,2
NC_037330.1,NC_032652.1,68456492,73230714,73230715,T,TC,1
NC_037330.1,NC_032652.1,68456541,73230764,73230766,G,GAC,2
NC_037330.1,NC_032652.1,68463279,73237520,73237522,C,CTT,2
NC_037330.1,NC_032652.1,68491221,73266274,73266276,A,AAG,2
NC_037330.1,NC_032652.1,68505151,73297744,73297745,t,ta,1
NC_037330.1,NC_032652.1,68508806,73301399,73301400,A,AM,1
NC_037330.1,NC_032652.1,68650123,73447039,73447043,A,ACGAT,4
NC_037330.1,NC_032652.1,68679780,73476061,73476062,T,TA,1
NC_037330.1,NC_032652.1,68697016,73493298,73493299,G,GK,1
NC_037330.1,NC_032652.1,68746307,73542593,73542594,t,tc,1
NC_037330.1,NC_032652.1,68758402,73554690,73554710,c,catacatatatatatatatat,20
NC_037330.1,NC_032652.1,68778772,73575215,73575216,A,AC,1
NC_037330.1,NC_032652.1,68818825,73615281,73615283,a,aat,2
NC_037330.1,NC_032652.1,68828204,73624670,73624672,a,aag,2
NC_037330.1,NC_032652.1,68828581,73625049,73625051,c,cct,2
NC_037330.1,NC_032652.1,68828585,73625055,73625057,c,ctt,2
NC_037330.1,NC_032652.1,68828618,73625090,73625091,a,at,1
NC_037330.1,NC_032652.1,68830364,73626831,73626835,g,gtgtt,4
NC_037330.1,NC_032652.1,68832571,73629043,73629044,g,gt,1
NC_037330.1,NC_032652.1,68832595,73629068,73629070,c,cta,2
NC_037330.1,NC_032652.1,68835127,73631603,73631608,c,cttttg,5
NC_037330.1,NC_032652.1,68838070,73634674,73634680,c,ctctctt,6
NC_037330.1,NC_032652.1,68855202,73651805,73651806,T,TK,1
NC_037330.1,NC_032652.1,68897523,73694115,73694117,t,tNN,2
NC_037330.1,NC_032652.1,68946318,73742972,73742974,a,act,2
NC_037330.1,NC_032652.1,69009535,73805381,73805383,C,CAY,2
NC_037330.1,NC_032652.1,69016075,73811925,73811926,C,CT,1
NC_037330.1,NC_032652.1,69127224,73923580,73923581,T,TA,1
NC_037330.1,NC_032652.1,69157586,73953962,73953966,c,ctgtg,4
NC_037330.1,NC_032652.1,69162238,73958616,73958617,T,TG,1
NC_037330.1,NC_032652.1,69217415,74014247,74014248,t,tg,1
NC_037330.1,NC_032652.1,69264156,74060996,74060997,T,TW,1
NC_037330.1,NC_032652.1,69277742,74074579,74074580,C,CY,1
NC_037330.1,NC_032652.1,69362914,74160194,74160195,T,TK,1
NC_037330.1,NC_032652.1,69368177,74165513,74165514,A,AR,1
NC_037330.1,NC_032652.1,69385100,74182443,74182444,A,AT,1
NC_037330.1,NC_032652.1,69417343,74214260,74214261,A,AC,1
NC_037330.1,NC_032652.1,69455461,74251911,74251912,c,cg,1
NC_037330.1,NC_032652.1,69485957,74282430,74282434,a,atatg,4
NC_037330.1,NC_032652.1,69517565,74314097,74314098,t,tg,1
NC_037330.1,NC_032652.1,69567385,74364677,74364678,G,GC,1
NC_037330.1,NC_032652.1,69580279,74377565,74377566,G,GR,1
NC_037330.1,NC_032652.1,69588904,74386193,74386197,a,aaaag,4
NC_037330.1,NC_032652.1,69589698,74386991,74386992,a,at,1
NC_037330.1,NC_032652.1,69683175,74480628,74480629,t,tg,1
NC_037330.1,NC_032652.1,69720034,74517504,74517510,a,atacatg,6
NC_037330.1,NC_032652.1,69769156,74566018,74566019,t,tg,1
NC_037330.1,NC_032652.1,69964724,74761847,74761848,C,CM,1
NC_037330.1,NC_032652.1,69989068,74786194,74786205,a,aacaccagggct,11
NC_037330.1,NC_032652.1,70007965,74805109,74805111,T,TTY,2
NC_037330.1,NC_032652.1,70014794,74817421,74817422,A,AC,1
NC_037330.1,NC_032652.1,70022729,74825348,74825351,C,CAGT,3
NC_037330.1,NC_032652.1,70040095,74842723,74842724,a,aM,1
NC_037330.1,NC_032652.1,70080866,74883501,74883503,t,tac,2
NC_037330.1,NC_032652.1,70151525,74952437,74952438,G,GR,1
NC_037330.1,NC_032652.1,70244189,75045237,75045238,G,GR,1
NC_037330.1,NC_032652.1,70250063,75051112,75051113,c,ca,1
NC_037330.1,NC_032652.1,70253354,75054404,75054411,G,GTCTTGTS,7
NC_037330.1,NC_032652.1,70261647,75062714,75062719,A,ACGAAC,5
NC_037330.1,NC_032652.1,70269639,75070694,75070702,A,AAGCATAGG,8
NC_037330.1,NC_032652.1,70272562,75073620,75073621,A,AG,1
NC_037330.1,NC_032652.1,70295795,75096860,75096862,T,TGA,2
NC_037330.1,NC_032652.1,70315976,75117041,75117042,t,tc,1
NC_037330.1,NC_032652.1,70336368,75137375,75137376,T,TG,1
NC_037330.1,NC_032652.1,70351119,75152135,75152137,g,ggt,2
NC_037330.1,NC_032652.1,70380207,75181253,75181259,g,gtgtgta,6
NC_037330.1,NC_032652.1,70414101,75215158,75215159,A,AG,1
NC_037330.1,NC_032652.1,70447607,75248612,75248613,T,TG,1
NC_037330.1,NC_032652.1,70464417,75265023,75265028,c,cttttt,5
NC_037330.1,NC_032652.1,70486862,75287475,75287477,t,taa,2
NC_037330.1,NC_032652.1,70487045,75287660,75287661,A,AG,1
NC_037330.1,NC_032652.1,70489573,75290190,75290193,t,tctc,3
NC_037330.1,NC_032652.1,70489611,75290231,75290232,c,ca,1
NC_037330.1,NC_032652.1,70501055,75301683,75301687,C,CTGAA,4
NC_037330.1,NC_032652.1,70520045,75320677,75320679,g,gaa,2
NC_037330.1,NC_032652.1,70548895,75349537,75349539,t,tgc,2
NC_037330.1,NC_032652.1,70598969,75399859,75399860,t,ta,1
NC_037330.1,NC_032652.1,70815444,75618424,75618428,t,tNNNN,4
NC_037330.1,NC_032652.1,70853014,75655997,75655998,g,gc,1
NC_037330.1,NC_032652.1,70854625,75657609,75657612,A,AGGT,3
NC_037330.1,NC_032652.1,70906655,75709641,75709643,T,TGC,2
NC_037330.1,NC_032652.1,70923391,75726367,75726368,T,TG,1
NC_037330.1,NC_032652.1,70942161,75745147,75745148,T,TY,1
NC_037330.1,NC_032652.1,70943240,75746228,75746236,G,GTATATTKK,8
NC_037330.1,NC_032652.1,70950598,75753591,75753595,c,ctgag,4
NC_037330.1,NC_032652.1,71025341,75868119,75868122,A,ANNN,3
NC_037330.1,NC_032652.1,71073349,75918801,75918812,g,gttcatcacagc,11
NC_037330.1,NC_032652.1,71076786,75922259,75922260,a,aM,1
NC_037330.1,NC_032652.1,71096273,75941753,75941754,t,ta,1
NC_037330.1,NC_032652.1,71105191,75950674,75950675,C,CY,1
NC_037330.1,NC_032652.1,71105405,75950889,75950895,c,catctat,6
NC_037330.1,NC_032652.1,71162030,76008818,76008819,a,ac,1
NC_037330.1,NC_032652.1,71214336,76061037,76061038,T,TY,1
NC_037330.1,NC_032652.1,71252332,76099042,76099044,t,taa,2
NC_037330.1,NC_032652.1,71272415,76119136,76119137,a,at,1
NC_037330.1,NC_032652.1,71276679,76123401,76123406,G,GATATA,5
NC_037330.1,NC_032652.1,71281480,76128205,76128206,A,AG,1
NC_037330.1,NC_032652.1,71284562,76131288,76131290,g,gaa,2
NC_037330.1,NC_032652.1,71373435,76220107,76220117,a,aaNNNNNNNNN,10
NC_037330.1,NC_032652.1,71402560,76249246,76249247,A,AC,1
NC_037330.1,NC_032652.1,71427397,76274077,76274078,t,tg,1
NC_037330.1,NC_032652.1,71432497,76279177,76279178,T,TA,1
NC_037330.1,NC_032652.1,71433562,76280243,76280246,t,tata,3
NC_037330.1,NC_032652.1,71434059,76280743,76280744,a,aW,1
NC_037330.1,NC_032652.1,71443691,76292169,76292171,t,tNN,2
NC_037330.1,NC_032652.1,71452431,76300912,76300913,t,tg,1
NC_037330.1,NC_032652.1,71470037,76318521,76318527,t,tagagtc,6
NC_037330.1,NC_032652.1,71484840,76333327,76333329,t,ttc,2
NC_037330.1,NC_032652.1,71487822,76336300,76336301,t,ta,1
NC_037330.1,NC_032652.1,71487973,76336453,76336455,t,tac,2
NC_037330.1,NC_032652.1,71538692,76433207,76433208,t,tN,1
NC_037330.1,NC_032652.1,71596343,76496493,76496494,g,gt,1
NC_037330.1,NC_032652.1,71601716,76501867,76501871,T,TTATC,4
NC_037330.1,NC_032652.1,71607725,76509166,76509167,g,ga,1
NC_037330.1,NC_032652.1,71616087,76524520,76524521,a,at,1
NC_037330.1,NC_032652.1,71616960,76525394,76525395,g,ga,1
NC_037330.1,NC_032652.1,71654189,76562632,76562633,a,ac,1
NC_037330.1,NC_032652.1,71657493,76565950,76565951,T,TN,1
NC_037330.1,NC_032652.1,71709812,76697264,76697265,A,AM,1
NC_037330.1,NC_032652.1,71717965,76705425,76705426,c,ca,1
NC_037330.1,NC_032652.1,71737115,76724682,76724683,t,tg,1
NC_037330.1,NC_032652.1,71815163,76804775,76804776,t,tN,1
NC_037330.1,NC_032652.1,71819664,76809275,76809276,C,CT,1
NC_037330.1,NC_032652.1,71819912,76809524,76809525,G,GC,1
NC_037330.1,NC_032652.1,71820321,76809936,76809937,A,AT,1
NC_037330.1,NC_032652.1,71820495,76810109,76810110,a,ag,1
NC_037330.1,NC_032652.1,71822538,76811989,76811995,C,CNNNNNN,6
NC_037330.1,NC_032652.1,71824785,76814241,76814242,c,ct,1
NC_037330.1,NC_032652.1,71860180,76849643,76849644,t,ta,1
NC_037330.1,NC_032652.1,71860982,76850439,76850445,A,ATATAAT,6
NC_037330.1,NC_032652.1,71861346,76850804,76850805,T,TG,1
NC_037330.1,NC_032652.1,71872303,76864975,76864976,t,ta,1
NC_037330.1,NC_032652.1,71879429,76872108,76872111,a,aaat,3
NC_037330.1,NC_032652.1,71888364,76881046,76881047,c,ca,1
NC_037330.1,NC_032652.1,71988166,76981205,76981206,T,TC,1
NC_037330.1,NC_032652.1,72084980,77077917,77077920,t,tggc,3
NC_037330.1,NC_032652.1,72085022,77077962,77077964,c,cca,2
NC_037330.1,NC_032652.1,72123462,77116606,77116607,g,gc,1
NC_037330.1,NC_032652.1,72128684,77121829,77121830,c,ca,1
NC_037330.1,NC_032652.1,72128745,77121892,77121893,c,ca,1
NC_037330.1,NC_032652.1,72161332,77155479,77155480,T,TA,1
NC_037330.1,NC_032652.1,72161344,77155492,77155493,T,TA,1
NC_037330.1,NC_032652.1,72161366,77155515,77155516,c,ca,1
NC_037330.1,NC_032652.1,72161380,77155530,77155531,a,at,1
NC_037330.1,NC_032652.1,72235373,77229849,77229851,T,TTC,2
NC_037330.1,NC_032652.1,72235382,77229860,77229861,C,CT,1
NC_037330.1,NC_032652.1,72283100,77277582,77277584,t,ttc,2
NC_037330.1,NC_032652.1,72287579,77282064,77282066,t,tta,2
NC_037330.1,NC_032652.1,72694922,78176038,78176039,a,ac,1
NC_037330.1,NC_032652.1,72708187,78189305,78189306,t,ta,1
NC_037330.1,NC_032652.1,72712114,78193233,78193234,c,cg,1
NC_037330.1,NC_032652.1,72712205,78193325,78193326,c,ca,1
NC_037330.1,NC_032652.1,72729094,78209895,78209897,T,TCC,2
NC_037330.1,NC_032652.1,72743937,78224741,78224745,g,gtttt,4
NC_037330.1,NC_032652.1,72838142,78317374,78317375,T,TA,1
NC_037330.1,NC_032652.1,73007798,78488081,78488083,t,tNN,2
NC_037330.1,NC_032652.1,73085259,78565554,78565556,t,tac,2
NC_037330.1,NC_032652.1,73154077,78634373,78634374,t,ta,1
NC_037330.1,NC_032652.1,73154081,78634378,78634380,a,agt,2
NC_037330.1,NC_032652.1,73216928,78696696,78696697,t,ta,1
NC_037330.1,NC_032652.1,73229475,78709246,78709247,G,GA,1
NC_037330.1,NC_032652.1,73234322,78714092,78714093,a,at,1
NC_037330.1,NC_032652.1,73237453,78717221,78717222,t,ta,1
NC_037330.1,NC_032652.1,73247860,78727612,78727616,T,TAAAA,4
NC_037330.1,NC_032652.1,73257585,78737373,78737374,T,TA,1
NC_037330.1,NC_032652.1,73258504,78738293,78738294,a,at,1
NC_037330.1,NC_032652.1,73486894,78967510,78967514,t,taNNN,4
NC_037330.1,NC_032652.1,73507533,78988320,78988328,C,CAAAACAGG,8
NC_037330.1,NC_032652.1,73533179,79016651,79016652,a,ag,1
NC_037330.1,NC_032652.1,73533243,79016716,79016717,a,ac,1
NC_037330.1,NC_032652.1,73570636,79054125,79054127,G,GCK,2
NC_037330.1,NC_032652.1,73596322,79079828,79079832,A,ATAGT,4
NC_037330.1,NC_032652.1,73598587,79082098,79082102,C,CACTT,4
NC_037330.1,NC_032652.1,73602205,79085722,79085723,C,CY,1
NC_037330.1,NC_032652.1,73617375,79100899,79100910,c,cgcacacacaca,11
NC_037330.1,NC_032652.1,73617413,79100948,79100949,A,AG,1
NC_037330.1,NC_032652.1,73629983,79113529,79113530,A,AG,1
NC_037330.1,NC_032652.1,73853321,79362592,79362594,g,gtt,2
NC_037330.1,NC_032652.1,74020328,79518531,79518532,t,ta,1
NC_037330.1,NC_032652.1,74048837,79547041,79547042,A,AC,1
NC_037330.1,NC_032652.1,74048884,79547089,79547090,C,CA,1
NC_037330.1,NC_032652.1,74194917,79694344,79694345,T,TA,1
NC_037330.1,NC_032652.1,74304460,79803354,79803355,g,gc,1
NC_037330.1,NC_032652.1,74323245,79821172,79821173,g,ga,1
NC_037330.1,NC_032652.1,74373708,79871178,79871179,C,CG,1
NC_037330.1,NC_032652.1,74375761,79873232,79873233,C,CA,1
NC_037330.1,NC_032652.1,74386994,79884473,79884474,t,ta,1
NC_037330.1,NC_032652.1,74391487,79888967,79888968,a,at,1
NC_037330.1,NC_032652.1,74427560,79925044,79925045,c,ct,1
NC_037330.1,NC_032652.1,74427576,79925061,79925062,c,ct,1
NC_037330.1,NC_032652.1,74638815,80163476,80163477,t,ta,1
NC_037330.1,NC_032652.1,74646618,80171282,80171283,t,ta,1
NC_037330.1,NC_032652.1,74648542,80173209,80173210,C,CA,1
NC_037330.1,NC_032652.1,74648614,80173282,80173283,T,TY,1
NC_037330.1,NC_032652.1,74649573,80174242,80174243,t,ta,1
NC_037330.1,NC_032652.1,74721872,80246685,80246686,A,AM,1
NC_037330.1,NC_032652.1,74750270,80275059,80275060,A,AW,1
NC_037330.1,NC_032652.1,74761304,80297745,80297746,G,GT,1
NC_037330.1,NC_032652.1,74794913,80332393,80332394,T,TA,1
NC_037330.1,NC_032652.1,74805681,80343152,80343163,a,atcttaAATAGC,11
NC_037330.1,NC_032652.1,74819618,80357096,80357097,t,tc,1
NC_037330.1,NC_032652.1,74846639,80386790,80386792,a,aac,2
NC_037330.1,NC_032652.1,74903707,80443876,80443877,a,at,1
NC_037330.1,NC_032652.1,75049027,80589704,80589705,T,TC,1
NC_037330.1,NC_032652.1,75200988,80723292,80723296,g,gagta,4
NC_037330.1,NC_032652.1,75208560,80730868,80730870,c,ctt,2
NC_037330.1,NC_032652.1,75208867,80731177,80731186,t,tagcagcagc,9
NC_037330.1,NC_032652.1,75272781,80795104,80795108,A,AAGAG,4
NC_037330.1,NC_032652.1,75287070,80809398,80809399,t,ta,1
NC_037330.1,NC_032652.1,75368229,80890331,80890332,T,TC,1
NC_037330.1,NC_032652.1,75485403,81007887,81007891,t,tNNNN,4
NC_037330.1,NC_032652.1,75499108,81021598,81021600,g,gaa,2
NC_037330.1,NC_032652.1,75586246,81107514,81107515,g,gc,1
NC_037330.1,NC_032652.1,75609102,81130247,81130248,C,CA,1
NC_037330.1,NC_032652.1,75647677,81168855,81168856,c,ca,1
NC_037330.1,NC_032652.1,75655485,81176738,81176743,a,aNNNNN,5
NC_037330.1,NC_032652.1,75659335,81180595,81180596,t,tg,1
NC_037330.1,NC_032652.1,75663017,81248349,81248351,g,gtt,2
NC_037330.1,NC_032652.1,75663017,81184621,81184623,g,gtt,2
NC_037330.1,NC_032652.1,75670911,81192589,81192590,A,AG,1
NC_037330.1,NC_032652.1,75670911,81258571,81258572,A,AG,1
NC_037330.1,NC_032652.1,75681404,81203079,81203080,A,AG,1
NC_037330.1,NC_032652.1,75681404,81269467,81269468,A,AG,1
NC_037330.1,NC_032652.1,75690192,81278269,81278270,G,GT,1
NC_037330.1,NC_032652.1,75690613,81278691,81278695,A,ATAGT,4
NC_037330.1,NC_032652.1,75722551,81310917,81310918,c,ct,1
NC_037330.1,NC_032652.1,75734302,81322910,81322912,A,ATC,2
NC_037330.1,NC_032652.1,75737134,81325746,81325748,c,cat,2
NC_037330.1,NC_032652.1,75757293,81345850,81345855,c,cttttt,5
NC_037330.1,NC_032652.1,75785282,81373548,81373550,T,TTA,2
NC_037330.1,NC_032652.1,75813674,81402067,81402068,A,AT,1
NC_037330.1,NC_032652.1,75821612,81410006,81410007,a,at,1
NC_037330.1,NC_032652.1,75828920,81417327,81417328,A,AC,1
NC_037330.1,NC_032652.1,75831642,81420049,81420050,A,AG,1
NC_037330.1,NC_032652.1,75861781,81451125,81451126,T,TA,1
NC_037330.1,NC_032652.1,75870732,81456966,81456967,t,ta,1
NC_037330.1,NC_032652.1,75881392,81467645,81467647,t,taa,2
NC_037330.1,NC_032652.1,75896741,81483001,81483002,t,tg,1
NC_037330.1,NC_032652.1,75911200,81497413,81497414,a,ac,1
NC_037330.1,NC_032652.1,75913545,81499762,81499766,g,gacaa,4
NC_037330.1,NC_032652.1,75973031,81509791,81509792,a,ag,1
NC_037330.1,NC_032652.1,75979547,81516310,81516311,G,GS,1
NC_037330.1,NC_032652.1,76008254,81545017,81545022,t,tcctga,5
NC_037330.1,NC_032652.1,76017051,81553821,81553823,T,TSG,2
NC_037330.1,NC_032652.1,76030188,81566958,81566959,c,ca,1
NC_037330.1,NC_032652.1,76075389,81612115,81612116,t,tg,1
NC_037330.1,NC_032652.1,76078248,81614975,81614983,a,aaaataaat,8
NC_037330.1,NC_032652.1,76130558,81702560,81702561,A,AR,1
NC_037330.1,NC_032652.1,76130700,81702703,81702704,a,at,1
NC_037330.1,NC_032652.1,76131078,81703082,81703088,t,tNNNNaa,6
NC_037330.1,NC_032652.1,76133949,81705960,81705961,t,tg,1
NC_037330.1,NC_032652.1,76160042,81731328,81731334,a,aNNNNNN,6
NC_037330.1,NC_032652.1,76172796,81744093,81744094,A,AG,1
NC_037330.1,NC_032652.1,76196854,81764945,81764990,G,GCACAGGCGGCCATGGTAAAANNNNNNNNNNNNNNNNNNNNNNNNN,45
NC_037330.1,NC_032652.1,76206924,81775100,81775101,a,aR,1
NC_037330.1,NC_032652.1,76226421,81793745,81793746,a,at,1
NC_037330.1,NC_032652.1,76259708,81826970,81826971,c,ca,1
NC_037330.1,NC_032652.1,76306869,81874127,81874128,T,TY,1
NC_037330.1,NC_032652.1,76333346,81900609,81900611,t,taa,2
NC_037330.1,NC_032652.1,76347998,81915280,81915282,c,caa,2
NC_037330.1,NC_032652.1,76357066,81924731,81924732,a,aR,1
NC_037330.1,NC_032652.1,76383930,81951486,81951488,C,CTA,2
NC_037330.1,NC_032652.1,76386621,81954182,81954183,t,tc,1
NC_037330.1,NC_032652.1,76405738,81975399,81975400,A,AC,1
NC_037330.1,NC_032652.1,76422174,81994231,81994232,c,ct,1
NC_037330.1,NC_032652.1,76464841,82039514,82039515,G,GR,1
NC_037330.1,NC_032652.1,76468886,82043579,82043580,G,GC,1
NC_037330.1,NC_032652.1,76481604,82056293,82056294,t,tc,1
NC_037330.1,NC_032652.1,76511816,82086517,82086518,t,ta,1
NC_037330.1,NC_032652.1,76517999,82092725,82092727,c,cag,2
NC_037330.1,NC_032652.1,76523864,82098590,82098591,T,TR,1
NC_037330.1,NC_032652.1,76533486,82108209,82108212,c,cagg,3
NC_037330.1,NC_032652.1,76533550,82108276,82108277,t,tg,1
NC_037330.1,NC_032652.1,76561363,82170115,82170116,g,ga,1
NC_037330.1,NC_032652.1,76623679,82197760,82197770,t,tNNNNNNNNNN,10
NC_037330.1,NC_032652.1,76670061,82244198,82244199,t,tc,1
NC_037330.1,NC_032652.1,76673873,82247306,82247308,A,ATC,2
NC_037330.1,NC_032652.1,76889433,82447895,82447896,t,tg,1
NC_037330.1,NC_032652.1,76894493,82452957,82452958,T,TA,1
NC_037330.1,NC_032652.1,76924275,82482826,82482827,g,ga,1
NC_037330.1,NC_032652.1,76949312,82507861,82507862,a,at,1
NC_037330.1,NC_032652.1,76950782,82509332,82509333,t,ta,1
NC_037330.1,NC_032652.1,76951993,82510544,82510545,a,ac,1
NC_037330.1,NC_032652.1,76952082,82510634,82510644,t,tagaaaagtac,10
NC_037330.1,NC_032652.1,77019828,82606913,82606914,a,aM,1
NC_037330.1,NC_032652.1,77030080,82617168,82617173,t,tKTTTG,5
NC_037330.1,NC_032652.1,77068492,82655582,82655583,T,TG,1
NC_037330.1,NC_032652.1,77164276,82751509,82751513,C,CACTA,4
NC_037330.1,NC_032652.1,77171760,82758998,82759001,t,tttg,3
NC_037330.1,NC_032652.1,77191684,82778928,82778929,c,ca,1
NC_037330.1,NC_032652.1,77215139,82802397,82802401,c,cacRY,4
NC_037330.1,NC_032652.1,77242179,82829447,82829448,t,tc,1
NC_037330.1,NC_032652.1,77300124,82887170,82887171,g,gc,1
NC_037330.1,NC_032652.1,77341251,82928305,82928306,T,TK,1
NC_037330.1,NC_032652.1,77360310,82947570,82947571,t,tc,1
NC_037330.1,NC_032652.1,77419784,83007052,83007055,t,ttgA,3
NC_037330.1,NC_032652.1,77432322,83019641,83019642,A,AG,1
NC_037330.1,NC_032652.1,77459693,83047012,83047014,a,aac,2
NC_037330.1,NC_032652.1,77530571,83149714,83149735,g,gNNNNNNNNNNNNNNNNNNNNN,21
NC_037330.1,NC_032652.1,77539039,83158208,83158209,C,CT,1
NC_037330.1,NC_032652.1,77640735,83264532,83264533,t,ta,1
NC_037330.1,NC_032652.1,77719699,83436332,83436335,T,TTTA,3
NC_037330.1,NC_032652.1,77743089,83459663,83459664,C,CA,1
NC_037330.1,NC_032652.1,77751318,83467892,83467893,t,ta,1
NC_037330.1,NC_032652.1,77767351,83483927,83483928,G,GT,1
NC_037330.1,NC_032652.1,77839944,14960990,14960991,c,ca,1
NC_037330.1,NC_032652.1,77840449,14961496,14961500,c,cagaa,4
NC_037330.1,NC_032652.1,77867234,83554510,83554511,c,cg,1
NC_037330.1,NC_032652.1,77869694,83558320,83558322,g,ggc,2
NC_037330.1,NC_032652.1,77869719,83558347,83558348,a,ag,1
NC_037330.1,NC_032652.1,77871556,83560185,83560186,g,ga,1
NC_037330.1,NC_032652.1,77916296,83604881,83604882,g,gc,1
NC_037330.1,NC_032652.1,77916377,83604963,83604964,a,ag,1
NC_037330.1,NC_032652.1,77942849,83631442,83631447,C,CATTGT,5
NC_037330.1,NC_032652.1,77956761,83645357,83645358,a,at,1
NC_037330.1,NC_032652.1,78003415,83692013,83692014,T,TC,1
NC_037330.1,NC_032652.1,78070990,83759764,83759765,a,at,1
NC_037330.1,NC_032652.1,78076720,83765498,83765503,a,aaaaac,5
NC_037330.1,NC_032652.1,78082331,83771114,83771115,T,TC,1
NC_037330.1,NC_032652.1,78100890,83789694,83789698,g,gctta,4
NC_037330.1,NC_032652.1,78192101,83880886,83880904,c,ccaaagcctttgactttgt,18
NC_037330.1,NC_032652.1,78211271,83900075,83900077,c,caa,2
NC_037330.1,NC_032652.1,78243260,83933073,83933078,c,caataa,5
NC_037330.1,NC_032652.1,78246339,83940521,83940522,g,gc,1
NC_037330.1,NC_032652.1,78246613,83940796,83940797,g,ga,1
NC_037330.1,NC_032652.1,78261432,83955747,83955748,A,AG,1
NC_037330.1,NC_032652.1,78261486,83955802,83955809,c,ccaaccta,7
NC_037330.1,NC_032652.1,78294967,83988749,83988750,g,gt,1
NC_037330.1,NC_032652.1,78311685,84005477,84005484,t,tttttttc,7
NC_037330.1,NC_032652.1,78339163,84032963,84032973,a,agtgtgtgtgt,10
NC_037330.1,NC_032652.1,78367094,84060903,84060904,G,GA,1
NC_037330.1,NC_032652.1,78422575,84115988,84115989,a,ag,1
NC_037330.1,NC_032652.1,78453802,84147202,84147204,g,ggt,2
NC_037330.1,NC_032652.1,78462842,84156244,84156245,A,AC,1
NC_037330.1,NC_032652.1,78505139,84198682,84198686,t,tNNNN,4
NC_037330.1,NC_032652.1,78532165,84226451,84226464,c,ctttcacttttcat,13
NC_037330.1,NC_032652.1,78551394,84244492,84244493,G,GW,1
NC_037330.1,NC_032652.1,78712795,84405906,84405908,g,gtt,2
NC_037330.1,NC_032652.1,78741573,84434688,84434690,c,ctt,2
NC_037330.1,NC_032652.1,78744895,84438012,84438014,a,atg,2
NC_037330.1,NC_032652.1,78755425,84448546,84448547,c,ct,1
NC_037330.1,NC_032652.1,78877907,84569399,84569400,g,ga,1
NC_037330.1,NC_032652.1,78949786,84647379,84647380,C,CA,1
NC_037330.1,NC_032652.1,78949793,84647387,84647388,A,AC,1
NC_037330.1,NC_032652.1,78961522,84659118,84659120,t,taa,2
NC_037330.1,NC_032652.1,78988618,84686295,84686296,T,TG,1
NC_037330.1,NC_032652.1,78995079,84692757,84692758,T,TA,1
NC_037330.1,NC_032652.1,78995115,84692794,84692795,G,GC,1
NC_037330.1,NC_032652.1,79016512,84714191,84714193,G,GGT,2
NC_037330.1,NC_032652.1,79040263,84737956,84737958,t,tta,2
NC_037330.1,NC_032652.1,79049397,84747171,84747173,A,ACG,2
NC_037330.1,NC_032652.1,79102736,84800524,84800525,t,ta,1
NC_037330.1,NC_032652.1,79118379,84816169,84816170,a,aW,1
NC_037330.1,NC_032652.1,79139393,84837189,84837190,T,TC,1
NC_037330.1,NC_032652.1,79165165,84862969,84862970,c,ct,1
NC_037330.1,NC_032652.1,79222930,84920756,84920760,t,tNNNN,4
NC_037330.1,NC_032652.1,79230345,84928175,84928176,A,AG,1
NC_037330.1,NC_032652.1,79236467,84934299,84934300,C,CM,1
NC_037330.1,NC_032652.1,79307142,85004964,85004965,a,at,1
NC_037330.1,NC_032652.1,79404977,85105657,85105658,A,AR,1
NC_037330.1,NC_032652.1,79405032,85105714,85105715,T,TA,1
NC_037330.1,NC_032652.1,79449526,85150213,85150214,c,ca,1
NC_037330.1,NC_032652.1,79468487,85169852,85169853,A,AR,1
NC_037330.1,NC_032652.1,79483149,85184517,85184519,C,CTA,2
NC_037330.1,NC_032652.1,79522025,85262550,85262552,T,TNN,2
NC_037330.1,NC_032652.1,79532915,85273442,85273447,t,tgtgcg,5
NC_037330.1,NC_032652.1,79589016,85329557,85329558,t,tg,1
NC_037330.1,NC_032652.1,79599171,85340028,85340029,a,ag,1
NC_037330.1,NC_032652.1,80033041,85733642,85733644,C,CTG,2
NC_037330.1,NC_032652.1,80033041,86102313,86102315,C,CTG,2
NC_037330.1,NC_032652.1,80063453,86132749,86132752,C,CKCT,3
NC_037330.1,NC_032652.1,80107603,85951864,85951865,G,GA,1
NC_037330.1,NC_032652.1,80152179,85996440,85996441,g,ga,1
NC_037330.1,NC_032652.1,80212774,86159330,86159332,C,CTG,2
NC_037330.1,NC_032652.1,80284467,86231502,86231503,G,GT,1
NC_037330.1,NC_032652.1,80335833,86283876,86283877,T,TA,1
NC_037330.1,NC_032652.1,80344641,86292686,86292687,c,ct,1
NC_037330.1,NC_032652.1,80405361,86353432,86353433,C,CS,1
NC_037330.1,NC_032652.1,80449598,86397675,86397676,c,ct,1
NC_037330.1,NC_032652.1,80497954,86445932,86445935,t,tgca,3
NC_037330.1,NC_032652.1,80575312,86523297,86523298,A,AG,1
NC_037330.1,NC_032652.1,80593635,86541582,86541583,a,ac,1
NC_037330.1,NC_032652.1,80593647,86541595,86541599,G,GGACA,4
NC_037330.1,NC_032652.1,80597873,86545825,86545829,C,CATGT,4
NC_037330.1,NC_032652.1,80602221,86550179,86550180,t,ta,1
NC_037330.1,NC_032652.1,80605569,86553528,86553529,T,TA,1
NC_037330.1,NC_032652.1,80645394,86592502,86592503,C,CM,1
NC_037330.1,NC_032652.1,80653335,86600625,86600626,A,AT,1
NC_037330.1,NC_032652.1,80659140,86606432,86606433,a,aM,1
NC_037330.1,NC_032652.1,80659143,86606436,86606437,c,ct,1
NC_037330.1,NC_032652.1,80675650,86622697,86622698,A,AR,1
NC_037330.1,NC_032652.1,80679928,86626974,86626975,t,tY,1
NC_037330.1,NC_032652.1,80812591,86759035,86759036,c,ct,1
NC_037330.1,NC_032652.1,80824738,86771184,86771187,a,atat,3
NC_037330.1,NC_032652.1,80881694,86828147,86828148,t,tc,1
NC_037330.1,NC_032652.1,80915029,86861484,86861487,C,CCCA,3
NC_037330.1,NC_032652.1,80943955,86891109,86891110,T,TG,1
NC_037330.1,NC_032652.1,80951351,86898510,86898513,a,acac,3
NC_037330.1,NC_032652.1,80952269,86899431,86899435,A,ACAGG,4
NC_037330.1,NC_032652.1,80957338,86904504,86904509,c,ctttaa,5
NC_037330.1,NC_032652.1,80957359,86904530,86904534,a,acccc,4
NC_037330.1,NC_032652.1,80960206,86907391,86907392,G,GA,1
NC_037330.1,NC_032652.1,81034324,86981403,86981404,t,tg,1
NC_037330.1,NC_032652.1,81043946,86991030,86991032,t,taa,2
NC_037330.1,NC_032652.1,81070179,87017263,87017264,G,GA,1
NC_037330.1,NC_032652.1,81105845,87066142,87066143,T,TW,1
NC_037330.1,NC_032652.1,81106896,87067194,87067195,a,ac,1
NC_037330.1,NC_032652.1,81107697,87067996,87067997,A,AR,1
NC_037330.1,NC_032652.1,81109240,87069539,87069540,A,AR,1
NC_037330.1,NC_032652.1,81136353,87096942,87096944,A,AGT,2
NC_037330.1,NC_032652.1,81144433,87105024,87105028,g,gagtc,4
NC_037330.1,NC_032652.1,81169598,87127600,87127601,t,tc,1
NC_037330.1,NC_032652.1,81172717,87130721,87130722,G,GR,1
NC_037330.1,NC_032652.1,81212009,87170005,87170010,t,taaaaa,5
NC_037330.1,NC_032652.1,81222603,87180601,87180602,a,ag,1
NC_037330.1,NC_032652.1,81224268,87182264,87182265,A,AR,1
NC_037330.1,NC_032652.1,81227532,87185526,87185528,T,TGW,2
NC_037330.1,NC_032652.1,81234377,87192373,87192374,C,CY,1
NC_037330.1,NC_032652.1,81238833,87196834,87196835,T,TC,1
NC_037330.1,NC_032652.1,81241047,87201664,87201670,g,gagacac,6
NC_037330.1,NC_032652.1,81266135,87227999,87228000,a,ag,1
NC_037330.1,NC_032652.1,81314640,87311371,87311372,A,AR,1
NC_037330.1,NC_032652.1,81321414,87318149,87318157,C,CACCCAAAA,8
NC_037330.1,NC_032652.1,81324007,87320750,87320751,G,GT,1
NC_037330.1,NC_032652.1,81351112,87347862,87347868,T,TGCCATA,6
NC_037330.1,NC_032652.1,81382329,87379088,87379089,G,GR,1
NC_037330.1,NC_032652.1,81414403,87420776,87420777,g,ga,1
NC_037330.1,NC_032652.1,81422082,87428456,87428457,c,ca,1
NC_037330.1,NC_032652.1,81422172,87428547,87428549,c,cct,2
NC_037330.1,NC_032652.1,81427756,87434134,87434135,G,GR,1
NC_037330.1,NC_032652.1,81432844,87439225,87439226,T,TG,1
NC_037330.1,NC_032652.1,81526489,87532882,87532883,a,aM,1
NC_037330.1,NC_032652.1,81832653,87839029,87839033,g,gcaac,4
NC_037330.1,NC_032652.1,81858082,87864463,87864466,T,TTTG,3
NC_037330.1,NC_032652.1,81862409,87868793,87868798,g,gtgtga,5
NC_037330.1,NC_032652.1,81878891,87885487,87885489,a,atM,2
NC_037330.1,NC_032652.1,81905394,87911993,87911996,C,CGTA,3
NC_037330.1,NC_032652.1,82038706,88045392,88045393,g,gc,1
NC_037330.1,NC_032652.1,82149905,88155873,88155874,A,AT,1
NC_037330.1,NC_032652.1,82245470,88252287,88252298,A,ACCCGAACCGGG,11
NC_037330.1,NC_032652.1,82332146,88338773,88338778,t,ttttaa,5
NC_037330.1,NC_032652.1,82407538,88412909,88412910,T,TN,1
NC_037330.1,NC_032652.1,82441520,88505841,88505842,G,GR,1
NC_037330.1,NC_032652.1,82505190,88569521,88569522,a,ag,1
NC_037330.1,NC_032652.1,82530551,88594918,88594919,G,GA,1
NC_037330.1,NC_032652.1,82743793,89024801,89024802,c,ct,1
NC_037330.1,NC_032652.1,82744687,89025697,89025704,T,TTCTTTCA,7
NC_037330.1,NC_032652.1,82750431,89031450,89031451,g,gt,1
NC_037330.1,NC_032652.1,82844774,89125834,89125838,g,gtggt,4
NC_037330.1,NC_032652.1,82856258,89137323,89137324,a,aN,1
NC_037330.1,NC_032652.1,82865492,89146559,89146560,G,GS,1
NC_037330.1,NC_032652.1,82894851,89176006,89176012,A,AATTTAG,6
NC_037330.1,NC_032652.1,82895465,89176627,89176630,c,cttt,3
NC_037330.1,NC_032652.1,82896688,89177853,89177854,a,at,1
NC_037330.1,NC_032652.1,82966709,89248178,89248179,T,TG,1
NC_037330.1,NC_032652.1,82970229,89251700,89251701,g,ga,1
NC_037330.1,NC_032652.1,82978625,89260100,89260101,T,TY,1
NC_037330.1,NC_032652.1,82981539,89263015,89263017,C,CAG,2
NC_037330.1,NC_032652.1,82986633,89268113,89268114,g,gt,1
NC_037330.1,NC_032652.1,83012811,89294306,89294307,g,gK,1
NC_037330.1,NC_032652.1,83082263,89363796,89363801,t,tgtagc,5
NC_037330.1,NC_032652.1,83087806,89369348,89369349,G,GC,1
NC_037330.1,NC_032652.1,83087813,89369356,89369357,A,AR,1
NC_037330.1,NC_032652.1,83170482,89451982,89451983,G,GA,1
NC_037330.1,NC_032652.1,83193139,89474596,89474598,c,ctg,2
NC_037330.1,NC_032652.1,83220998,89505146,89505148,a,aNN,2
NC_037330.1,NC_032652.1,83276604,89560740,89560741,G,GC,1
NC_037330.1,NC_032652.1,83321489,89605627,89605629,T,TTA,2
NC_037330.1,NC_032652.1,83344056,89628199,89628200,t,tc,1
NC_037330.1,NC_032652.1,83344573,89628717,89628718,t,tK,1
NC_037330.1,NC_032652.1,83403834,89694744,89694746,a,aac,2
NC_037330.1,NC_032652.1,83425742,89716510,89716511,T,TK,1
NC_037330.1,NC_032652.1,83529403,89868585,89868586,G,GM,1
NC_037330.1,NC_032652.1,83654611,89993924,89993925,c,ca,1
NC_037330.1,NC_032652.1,83671750,90011064,90011065,g,gc,1
NC_037330.1,NC_032652.1,83742785,90080552,90080555,t,tagc,3
NC_037330.1,NC_032652.1,83747895,90085671,90085672,A,AR,1
NC_037330.1,NC_032652.1,83772818,90110662,90110663,G,GA,1
NC_037330.1,NC_032652.1,83773827,90111671,90111675,c,ctttg,4
NC_037330.1,NC_032652.1,83773946,90111794,90111796,C,CAT,2
NC_037330.1,NC_032652.1,83791830,90128928,90128929,A,AR,1
NC_037330.1,NC_032652.1,83813601,90182489,90182490,C,CY,1
NC_037330.1,NC_032652.1,83841980,90210855,90210856,A,AC,1
NC_037330.1,NC_032652.1,83873141,90242036,90242037,C,CT,1
NC_037330.1,NC_032652.1,83873234,90242130,90242131,T,TN,1
NC_037330.1,NC_032652.1,83873280,90242177,90242179,t,ttg,2
NC_037330.1,NC_032652.1,83992827,90362075,90362119,G,GTCANNNNNTTATgtgataaatttattaatttattaatttaaaaa,44
NC_037330.1,NC_032652.1,84049751,90419491,90419492,t,tc,1
NC_037330.1,NC_032652.1,84176354,90546156,90546157,g,gt,1
NC_037330.1,NC_032652.1,84243858,90612686,90612702,g,gtatatatatatgtata,16
NC_037330.1,NC_032652.1,84251579,90620425,90620426,C,CY,1
NC_037330.1,NC_032652.1,84255183,90624030,90624031,G,GS,1
NC_037330.1,NC_032652.1,84395526,90764127,90764128,A,AG,1
NC_037330.1,NC_032652.1,84401938,90770541,90770542,T,TG,1
NC_037330.1,NC_032652.1,84631655,90999403,90999404,c,ct,1
NC_037330.1,NC_032652.1,84746665,91119331,91119338,T,TTTCTTAN,7
NC_037330.1,NC_032652.1,84782540,91155215,91155216,A,AG,1
NC_037330.1,NC_032652.1,84798734,91171412,91171413,c,ca,1
NC_037330.1,NC_032652.1,84841675,91214353,91214359,g,gacagct,6
NC_037330.1,NC_032652.1,84841791,91214475,91214476,t,tc,1
NC_037330.1,NC_032652.1,84842961,91215646,91215648,c,cct,2
NC_037330.1,NC_032652.1,84879387,91251989,91251990,G,GA,1
NC_037330.1,NC_032652.1,85025269,91414984,91414985,T,TY,1
NC_037330.1,NC_032652.1,85031537,91421253,91421257,a,aNNNN,4
NC_037330.1,NC_032652.1,85041599,91431685,91431704,c,ctctctctctctctcactct,19
NC_037330.1,NC_032652.1,85041660,91431765,91431766,A,AC,1
NC_037330.1,NC_032652.1,85046399,91436505,91436506,A,AR,1
NC_037330.1,NC_032652.1,85049044,91439012,91439028,a,accccatagacagcagc,16
NC_037330.1,NC_032652.1,85050937,91440919,91440920,A,AG,1
NC_037330.1,NC_032652.1,85051783,91441766,91441767,G,GA,1
NC_037330.1,NC_032652.1,85051955,91441940,91441942,t,tta,2
NC_037330.1,NC_032652.1,85052615,91442601,91442602,G,GR,1
NC_037330.1,NC_032652.1,85058963,91448945,91448946,A,AT,1
NC_037330.1,NC_032652.1,85059980,91449957,91449958,g,ga,1
NC_037330.1,NC_032652.1,85065962,91455952,91455953,A,AG,1
NC_037330.1,NC_032652.1,85184373,91564627,91564628,C,CA,1
NC_037330.1,NC_032652.1,85192900,91573163,91573164,T,TC,1
NC_037330.1,NC_032652.1,85192962,91573226,91573227,G,GA,1
NC_037330.1,NC_032652.1,85214603,91594644,91594645,c,ct,1
NC_037330.1,NC_032652.1,85216789,91596832,91596833,g,ga,1
NC_037330.1,NC_032652.1,85217217,91597265,91597269,c,ctttt,4
NC_037330.1,NC_032652.1,85220615,91608342,91608344,g,ggt,2
NC_037330.1,NC_032652.1,85235329,91623126,91623127,a,ag,1
NC_037330.1,NC_032652.1,85273408,91663821,91663826,t,ttaaaa,5
NC_037330.1,NC_032652.1,85337278,91729749,91729750,C,CA,1
NC_037330.1,NC_032652.1,85350640,91743111,91743113,c,cca,2
NC_037330.1,NC_032652.1,85396814,91789286,91789289,T,TCTG,3
NC_037330.1,NC_032652.1,85408018,91800501,91800506,g,gtgact,5
NC_037330.1,NC_032652.1,85414469,91813532,91813536,a,acact,4
NC_037330.1,NC_032652.1,85417966,91817605,91817609,T,TACTC,4
NC_037330.1,NC_032652.1,85418840,91818482,91818486,C,CAGAT,4
NC_037330.1,NC_032652.1,85489079,91888565,91888594,T,TNNNNNNNNNNNNNNNNNNNNNNNNNNNNN,29
NC_037330.1,NC_032652.1,85500016,91899533,91899534,G,GC,1
NC_037330.1,NC_032652.1,85528215,91927723,91927724,C,CM,1
NC_037330.1,NC_032652.1,85552483,91951988,91951989,T,TC,1
NC_037330.1,NC_032652.1,85565654,91965160,91965161,T,TC,1
NC_037330.1,NC_032652.1,85568634,91968138,91968140,T,TTA,2
NC_037330.1,NC_032652.1,85568801,91968307,91968308,T,TC,1
NC_037330.1,NC_032652.1,85583860,91983368,91983369,t,tg,1
NC_037330.1,NC_032652.1,85599176,91998825,91998831,g,ggtgggK,6
NC_037330.1,NC_032652.1,85650465,92050195,92050196,C,CT,1
NC_037330.1,NC_032652.1,85757707,92176036,92176042,t,tctctgc,6
NC_037330.1,NC_032652.1,85761210,92179544,92179545,C,CK,1
NC_037330.1,NC_032652.1,85767114,92185450,92185470,A,AATTCAGNNNNNNNNNNNNNN,20
NC_037330.1,NC_032652.1,85768721,92187078,92187086,a,acacacacW,8
NC_037330.1,NC_032652.1,85777407,92195373,92195374,T,TY,1
NC_037330.1,NC_032652.1,85778168,92196135,92196137,C,CTG,2
NC_037330.1,NC_032652.1,85779489,92197459,92197460,c,ca,1
NC_037330.1,NC_032652.1,85783648,92201632,92201634,G,GAA,2
NC_037330.1,NC_032652.1,85786735,92204721,92204722,T,TC,1
NC_037330.1,NC_032652.1,85792129,92210121,92210126,g,gactga,5
NC_037330.1,NC_032652.1,85799294,92217295,92217309,t,tgcgcacgcacacac,14
NC_037330.1,NC_032652.1,85808340,92226366,92226367,c,ct,1
NC_037330.1,NC_032652.1,85813039,92231074,92231087,c,caggaaagtgaaaa,13
NC_037330.1,NC_032652.1,85852065,92270086,92270087,t,ta,1
NC_037330.1,NC_032652.1,85878763,92296512,92296513,G,GC,1
NC_037330.1,NC_032652.1,85878766,92296516,92296517,A,AT,1
NC_037330.1,NC_032652.1,85878808,92296559,92296560,C,CA,1
NC_037330.1,NC_032652.1,85883524,92301276,92301278,a,aNN,2
NC_037330.1,NC_032652.1,86133541,92470826,92470827,t,ta,1
NC_037330.1,NC_032652.1,86135847,92473131,92473132,G,GS,1
NC_037330.1,NC_032652.1,86157360,92494717,92494718,T,TA,1
NC_037330.1,NC_032652.1,86160070,92497425,92497426,A,AG,1
NC_037330.1,NC_032652.1,86164549,92502214,92502215,t,tg,1
NC_037330.1,NC_032652.1,86165656,92503322,92503323,T,TA,1
NC_037330.1,NC_032652.1,86178685,92516364,92516380,t,tagcTTTCTANNNNNTC,16
NC_037330.1,NC_032652.1,86178762,92516457,92516458,t,tc,1
NC_037330.1,NC_032652.1,86184247,92521947,92521952,t,taaaaa,5
NC_037330.1,NC_032652.1,86209882,92547547,92547549,C,CCT,2
NC_037330.1,NC_032652.1,86271998,92609688,92609690,a,att,2
NC_037330.1,NC_032652.1,86287696,92625394,92625395,G,GR,1
NC_037330.1,NC_032652.1,86306879,92644574,92644582,c,cacacacag,8
NC_037330.1,NC_032652.1,86319938,92657647,92657649,c,cat,2
NC_037330.1,NC_032652.1,86364424,92701864,92701865,g,ga,1
NC_037330.1,NC_032652.1,86391733,92729393,92729394,g,gt,1
NC_037330.1,NC_032652.1,86542971,92881134,92881136,C,CTT,2
NC_037330.1,NC_032652.1,86635669,92974490,92974512,t,tttaTTNNNNNNNNNNNNNNNNN,22
NC_037330.1,NC_032652.1,86646260,92985104,92985105,t,ta,1
NC_037330.1,NC_032652.1,87107556,93462758,93462759,a,ac,1
NC_037330.1,NC_032652.1,87136138,93491340,93491341,A,AC,1
NC_037330.1,NC_032652.1,87178964,93529609,93529611,t,tNN,2
NC_037330.1,NC_032652.1,87292033,93642408,93642409,C,CS,1
NC_037330.1,NC_032652.1,87299566,93649942,93649943,C,CS,1
NC_037330.1,NC_032652.1,87386269,93736429,93736430,T,TA,1
NC_037330.1,NC_032652.1,87386420,93736581,93736582,T,TY,1
NC_037330.1,NC_032652.1,87405291,93755452,93755454,g,gga,2
NC_037330.1,NC_032652.1,87456673,93806836,93806837,C,CA,1
NC_037330.1,NC_032652.1,87461258,93811386,93811397,A,ACAGACGATCCG,11
NC_037330.1,NC_032652.1,87803065,94153793,94153794,T,TG,1
NC_037330.1,NC_032652.1,87859991,94210720,94210721,g,gc,1
NC_037330.1,NC_032652.1,87860022,94210752,94210753,g,gt,1
NC_037330.1,NC_032652.1,87969117,94319852,94319856,A,ATATG,4
NC_037330.1,NC_032652.1,87978092,94328830,94328831,g,ga,1
NC_037330.1,NC_032652.1,87997946,94348689,94348690,t,tc,1
NC_037330.1,NC_032652.1,88024620,94375370,94375371,A,AG,1
NC_037330.1,NC_032652.1,88037137,94387888,94387889,G,GA,1
NC_037330.1,NC_032652.1,88095536,94446295,94446298,T,TAAA,3
NC_037330.1,NC_032652.1,88121407,94472188,94472189,T,TY,1
NC_037330.1,NC_032652.1,88131514,94482306,94482330,T,TTCCATGGARGTTTCTCTTCTCTAG,24
NC_037330.1,NC_032652.1,88152336,94503152,94503153,a,at,1
NC_037330.1,NC_032652.1,88239383,94590201,94590202,C,CS,1
NC_037330.1,NC_032652.1,88239394,94590213,94590214,T,TC,1
NC_037330.1,NC_032652.1,88313030,94663918,94663919,c,ct,1
NC_037330.1,NC_032652.1,88317146,94668034,94668035,t,tg,1
NC_037330.1,NC_032652.1,88336686,94687568,94687583,T,TGTAGGAGAGACATGA,15
NC_037330.1,NC_032652.1,88338326,94689223,94689224,A,AR,1
NC_037330.1,NC_032652.1,88464736,94815577,94815578,C,CY,1
NC_037330.1,NC_032652.1,88500650,94851498,94851499,A,AT,1
NC_037330.1,NC_032652.1,88500650,95025804,95025805,A,AT,1
NC_037330.1,NC_032652.1,88510833,95035988,95035989,t,tN,1
NC_037330.1,NC_032652.1,88529251,94880881,94880883,C,CAG,2
NC_037330.1,NC_032652.1,88631520,94982549,94982550,t,tK,1
NC_037330.1,NC_032652.1,88646899,94997931,94997932,a,ag,1
NC_037330.1,NC_032652.1,88683526,95083149,95083150,C,CT,1
NC_037330.1,NC_032652.1,88688775,95088393,95088394,A,AC,1
NC_037330.1,NC_032652.1,88690060,95089679,95089680,a,at,1
NC_037330.1,NC_032652.1,88734358,95142638,95142641,c,ctct,3
NC_037330.1,NC_032652.1,88737535,95145820,95145822,C,CTG,2
NC_037330.1,NC_032652.1,88741643,95149931,95149932,a,ag,1
NC_037330.1,NC_032652.1,88758423,95166719,95166723,a,aacac,4
NC_037330.1,NC_032652.1,88807904,95215817,95215824,A,AGCATGTT,7
NC_037330.1,NC_032652.1,88830251,95238189,95238190,G,GR,1
NC_037330.1,NC_032652.1,88878913,95287161,95287163,A,AAT,2
NC_037330.1,NC_032652.1,88936107,95344226,95344229,G,GAAC,3
NC_037330.1,NC_032652.1,88948350,95356476,95356477,G,GR,1
NC_037330.1,NC_032652.1,88962375,95370506,95370508,C,CAA,2
NC_037330.1,NC_032652.1,88963391,95371522,95371523,g,gt,1
NC_037330.1,NC_032652.1,89004768,95412909,95412916,G,GGCAGCCC,7
NC_037330.1,NC_032652.1,89005061,95413209,95413213,C,CATCT,4
NC_037330.1,NC_032652.1,89134953,95543142,95543143,G,GA,1
NC_037330.1,NC_032652.1,89178610,95587541,95587542,t,tg,1
NC_037330.1,NC_032652.1,89229204,95638142,95638143,G,GR,1
NC_037330.1,NC_032652.1,89232022,95640904,95640908,a,atcac,4
NC_037330.1,NC_032652.1,89232107,95640993,95641002,c,cattatatat,9
NC_037330.1,NC_032652.1,89254842,95663864,95663865,T,TC,1
NC_037330.1,NC_032652.1,89262080,95671111,95671115,c,ccctt,4
NC_037330.1,NC_032652.1,89268042,95677078,95677080,c,cca,2
NC_037330.1,NC_032652.1,89270561,95679636,95679645,T,TCATATAGGG,9
NC_037330.1,NC_032652.1,89274951,95684038,95684039,G,GC,1
NC_037330.1,NC_032652.1,89277778,95686866,95686871,G,GGACTA,5
NC_037330.1,NC_032652.1,89317207,95726318,95726319,C,CT,1
NC_037330.1,NC_032652.1,89532727,95942257,95942258,t,tW,1
NC_037330.1,NC_032652.1,89570820,95980489,95980490,c,ca,1
NC_037330.1,NC_032652.1,89667811,96109220,96109221,c,ct,1
NC_037330.1,NC_032652.1,89684652,96125888,96125889,T,TC,1
NC_037330.1,NC_032652.1,89763102,96204272,96204273,A,AM,1
NC_037330.1,NC_032652.1,89774886,96216062,96216071,g,gcagcagcaR,9
NC_037330.1,NC_032652.1,89783530,96222885,96222886,G,GC,1
NC_037330.1,NC_032652.1,89799670,96238764,96238765,A,AR,1
NC_037330.1,NC_032652.1,89804873,96243971,96243972,T,TC,1
NC_037330.1,NC_032652.1,89809593,96248673,96248674,T,TY,1
NC_037330.1,NC_032652.1,89815452,96256082,96256107,A,AWAAAATACTTTTTCATGCTAAGCAG,25
NC_037330.1,NC_032652.1,89833201,96273841,96273843,C,CTT,2
NC_037330.1,NC_032652.1,89865730,96306404,96306411,c,cKTCAGCa,7
NC_037330.1,NC_032652.1,89868984,96309665,96309666,C,CA,1
NC_037330.1,NC_032652.1,89875403,96316090,96316093,t,tttc,3
NC_037330.1,NC_032652.1,89908156,96348844,96348852,T,TGACCAGTA,8
NC_037330.1,NC_032652.1,89987501,96428037,96428042,g,gttttt,5
NC_037330.1,NC_032652.1,90108222,96548063,96548064,c,ct,1
NC_037330.1,NC_032652.1,90118889,96558396,96558399,t,tcaa,3
NC_037330.1,NC_032652.1,90196532,96636008,96636052,c,ctggtgctagtggtaaaggacccatctgccaatgctggTAGATat,44
NC_037330.1,NC_032652.1,90211640,96651164,96651165,a,ac,1
NC_037330.1,NC_032652.1,90228131,96666334,96666335,T,TA,1
NC_037330.1,NC_032652.1,90340770,96779134,96779136,a,aNN,2
NC_037330.1,NC_032652.1,90355575,96793928,96793931,c,ctaS,3
NC_037330.1,NC_032652.1,90355584,96793940,96793944,a,aaagt,4
NC_037330.1,NC_032652.1,90355600,96793960,96793964,a,aaaat,4
NC_037330.1,NC_032652.1,90416918,96869327,96869328,A,AC,1
NC_037330.1,NC_032652.1,90436011,96888992,96888993,C,CT,1
NC_037330.1,NC_032652.1,90546540,97051854,97051858,C,CCTGA,4
NC_037330.1,NC_032652.1,90546974,97052292,97052294,G,GGA,2
NC_037330.1,NC_032652.1,90554403,97059619,97059621,T,TTC,2
NC_037330.1,NC_032652.1,90557589,97062811,97062813,a,aNN,2
NC_037330.1,NC_032652.1,90570863,97076092,97076099,T,TTTATTGA,7
NC_037330.1,NC_032652.1,90619305,97124543,97124544,A,AT,1
NC_037330.1,NC_032652.1,90675374,97180620,97180621,t,ta,1
NC_037330.1,NC_032652.1,90726358,97231612,97231613,A,AG,1
NC_037330.1,NC_032652.1,90748278,97253535,97253536,c,ca,1
NC_037330.1,NC_032652.1,90748364,97253622,97253623,g,ga,1
NC_037330.1,NC_032652.1,90766409,97271707,97271708,a,aW,1
NC_037330.1,NC_032652.1,90766766,97272065,97272066,c,ca,1
NC_037330.1,NC_032652.1,90866493,97370730,97370731,C,CY,1
NC_037330.1,NC_032652.1,90869977,97374217,97374232,t,ttagtagtagtagtag,15
NC_037330.1,NC_032652.1,90891928,97396185,97396189,C,CAGAT,4
NC_037330.1,NC_032652.1,90897025,97401284,97401285,A,AR,1
NC_037330.1,NC_032652.1,90935147,97439428,97439429,G,GR,1
NC_037330.1,NC_032652.1,90963378,97467661,97467662,A,AT,1
NC_037330.1,NC_032652.1,90975968,97480254,97480255,A,AC,1
NC_037330.1,NC_032652.1,90979083,97483372,97483373,T,TA,1
NC_037330.1,NC_032652.1,90981864,97486155,97486156,A,AT,1
NC_037330.1,NC_032652.1,91003266,97507574,97507575,A,AR,1
NC_037330.1,NC_032652.1,91060896,97565210,97565211,A,AG,1
NC_037330.1,NC_032652.1,91115145,97622903,97622905,A,AAG,2
NC_037330.1,NC_032652.1,91205514,97760779,97760780,G,GS,1
NC_037330.1,NC_032652.1,91275880,97831141,97831143,C,CTG,2
NC_037330.1,NC_032652.1,91295058,97850322,97850324,T,TTC,2
NC_037330.1,NC_032652.1,91299066,97854333,97854334,t,tg,1
NC_037330.1,NC_032652.1,91299072,97854340,97854341,t,ta,1
NC_037330.1,NC_032652.1,91299103,97854372,97854373,t,tc,1
NC_037330.1,NC_032652.1,91370905,97926246,97926247,g,gt,1
NC_037330.1,NC_032652.1,91372466,97927800,97927801,G,GA,1
NC_037330.1,NC_032652.1,91379233,97934569,97934570,g,ga,1
NC_037330.1,NC_032652.1,91379260,97934597,97934598,a,at,1
NC_037330.1,NC_032652.1,91390033,97945398,97945399,c,ct,1
NC_037330.1,NC_032652.1,91574938,98119571,98119573,t,tKG,2
NC_037330.1,NC_032652.1,91650550,98194835,98194836,C,CA,1
NC_037330.1,NC_032652.1,91735400,98279686,98279687,t,ta,1
NC_037330.1,NC_032652.1,91746027,98290310,98290312,g,gct,2
NC_037330.1,NC_032652.1,91754532,98298804,98298813,C,CTTTCCccct,9
NC_037330.1,NC_032652.1,91761427,98305704,98305707,A,ATCT,3
NC_037330.1,NC_032652.1,91841175,98385990,98385991,T,TA,1
NC_037330.1,NC_032652.1,91841707,98386524,98386525,A,AC,1
NC_037330.1,NC_032652.1,91888766,98433561,98433563,g,ggt,2
NC_037330.1,NC_032652.1,91905922,98450720,98450721,T,TG,1
NC_037330.1,NC_032652.1,91975302,98520094,98520095,G,GC,1
NC_037330.1,NC_032652.1,91980631,98525420,98525421,C,CN,1
NC_037330.1,NC_032652.1,91980776,98525565,98525566,C,CT,1
NC_037330.1,NC_032652.1,92007646,98552359,98552364,C,CCCTCT,5
NC_037330.1,NC_032652.1,92106253,98650897,98650898,T,TC,1
NC_037330.1,NC_032652.1,92165339,98782387,98782396,T,TAGAAATATA,9
NC_037330.1,NC_032652.1,92227360,98844409,98844412,t,ttaa,3
NC_037330.1,NC_032652.1,92227693,98844745,98844746,c,ct,1
NC_037330.1,NC_032652.1,92246969,98864017,98864018,c,ct,1
NC_037330.1,NC_032652.1,92251104,98868139,98868141,t,taa,2
NC_037330.1,NC_032652.1,92252126,98869163,98869164,T,TA,1
NC_037330.1,NC_032652.1,92299616,98892738,98892740,A,AAT,2
NC_037330.1,NC_032652.1,92300622,98893746,98893747,T,TC,1
NC_037330.1,NC_032652.1,92312552,98930762,98930763,C,CN,1
NC_037330.1,NC_032652.1,92349110,98967289,98967290,A,AG,1
NC_037330.1,NC_032652.1,92361387,98979602,98979604,A,ACG,2
NC_037330.1,NC_032652.1,92369317,98987597,98987598,G,GR,1
NC_037330.1,NC_032652.1,92380219,98998384,98998389,a,agtcgt,5
NC_037330.1,NC_032652.1,92420222,99038391,99038392,T,TC,1
NC_037330.1,NC_032652.1,92432717,99050883,99050885,G,GGA,2
NC_037330.1,NC_032652.1,92435885,99054059,99054060,a,at,1
NC_037330.1,NC_032652.1,92445202,99063412,99063415,T,TGAC,3
NC_037330.1,NC_032652.1,92448805,99067019,99067020,a,at,1
NC_037330.1,NC_032652.1,92457577,99075797,99075798,A,AG,1
NC_037330.1,NC_032652.1,92528521,99147906,99147908,a,aat,2
NC_037330.1,NC_032652.1,92528611,99147998,99148001,g,gccc,3
NC_037330.1,NC_032652.1,92642631,99259534,99259536,G,GMK,2
NC_037330.1,NC_032652.1,92643317,99260222,99260223,c,ca,1
NC_037330.1,NC_032652.1,92674989,99291895,99291899,c,cactt,4
NC_037330.1,NC_032652.1,92702882,99319794,99319808,C,CAGACTGCTTTTCCM,14
NC_037330.1,NC_032652.1,92704209,99321135,99321138,C,CCTT,3
NC_037330.1,NC_032652.1,92731817,99348755,99348759,a,aacac,4
NC_037330.1,NC_032652.1,92739622,99356566,99356567,C,CT,1
NC_037330.1,NC_032652.1,92810633,99449600,99449601,G,GC,1
NC_037330.1,NC_032652.1,92905071,99611182,99611186,t,tttgc,4
NC_037330.1,NC_032652.1,92916332,99622447,99622450,t,tttc,3
NC_037330.1,NC_032652.1,92917152,99623270,99623289,A,AATTCACAACTTCAATTCAC,19
NC_037330.1,NC_032652.1,92936968,99642605,99642607,T,TTG,2
NC_037330.1,NC_032652.1,92971842,99677477,99677478,G,GC,1
NC_037330.1,NC_032652.1,92982182,99687819,99687820,a,ac,1
NC_037330.1,NC_032652.1,92982201,99687839,99687840,a,aM,1
NC_037330.1,NC_032652.1,93061464,99767154,99767155,g,gc,1
NC_037330.1,NC_032652.1,93097503,99803206,99803207,t,ta,1
NC_037330.1,NC_032652.1,93098510,99804216,99804217,A,AR,1
NC_037330.1,NC_032652.1,93130912,99836631,99836632,C,CT,1
NC_037330.1,NC_032652.1,93132805,99838525,99838526,c,ca,1
NC_037330.1,NC_032652.1,93213410,99919458,99919459,g,gc,1
NC_037330.1,NC_032652.1,93227574,99933773,99933775,c,ctg,2
NC_037330.1,NC_032652.1,93227925,99934124,99934126,C,CAG,2
NC_037330.1,NC_032652.1,93228569,99934768,99934771,C,CCAA,3
NC_037330.1,NC_032652.1,93233606,99939808,99939809,t,tN,1
NC_037330.1,NC_032652.1,93236929,99942015,99942016,t,ta,1
NC_037330.1,NC_032652.1,93237178,99942265,99942268,c,cgca,3
NC_037330.1,NC_032652.1,93255177,99960263,99960264,g,ga,1
NC_037330.1,NC_032652.1,93256223,99961310,99961311,g,ga,1
NC_037330.1,NC_032652.1,93257493,99962581,99962584,t,taaa,3
NC_037330.1,NC_032652.1,93259124,99964235,99964236,T,TG,1
NC_037330.1,NC_032652.1,93278676,99983799,99983802,A,AAAT,3
NC_037330.1,NC_032652.1,93283679,99988810,99988811,C,CA,1
NC_037330.1,NC_032652.1,93297831,100002968,100002969,g,ga,1
NC_037330.1,NC_032652.1,93586186,100298597,100298598,t,tc,1
NC_037330.1,NC_032652.1,93594416,100306845,100306846,g,gc,1
NC_037330.1,NC_032652.1,93594427,100306857,100306858,c,ca,1
NC_037330.1,NC_032652.1,93594430,100306861,100306862,t,tg,1
NC_037330.1,NC_032652.1,93598251,100310684,100310687,G,GTTA,3
NC_037330.1,NC_032652.1,93599259,100311693,100311694,a,at,1
NC_037330.1,NC_032652.1,93603390,100315827,100315829,G,GGA,2
NC_037330.1,NC_032652.1,93604084,100316535,100316538,a,aaat,3
NC_037330.1,NC_032652.1,93631799,100346463,100346464,C,CT,1
NC_037330.1,NC_032652.1,93646240,100359925,100359926,a,at,1
NC_037330.1,NC_032652.1,93725863,100444375,100444376,C,CG,1
NC_037330.1,NC_032652.1,93803296,100521895,100521896,g,gc,1
NC_037330.1,NC_032652.1,93884603,100633536,100633540,a,aNNNN,4
NC_037330.1,NC_032652.1,93887974,100636909,100636910,a,at,1
NC_037330.1,NC_032652.1,93887976,100636912,100636913,t,ta,1
NC_037330.1,NC_032652.1,93919095,100668173,100668174,T,TK,1
NC_037330.1,NC_032652.1,93999336,100748418,100748419,a,at,1
NC_037330.1,NC_032652.1,94008422,100757506,100757507,a,at,1
NC_037330.1,NC_032652.1,94126946,100875853,100875860,c,cgtcgaca,7
NC_037330.1,NC_032652.1,94133519,100882433,100882434,a,at,1
NC_037330.1,NC_032652.1,94143649,100892566,100892567,G,GN,1
NC_037330.1,NC_032652.1,94196801,100945523,100945534,c,ctggcatgctga,11
NC_037330.1,NC_032652.1,94212111,100960725,100960729,a,atatg,4
NC_037330.1,NC_032652.1,94219401,100968020,100968022,a,aag,2
NC_037330.1,NC_032652.1,94277944,101026813,101026814,G,GA,1
NC_037330.1,NC_032652.1,94298580,101047297,101047306,a,atatatatat,9
NC_037330.1,NC_032652.1,94434397,101182506,101182508,a,aNN,2
NC_037330.1,NC_032652.1,94564319,101319085,101319086,t,tc,1
NC_037330.1,NC_032652.1,94723252,101477190,101477192,C,CAT,2
NC_037330.1,NC_032652.1,94823376,101577547,101577551,T,TAGAG,4
NC_037330.1,NC_032652.1,94865946,101619585,101619586,T,TC,1
NC_037330.1,NC_032652.1,94875474,101628651,101628653,a,att,2
NC_037330.1,NC_032652.1,94912776,101665940,101665941,G,GA,1
NC_037330.1,NC_032652.1,94932088,101685085,101685086,T,TC,1
NC_037330.1,NC_032652.1,94953979,101741046,101741047,C,CA,1
NC_037330.1,NC_032652.1,94981837,101768903,101768904,T,TA,1
NC_037330.1,NC_032652.1,95107850,101899275,101899276,A,AR,1
NC_037330.1,NC_032652.1,95127667,101919094,101919095,t,tc,1
NC_037330.1,NC_032652.1,95129838,101921266,101921268,a,aNN,2
NC_037330.1,NC_032652.1,95320246,102109896,102109897,t,ta,1
NC_037330.1,NC_032652.1,95322322,102111975,102111977,a,aat,2
NC_037330.1,NC_032652.1,95613548,102403042,102403043,G,GK,1
NC_037330.1,NC_032652.1,95615232,102404728,102404729,c,ct,1
NC_037330.1,NC_032652.1,95638951,102428562,102428563,t,tg,1
NC_037330.1,NC_032652.1,95663557,102453177,102453178,g,gc,1
NC_037330.1,NC_032652.1,95663572,102453193,102453196,c,ctct,3
NC_037330.1,NC_032652.1,95689242,102478437,102478449,C,CCTAATCTTTGAT,12
NC_037330.1,NC_032652.1,95740284,102529800,102529801,T,TA,1
NC_037330.1,NC_032652.1,95814147,102603664,102603665,g,gt,1
NC_037330.1,NC_032652.1,95831588,102621105,102621108,T,TGAG,3
NC_037330.1,NC_032652.1,95871177,102660710,102660714,T,TATTA,4
NC_037330.1,NC_032652.1,95884246,102673784,102673786,a,act,2
NC_037330.1,NC_032652.1,95926411,102715926,102715927,a,ac,1
NC_037330.1,NC_032652.1,95984307,102773861,102773862,C,CA,1
NC_037330.1,NC_032652.1,96135287,102931892,102931893,G,GC,1
NC_037330.1,NC_032652.1,96214988,103011553,103011554,A,AG,1
NC_037330.1,NC_032652.1,96324999,103067245,103067248,t,tttc,3
NC_037330.1,NC_032652.1,96350190,103204660,103204661,t,tg,1
NC_037330.1,NC_032652.1,96385239,103252445,103252446,g,gc,1
NC_037330.1,NC_032652.1,96444154,103360920,103360926,t,tNNNNNN,6
NC_037330.1,NC_032652.1,96451901,103368679,103368680,t,tg,1
NC_037330.1,NC_032652.1,96452608,103369387,103369388,g,gt,1
NC_037330.1,NC_032652.1,96453888,103370668,103370676,a,atcttgatt,8
NC_037330.1,NC_032652.1,96453891,103370679,103370687,t,tgggagaaa,8
NC_037330.1,NC_032652.1,96457003,103373825,103373826,c,ct,1
NC_037330.1,NC_032652.1,96474345,103391169,103391170,G,GA,1
NC_037330.1,NC_032652.1,96491000,103408719,103408721,a,aag,2
NC_037330.1,NC_032652.1,96508271,103426001,103426004,t,tcaa,3
NC_037330.1,NC_032652.1,96510447,103428180,103428181,t,ta,1
NC_037330.1,NC_032652.1,96552060,103469792,103469793,c,ct,1
NC_037330.1,NC_032652.1,96584774,103502516,103502517,G,GT,1
NC_037330.1,NC_032652.1,96587286,103505031,103505032,A,AW,1
NC_037330.1,NC_032652.1,96588545,103506292,103506293,a,at,1
NC_037330.1,NC_032652.1,96608016,103525751,103525758,g,gaaagtga,7
NC_037330.1,NC_032652.1,96654275,103572005,103572011,c,ccccccg,6
NC_037330.1,NC_032652.1,96660700,103578440,103578441,c,ct,1
NC_037330.1,NC_032652.1,96663470,103581211,103581223,a,aaaNNNNNNNNNN,12
NC_037330.1,NC_032652.1,96673705,103591459,103591460,c,ct,1
NC_037330.1,NC_032652.1,96680300,103598148,103598150,g,gaa,2
NC_037330.1,NC_032652.1,96755045,103672900,103672909,A,AAATACTTTC,9
NC_037330.1,NC_032652.1,96777798,103695923,103695925,a,atc,2
NC_037330.1,NC_032652.1,96788736,103706866,103706867,T,TY,1
NC_037330.1,NC_032652.1,96801989,103720125,103720127,a,aac,2
NC_037330.1,NC_032652.1,96802333,103720471,103720472,t,tc,1
NC_037330.1,NC_032652.1,96837997,103756046,103756056,t,tNNNNNNNNNN,10
NC_037330.1,NC_032652.1,96861665,103779726,103779730,T,TAGTW,4
NC_037330.1,NC_032652.1,96973069,103892110,103892111,a,ag,1
NC_037330.1,NC_032652.1,97001204,103920487,103920489,t,tta,2
NC_037330.1,NC_032652.1,97004150,103923438,103923439,a,at,1
NC_037330.1,NC_032652.1,97026181,103945473,103945477,t,ttgtg,4
NC_037330.1,NC_032652.1,97079827,103997713,103997719,T,TTTACTC,6
NC_037330.1,NC_032652.1,97094291,104012195,104012214,t,tacattttttttttttttgc,19
NC_037330.1,NC_032652.1,97094449,104012372,104012373,A,AT,1
NC_037330.1,NC_032652.1,97136502,104054257,104054258,G,GT,1
NC_037330.1,NC_032652.1,97175716,104093480,104093481,a,ag,1
NC_037330.1,NC_032652.1,97211161,104129000,104129002,C,CTT,2
NC_037330.1,NC_032652.1,97220062,104137904,104137924,g,gcacacacacacacacacaca,20
NC_037330.1,NC_032652.1,97221387,104139249,104139251,A,ACT,2
NC_037330.1,NC_032652.1,97221393,104139257,104139262,A,AAAAAG,5
NC_037330.1,NC_032652.1,97259210,104177162,104177163,A,AC,1
NC_037330.1,NC_032652.1,97315700,104233651,104233653,a,aat,2
NC_037330.1,NC_032652.1,97334420,104252376,104252377,A,AT,1
NC_037330.1,NC_032652.1,97334423,104252380,104252382,G,GAA,2
NC_037330.1,NC_032652.1,97434137,104353672,104353673,T,TG,1
NC_037330.1,NC_032652.1,97508706,104428068,104428069,g,ga,1
NC_037330.1,NC_032652.1,97531082,104450321,104450322,A,AC,1
NC_037330.1,NC_032652.1,97576039,104495279,104495280,T,TA,1
NC_037330.1,NC_032652.1,97577397,104496642,104496644,T,TAG,2
NC_037330.1,NC_032652.1,97602568,104521815,104521817,g,gca,2
NC_037330.1,NC_032652.1,97630623,104549962,104549963,G,GS,1
NC_037330.1,NC_032652.1,97636470,104555809,104555810,C,CT,1
NC_037330.1,NC_032652.1,97685499,104604821,104604822,C,CS,1
NC_037330.1,NC_032652.1,97699810,104619133,104619134,C,CM,1
NC_037330.1,NC_032652.1,97716649,104635977,104635978,A,AG,1
NC_037330.1,NC_032652.1,97719531,104638859,104638860,T,TY,1
NC_037330.1,NC_032652.1,97739038,104658369,104658377,t,tcccccgtc,8
NC_037330.1,NC_032652.1,97778495,104697831,104697832,A,AT,1
NC_037330.1,NC_032652.1,97783055,104702392,104702393,t,tY,1
NC_037330.1,NC_032652.1,97793638,104712989,104712991,T,TTC,2
NC_037330.1,NC_032652.1,97806341,104725686,104725687,c,ca,1
NC_037330.1,NC_032652.1,97839667,104761551,104761552,A,AW,1
NC_037330.1,NC_032652.1,97841301,104763187,104763192,C,CATTGT,5
NC_037330.1,NC_032652.1,97841534,104763425,104763426,G,GK,1
NC_037330.1,NC_032652.1,97859397,104781273,104781282,g,ggagaatttt,9
NC_037330.1,NC_032652.1,97874198,104796144,104796147,T,TTAA,3
NC_037330.1,NC_032652.1,97877868,104799828,104799829,G,GT,1
NC_037330.1,NC_032652.1,97881900,104803855,104803856,g,ga,1
NC_037330.1,NC_032652.1,97884226,104806195,104806196,G,GT,1
NC_037330.1,NC_032652.1,97889167,104811140,104811142,C,CAT,2
NC_037330.1,NC_032652.1,97912660,104833980,104833982,a,agc,2
NC_037330.1,NC_032652.1,97913182,104834505,104834506,t,tc,1
NC_037330.1,NC_032652.1,97913456,104834780,104834785,a,aaaaat,5
NC_037330.1,NC_032652.1,97914363,104835692,104835695,t,tctc,3
NC_037330.1,NC_032652.1,97914849,104836181,104836182,c,ct,1
NC_037330.1,NC_032652.1,97916550,104837892,104837898,A,AGTGCCG,6
NC_037330.1,NC_032652.1,97919450,104840798,104840799,A,AT,1
NC_037330.1,NC_032652.1,97925739,104846660,104846661,a,at,1
NC_037330.1,NC_032652.1,97926807,104847731,104847732,C,CG,1
NC_037330.1,NC_032652.1,97930735,104851657,104851661,T,TTTAC,4
NC_037330.1,NC_032652.1,97938684,104859511,104859512,g,gt,1
NC_037330.1,NC_032652.1,97945377,104866206,104866210,a,atatR,4
NC_037330.1,NC_032652.1,98023950,104944784,104944785,t,ta,1
NC_037330.1,NC_032652.1,98035311,104956147,104956148,t,ta,1
NC_037330.1,NC_032652.1,98054332,104975171,104975172,a,ac,1
NC_037330.1,NC_032652.1,98186490,105091852,105091853,g,ga,1
NC_037330.1,NC_032652.1,98229827,105135194,105135196,C,CAG,2
NC_037330.1,NC_032652.1,98237435,105146848,105146849,t,ta,1
NC_037330.1,NC_032652.1,98259479,105168892,105168893,G,GS,1
NC_037330.1,NC_032652.1,98265695,105175102,105175103,a,ag,1
NC_037330.1,NC_032652.1,98375938,105285432,105285433,t,tg,1
NC_037330.1,NC_032652.1,98377254,105286675,105286676,C,CA,1
NC_037330.1,NC_032652.1,98377355,105286777,105286778,T,TA,1
NC_037330.1,NC_032652.1,98377364,105286787,105286788,T,TA,1
NC_037330.1,NC_032652.1,98507788,105416698,105416703,T,TTCAAG,5
NC_037330.1,NC_032652.1,98516282,105425197,105425198,G,GR,1
NC_037330.1,NC_032652.1,98536013,105445390,105445392,g,ggc,2
NC_037330.1,NC_032652.1,98536445,105445824,105445825,A,AR,1
NC_037330.1,NC_032652.1,98545275,105454654,105454655,A,AG,1
NC_037330.1,NC_032652.1,98548866,105458246,105458247,T,TK,1
NC_037330.1,NC_032652.1,98552955,105462336,105462337,A,AG,1
NC_037330.1,NC_032652.1,98575143,105484489,105484490,T,TK,1
NC_037330.1,NC_032652.1,98578504,105487849,105487850,C,CT,1
NC_037330.1,NC_032652.1,98662189,105572066,105572067,a,ag,1
NC_037330.1,NC_032652.1,98884072,105794413,105794414,g,ga,1
NC_037330.1,NC_032652.1,98900193,105810535,105810536,C,CG,1
NC_037330.1,NC_032652.1,98900196,105810539,105810540,T,TA,1
NC_037330.1,NC_032652.1,98912645,105822885,105822887,T,TCC,2
NC_037330.1,NC_032652.1,98930337,105840579,105840580,T,TG,1
NC_037330.1,NC_032652.1,98937553,105847798,105847799,G,GC,1
NC_037330.1,NC_032652.1,98947293,105857541,105857542,A,AT,1
NC_037330.1,NC_032652.1,98998041,105904212,105904213,A,AW,1
NC_037330.1,NC_032652.1,99002522,105908694,105908696,C,CTA,2
NC_037330.1,NC_032652.1,99037506,105943693,105943696,A,ACAM,3
NC_037330.1,NC_032652.1,99195034,106093928,106093929,t,ta,1
NC_037330.1,NC_032652.1,99266986,106165532,106165533,A,AG,1
NC_037330.1,NC_032652.1,99297393,106197096,106197097,G,GA,1
NC_037330.1,NC_032652.1,99297397,106197101,106197102,T,TA,1
NC_037330.1,NC_032652.1,99420795,106320500,106320501,C,CS,1
NC_037330.1,NC_032652.1,99459349,106359059,106359060,C,CS,1
NC_037330.1,NC_032652.1,99605879,106505863,106505864,C,CT,1
NC_037330.1,NC_032652.1,99692663,106593346,106593347,C,CG,1
NC_037330.1,NC_032652.1,99766448,106667235,106667237,C,CTA,2
NC_037330.1,NC_032652.1,99881381,106781995,106781996,C,CA,1
NC_037330.1,NC_032652.1,99927210,106827855,106827856,G,GT,1
NC_037330.1,NC_032652.1,99927607,106828253,106828254,c,ct,1
NC_037330.1,NC_032652.1,99930605,106831252,106831253,T,TC,1
NC_037330.1,NC_032652.1,99944975,106845650,106845652,T,TAA,2
NC_037330.1,NC_032652.1,99967571,106868252,106868254,T,TTG,2
NC_037330.1,NC_032652.1,99984913,106885594,106885595,a,at,1
NC_037330.1,NC_032652.1,100094243,106991745,106991746,t,tg,1
NC_037330.1,NC_032652.1,100107123,107004625,107004626,t,ta,1
NC_037330.1,NC_032652.1,100114652,107012144,107012145,a,at,1
NC_037330.1,NC_032652.1,100123551,107021046,107021047,t,tc,1
NC_037330.1,NC_032652.1,100124704,107022198,107022199,g,gc,1
NC_037330.1,NC_032652.1,100136874,107034372,107034374,G,GGA,2
NC_037330.1,NC_032652.1,100160020,107057519,107057530,a,aagcagtaacag,11
NC_037330.1,NC_032652.1,100199639,107097171,107097172,c,cg,1
NC_037330.1,NC_032652.1,100262818,107131448,107131449,c,ct,1
NC_037330.1,NC_032652.1,100424221,107338058,107338059,G,GA,1
NC_037330.1,NC_032652.1,100449396,107363246,107363247,t,tg,1
NC_037330.1,NC_032652.1,100449474,107363325,107363326,c,ct,1
NC_037330.1,NC_032652.1,100461894,107375749,107375751,t,tta,2
NC_037330.1,NC_032652.1,100493689,107407555,107407558,t,ttgc,3
NC_037330.1,NC_032652.1,100500159,107414033,107414034,t,tg,1
NC_037330.1,NC_032652.1,100512130,107426006,107426007,c,ct,1
NC_037330.1,NC_032652.1,100560105,107474028,107474035,g,gcagtcCC,7
NC_037330.1,NC_032652.1,100567345,107481278,107481280,A,AAK,2
NC_037330.1,NC_032652.1,100646033,107526122,107526123,t,tg,1
NC_037330.1,NC_032652.1,101002269,107883240,107883241,t,ta,1
NC_037330.1,NC_032652.1,101010035,107891006,107891007,T,TC,1
NC_037330.1,NC_032652.1,101011357,107892330,107892331,T,TC,1
NC_037330.1,NC_032652.1,101011364,107892338,107892339,A,AC,1
NC_037330.1,NC_032652.1,101011372,107892347,107892348,C,CT,1
NC_037330.1,NC_032652.1,101011486,107892462,107892463,G,GC,1
NC_037330.1,NC_032652.1,101011659,107892635,107892636,A,AG,1
NC_037330.1,NC_032652.1,101011922,107892900,107892901,G,GA,1
NC_037330.1,NC_032652.1,101012207,107893182,107893183,G,GA,1
NC_037330.1,NC_032652.1,101012990,107893964,107893965,A,AG,1
NC_037330.1,NC_032652.1,101013466,107894439,107894440,C,CG,1
NC_037330.1,NC_032652.1,101013753,107894724,107894725,G,GC,1
NC_037330.1,NC_032652.1,101013878,107894848,107894849,g,ga,1
NC_037330.1,NC_032652.1,101013933,107894904,107894905,A,AT,1
NC_037330.1,NC_032652.1,101014029,107895000,107895001,T,TG,1
NC_037330.1,NC_032652.1,101014175,107895145,107895146,T,TA,1
NC_037330.1,NC_032652.1,101014307,107895278,107895279,T,TA,1
NC_037330.1,NC_032652.1,101014321,107895293,107895294,G,GC,1
NC_037330.1,NC_032652.1,101014464,107895435,107895436,G,GC,1
NC_037330.1,NC_032652.1,101014513,107895484,107895485,G,GC,1
NC_037330.1,NC_032652.1,101015017,107895986,107895987,C,CT,1
NC_037330.1,NC_032652.1,101015061,107896031,107896032,T,TG,1
NC_037330.1,NC_032652.1,101025629,107885163,107885164,g,gt,1
NC_037330.1,NC_032652.1,101026129,107885664,107885665,c,ct,1
NC_037330.1,NC_032652.1,101026626,107886162,107886163,c,ct,1
NC_037330.1,NC_032652.1,101026684,107886221,107886222,g,gc,1
NC_037330.1,NC_032652.1,101027272,107886810,107886811,a,at,1
NC_037330.1,NC_032652.1,101081568,107941112,107941116,a,aNNNN,4
NC_037330.1,NC_032652.1,101148296,108007490,108007491,c,ct,1
NC_037330.1,NC_032652.1,101156928,108016130,108016131,T,TG,1
NC_037330.1,NC_032652.1,101158128,108017331,108017333,t,taa,2
NC_037330.1,NC_032652.1,101159992,108019200,108019201,t,ta,1
NC_037330.1,NC_032652.1,101174794,108033874,108033888,G,GGAAAGAAGGGAGCT,14
NC_037330.1,NC_032652.1,101281647,108140260,108140261,a,ag,1
NC_037330.1,NC_032652.1,101296798,108155413,108155414,g,gt,1
NC_037330.1,NC_032652.1,101342286,108200917,108200921,C,CTGTT,4
NC_037330.1,NC_032652.1,101515111,108374398,108374400,c,cca,2
NC_037330.1,NC_032652.1,101515301,108374590,108374591,T,TY,1
NC_037330.1,NC_032652.1,101518958,108378245,108378246,A,AM,1
NC_037330.1,NC_032652.1,101542446,108401555,108401556,t,ta,1
NC_037330.1,NC_032652.1,101546813,108405587,108405588,T,TG,1
NC_037330.1,NC_032652.1,101548757,108407532,108407534,t,ttc,2
NC_037330.1,NC_032652.1,101550436,108409219,108409221,C,CTA,2
NC_037330.1,NC_032652.1,101551332,108410118,108410119,C,CT,1
NC_037330.1,NC_032652.1,101551794,108410581,108410582,C,CT,1
NC_037330.1,NC_032652.1,101566526,108425313,108425314,g,ga,1
NC_037330.1,NC_032652.1,101566537,108425325,108425326,t,tc,1
NC_037330.1,NC_032652.1,101567242,108433360,108433366,t,tggggaa,6
NC_037330.1,NC_032652.1,101787019,108661376,108661377,T,TK,1
NC_037330.1,NC_032652.1,101834054,108708410,108708414,g,ggggt,4
NC_037330.1,NC_032652.1,101838351,108712712,108712713,t,tg,1
NC_037330.1,NC_032652.1,101870519,108744880,108744881,T,TA,1
NC_037330.1,NC_032652.1,101894100,108768497,108768498,a,at,1
NC_037330.1,NC_032652.1,101898291,108772685,108772694,T,TCTGGCAGCA,9
NC_037330.1,NC_032652.1,101902136,108776542,108776550,A,ACAGGGTGT,8
NC_037330.1,NC_032652.1,101902665,108777079,108777084,t,ttaaag,5
NC_037330.1,NC_032652.1,101906817,108781236,108781240,c,ctctt,4
NC_037330.1,NC_032652.1,101915321,108789903,108789905,C,CCT,2
NC_037330.1,NC_032652.1,101946512,108821585,108821603,t,tagatagatagatagatag,18
NC_037330.1,NC_032652.1,101953203,108828290,108828292,g,gaa,2
NC_037330.1,NC_032652.1,101957801,108832890,108832892,T,TAK,2
NC_037330.1,NC_032652.1,101959551,108834639,108834640,A,AG,1
NC_037330.1,NC_032652.1,101963839,108838977,108838978,T,TG,1
NC_037330.1,NC_032652.1,101987209,108861867,108861868,c,ca,1
NC_037330.1,NC_032652.1,102098949,108973835,108973836,A,AG,1
NC_037330.1,NC_032652.1,102115689,108990571,108990572,C,CT,1
NC_037330.1,NC_032652.1,102115760,108990643,108990644,G,GT,1
NC_037330.1,NC_032652.1,102134055,109008725,109008726,A,AG,1
NC_037330.1,NC_032652.1,102144571,109019242,109019243,t,tc,1
NC_037330.1,NC_032652.1,102154092,109028764,109028765,T,TY,1
NC_037330.1,NC_032652.1,102163420,109038096,109038098,c,cta,2
NC_037330.1,NC_032652.1,102191842,109106673,109106675,C,CTG,2
NC_037330.1,NC_032652.1,102522115,109440619,109440622,t,ttaa,3
NC_037330.1,NC_032652.1,102544601,109463117,109463118,A,AG,1
NC_037330.1,NC_032652.1,102650225,109567417,109567418,G,GA,1
NC_037330.1,NC_032652.1,102650228,109567421,109567423,C,CTT,2
NC_037330.1,NC_032652.1,102657040,109574235,109574236,G,GS,1
NC_037330.1,NC_032652.1,102684623,109601820,109601837,C,CAGCCTAATGAGGCTTTA,17
NC_037330.1,NC_032652.1,102721112,109638324,109638327,t,tagc,3
NC_037330.1,NC_032652.1,102751026,109668249,109668250,g,gc,1
NC_037330.1,NC_032652.1,102751040,109668264,109668265,c,cg,1
NC_037330.1,NC_032652.1,102864050,109789773,109789774,g,gt,1
NC_037330.1,NC_032652.1,102865976,109791704,109791710,A,ACTCCGT,6
NC_037330.1,NC_032652.1,102874136,109799865,109799866,a,at,1
NC_037330.1,NC_032652.1,102874959,109800687,109800688,A,AG,1
NC_037330.1,NC_032652.1,102886930,109818527,109818531,t,tttta,4
NC_037330.1,NC_032652.1,102907189,109838795,109838801,c,ctatact,6
NC_037330.1,NC_032652.1,102942298,109873924,109873926,c,cta,2
NC_037330.1,NC_032652.1,102942409,109874037,109874046,a,acagttttgg,9
NC_037330.1,NC_032652.1,103025902,109953533,109953537,c,caata,4
NC_037330.1,NC_032652.1,103026310,109953945,109953946,A,AC,1
NC_037330.1,NC_032652.1,103031049,109958281,109958284,c,ccaa,3
NC_037330.1,NC_032652.1,103072460,109999446,109999447,t,tc,1
NC_037330.1,NC_032652.1,103147437,110074241,110074242,a,ac,1
NC_037330.1,NC_032652.1,103349319,110259618,110259619,A,AT,1
NC_037330.1,NC_032652.1,103427492,110339220,110339221,T,TG,1
NC_037330.1,NC_032652.1,103432106,110372298,110372299,g,gc,1
NC_037330.1,NC_032652.1,103516671,110456871,110456872,C,CA,1
NC_037330.1,NC_032652.1,103599175,110539680,110539682,c,ctt,2
NC_037330.1,NC_032652.1,103748338,110686297,110686298,t,tc,1
NC_037330.1,NC_032652.1,103757835,110695794,110695796,c,cca,2
NC_037330.1,NC_032652.1,103768279,110706243,110706254,G,GTAGTAAAATAA,11
NC_037330.1,NC_032652.1,103784050,110722025,110722026,C,CM,1
NC_037330.1,NC_032652.1,103786027,110724003,110724004,C,CM,1
NC_037330.1,NC_032652.1,103787018,110724995,110724999,t,taatc,4
NC_037330.1,NC_032652.1,103809037,110746807,110746825,t,tNNNNNNNNNNNNNNNNNN,18
NC_037330.1,NC_032652.1,103835982,110777141,110777142,g,gt,1
NC_037330.1,NC_032652.1,103878790,110819950,110819971,g,gaagaaggggacaacagaggat,21
NC_037330.1,NC_032652.1,103991500,110933781,110933782,T,TG,1
NC_037330.1,NC_032652.1,104014642,110956918,110956919,C,CT,1
NC_037330.1,NC_032652.1,104031622,110973900,110973901,A,AT,1
NC_037330.1,NC_032652.1,104140456,111082616,111082617,g,ga,1
NC_037330.1,NC_032652.1,104157119,111099284,111099285,g,ga,1
NC_037330.1,NC_032652.1,104157314,111099480,111099481,T,TA,1
NC_037330.1,NC_032652.1,104183908,111126068,111126069,c,ct,1
NC_037330.1,NC_032652.1,104190612,111132770,111132771,T,TA,1
NC_037330.1,NC_032652.1,104221268,111163435,111163436,a,ag,1
NC_037330.1,NC_032652.1,104241147,111185655,111185659,G,GAAGT,4
NC_037330.1,NC_032652.1,104245516,111190028,111190029,g,gc,1
NC_037330.1,NC_032652.1,104245621,111190134,111190135,t,tc,1
NC_037330.1,NC_032652.1,104253775,111198295,111198296,G,GA,1
NC_037330.1,NC_032652.1,104300493,111245232,111245233,T,TA,1
NC_037330.1,NC_032652.1,104329353,111274139,111274140,c,cg,1
NC_037330.1,NC_032652.1,104345868,111290654,111290655,T,TG,1
NC_037330.1,NC_032652.1,104352372,111297167,111297168,T,TA,1
NC_037330.1,NC_032652.1,104356013,111300813,111300815,c,ctt,2
NC_037330.1,NC_032652.1,104403231,111347610,111347611,G,GR,1
NC_037330.1,NC_032652.1,104435894,111380288,111380289,g,gt,1
NC_037330.1,NC_032652.1,104445039,111389432,111389441,A,AAATGTGATC,9
NC_037330.1,NC_032652.1,104481969,111426454,111426455,t,tW,1
NC_037330.1,NC_032652.1,104526293,111470780,111470781,g,gt,1
NC_037330.1,NC_032652.1,104542324,111486813,111486814,A,AC,1
NC_037330.1,NC_032652.1,104599610,111542196,111542197,A,AC,1
NC_037330.1,NC_032652.1,104604256,111546843,111546846,A,AGAT,3
NC_037330.1,NC_032652.1,104610358,111552951,111552952,T,TY,1
NC_037330.1,NC_032652.1,104785856,111762136,111762137,c,ct,1
NC_037330.1,NC_032652.1,104785899,111762180,111762181,c,ca,1
NC_037330.1,NC_032652.1,104912054,111886224,111886225,G,GC,1
NC_037330.1,NC_032652.1,104949653,111923716,111923717,G,GA,1
NC_037330.1,NC_032652.1,104985562,111959752,111959753,A,AM,1
NC_037330.1,NC_032652.1,105347278,112319991,112319992,a,aR,1
NC_037330.1,NC_032652.1,105409355,112387859,112387862,G,GAGA,3
NC_037330.1,NC_032652.1,105558059,112534918,112534919,a,at,1
NC_037330.1,NC_032652.1,105577184,112554000,112554001,c,ca,1
NC_037330.1,NC_032652.1,105577197,112554014,112554016,a,att,2
NC_037330.1,NC_032652.1,105586201,112647848,112647849,A,AG,1
NC_037330.1,NC_032652.1,105587458,112649100,112649101,g,gt,1
NC_037330.1,NC_032652.1,105590276,112651816,112651817,T,TC,1
NC_037330.1,NC_032652.1,105600819,112662894,112662914,g,gtacatcaaggctatatatta,20
NC_037330.1,NC_032652.1,105606260,112668354,112668355,A,AG,1
NC_037330.1,NC_032652.1,105622520,112684640,112684641,g,gt,1
NC_037330.1,NC_032652.1,105629971,112692091,112692092,g,ga,1
NC_037330.1,NC_032652.1,105643114,112705247,112705251,c,ctggg,4
NC_037330.1,NC_032652.1,105685685,112747832,112747833,A,AT,1
NC_037330.1,NC_032652.1,105685933,112748081,112748082,T,TY,1
NC_037330.1,NC_032652.1,105756981,112852488,112852489,C,CN,1
NC_037330.1,NC_032652.1,105760877,112855890,112855891,T,TG,1
NC_037330.1,NC_032652.1,105784668,112879687,112879688,T,TY,1
NC_037330.1,NC_032652.1,105801437,112895607,112895608,G,GS,1
NC_037330.1,NC_032652.1,105804448,112898617,112898619,C,CTG,2
NC_037330.1,NC_032652.1,105804991,112899162,112899163,C,CY,1
NC_037330.1,NC_032652.1,105840475,112934378,112934379,A,AC,1
NC_037330.1,NC_032652.1,105866099,112960006,112960008,G,GCT,2
NC_037330.1,NC_032652.1,105866103,112960012,112960027,A,ACCTGATCTCGTAATC,15
NC_037330.1,NC_032652.1,105870230,112964151,112964153,C,CAT,2
NC_037330.1,NC_032652.1,105878602,112972538,112972541,t,tagc,3
NC_037330.1,NC_032652.1,105880197,112974192,112974193,c,ca,1
NC_037330.1,NC_032652.1,105889505,112983498,112983500,C,CCT,2
NC_037330.1,NC_032652.1,105907080,113001101,113001102,C,CA,1
NC_037330.1,NC_032652.1,105938650,113033463,113033480,T,TATTTACAAAAGGATGCC,17
NC_037330.1,NC_032652.1,105952934,113047779,113047780,g,gt,1
NC_037330.1,NC_032652.1,106000578,113095448,113095449,A,AG,1
NC_037330.1,NC_032652.1,106019051,113113921,113113924,a,aatt,3
NC_037330.1,NC_032652.1,106028664,113123532,113123534,g,gcc,2
NC_037330.1,NC_032652.1,106170422,113271811,113271812,A,AR,1
NC_037330.1,NC_032652.1,106176362,113277761,113277765,g,gaaaa,4
NC_037330.1,NC_032652.1,106196666,113298077,113298079,A,AAT,2
NC_037330.1,NC_032652.1,106237140,113338573,113338574,A,AG,1
NC_037330.1,NC_032652.1,106320800,113386996,113386997,T,TG,1
NC_037330.1,NC_032652.1,106359632,113429984,113429985,g,gt,1
NC_037330.1,NC_032652.1,106383785,113454133,113454134,G,GS,1
NC_037330.1,NC_032652.1,106426181,113496546,113496547,C,CS,1
NC_037330.1,NC_032652.1,106579971,113607635,113607641,A,AGACAAC,6
NC_037330.1,NC_032652.1,106590422,113618050,113618052,C,CCM,2
NC_037330.1,NC_032652.1,106596077,113623716,113623718,A,AGC,2
NC_037330.1,NC_032652.1,106630520,113658231,113658232,C,CT,1
NC_037330.1,NC_032652.1,106633114,113660826,113660827,g,ga,1
NC_037330.1,NC_032652.1,106635003,113662717,113662719,A,AAC,2
NC_037330.1,NC_032652.1,106718884,113746615,113746616,A,AC,1
NC_037330.1,NC_032652.1,106936049,113982203,113982204,C,CT,1
NC_037330.1,NC_032652.1,106958107,114004201,114004202,t,ta,1
NC_037330.1,NC_032652.1,106998462,114046320,114046322,a,aac,2
NC_037330.1,NC_032652.1,107022052,114071169,114071178,t,tctcttgtcc,9
NC_037330.1,NC_032652.1,107025569,114075621,114075622,c,ca,1
NC_037330.1,NC_032652.1,107025574,114075627,114075628,t,ta,1
NC_037330.1,NC_032652.1,107034253,114084303,114084304,G,GT,1
NC_037330.1,NC_032652.1,107151858,114200947,114200948,C,CA,1
NC_037330.1,NC_032652.1,107153456,114202546,114202547,T,TA,1
NC_037330.1,NC_032652.1,107211471,114260535,114260536,T,TY,1
NC_037330.1,NC_032652.1,107237549,114285742,114285743,c,ct,1
NC_037330.1,NC_032652.1,107268541,114316732,114316733,c,ca,1
NC_037330.1,NC_032652.1,107331734,114380592,114380607,C,CTGGCTTGACCTCGAT,15
NC_037330.1,NC_032652.1,107380638,114429504,114429510,t,tctgctg,6
NC_037330.1,NC_032652.1,107501570,114550036,114550037,A,AT,1
NC_037330.1,NC_032652.1,107515291,114563795,114563799,g,gcctt,4
NC_037330.1,NC_032652.1,107516113,114564635,114564636,C,CG,1
NC_037330.1,NC_032652.1,107517761,114566284,114566286,g,gtt,2
NC_037330.1,NC_032652.1,107523564,114572090,114572091,t,tc,1
NC_037330.1,NC_032652.1,107524584,114573111,114573112,g,gc,1
NC_037330.1,NC_032652.1,107532551,114581086,114581108,g,gggtcgaaaagtgccagacatga,22
NC_037330.1,NC_032652.1,107536133,114584688,114584689,G,GR,1
NC_037330.1,NC_032652.1,107539429,114587985,114587986,T,TK,1
NC_037330.1,NC_032652.1,107542772,114591327,114591329,A,ACT,2
NC_037330.1,NC_032652.1,107553606,114607359,114607360,A,AT,1
NC_037330.1,NC_032652.1,107591679,114645442,114645443,A,AW,1
NC_037330.1,NC_032652.1,107713408,114780136,114780137,C,CN,1
NC_037330.1,NC_032652.1,107713449,114780178,114780179,T,TA,1
NC_037330.1,NC_032652.1,107739706,114806437,114806438,T,TA,1
NC_037330.1,NC_032652.1,107923348,115099920,115099921,G,GS,1
NC_037330.1,NC_032652.1,108121269,115297928,115297929,T,TA,1
NC_037330.1,NC_032652.1,108150417,115327161,115327162,C,CG,1
NC_037330.1,NC_032652.1,108231940,115408684,115408685,a,ac,1
NC_037330.1,NC_032652.1,108349047,115545222,115545229,c,cggttNNN,7
NC_037330.1,NC_032652.1,108354904,115551088,115551089,G,GA,1
NC_037330.1,NC_032652.1,108508486,115702871,115702872,T,TA,1
NC_037330.1,NC_032652.1,108730128,115924651,115924653,T,TTA,2
NC_037330.1,NC_032652.1,108786890,115981415,115981416,C,CG,1
NC_037330.1,NC_032652.1,109370452,116583036,116583037,G,GA,1
NC_037330.1,NC_032652.1,109384863,116597454,116597456,g,gtc,2
NC_037330.1,NC_032652.1,109386239,116598831,116598880,a,atNNNNNNNNNNNNNNNNNNNNNNNNNNNNNNNNNNNNACTGAAGTCAAc,49
NC_037330.1,NC_032652.1,109393931,116606574,116606575,A,AR,1
NC_037330.1,NC_032652.1,109417015,116629666,116629668,C,CAG,2
NC_037330.1,NC_032652.1,109433858,116646514,116646515,C,CM,1
NC_037330.1,NC_032652.1,109434160,116646817,116646818,C,CA,1
NC_037330.1,NC_032652.1,109434198,116646855,116646856,G,GA,1
NC_037330.1,NC_032652.1,109485277,116699631,116699632,T,TY,1
NC_037330.1,NC_032652.1,109488500,116702865,116702872,T,TACTACTA,7
NC_037330.1,NC_032652.1,109489366,116703738,116703739,g,gc,1
NC_037330.1,NC_032652.1,109494798,116709174,116709175,G,GA,1
NC_037330.1,NC_032652.1,109497718,116712096,116712097,G,GC,1
NC_037330.1,NC_032652.1,109497740,116712119,116712120,C,CT,1
NC_037330.1,NC_032652.1,109501511,116715891,116715892,G,GC,1
NC_037330.1,NC_032652.1,109525436,116739841,116739842,C,CG,1
NC_037330.1,NC_032652.1,109552069,116766476,116766477,T,TA,1
NC_037330.1,NC_032652.1,109552072,116766480,116766484,T,TTTTA,4
NC_037330.1,NC_032652.1,109566526,116780937,116780956,A,ACAGAAAGGGGAAAATGARR,19
NC_037330.1,NC_032652.1,109576172,116790602,116790603,t,tg,1
NC_037330.1,NC_032652.1,109608364,116822797,116822798,t,ta,1
NC_037330.1,NC_032652.1,109671064,116885288,116885289,G,GS,1
NC_037330.1,NC_032652.1,109703314,116918290,116918293,T,TAAG,3
NC_037330.1,NC_032652.1,109728194,116943275,116943351,t,tgtgtgtgtgtgtgcgtgcgcctggagaattctatggaaagaggtgtgtgtgtgtgtgtgtgtgtgtgtgtgtgtgc,76
NC_037330.1,NC_032652.1,109756069,116971241,116971242,G,GR,1
NC_037330.1,NC_032652.1,109987023,117201345,117201346,t,tg,1
NC_037330.1,NC_032652.1,110109979,117324329,117324331,T,TTG,2
NC_037330.1,NC_032652.1,110133600,117345646,117345654,C,CTCAATGTG,8
NC_037330.1,NC_032652.1,110144453,117356506,117356507,g,ga,1
NC_037330.1,NC_032652.1,110216015,117428687,117428688,G,GT,1
NC_037330.1,NC_032652.1,110325778,117538543,117538545,T,TTC,2
NC_037330.1,NC_032652.1,110328062,117540829,117540831,A,AAM,2
NC_037330.1,NC_032652.1,110332462,117545231,117545235,A,ACTAT,4
NC_037330.1,NC_032652.1,110334671,117547444,117547450,G,GCATCGA,6
NC_037330.1,NC_032652.1,110429755,117643083,117643084,a,ag,1
NC_037330.1,NC_032652.1,110429822,117643151,117643152,a,ag,1
NC_037330.1,NC_032652.1,110430391,117643721,117643725,t,tctNN,4
NC_037330.1,NC_032652.1,110438993,117651961,117651962,c,ca,1
NC_037330.1,NC_032652.1,110563550,117817302,117817308,T,TGTAGAG,6
NC_037330.1,NC_032652.1,110572335,117826092,117826094,C,CAG,2
NC_037330.1,NC_032652.1,110574586,117828605,117828607,c,ctg,2
NC_037330.1,NC_032652.1,110587238,117841265,117841282,A,AAGGCAAAAAGCCAGGCT,17
NC_037330.1,NC_032652.1,110634178,117888433,117888443,A,AACAATAAGAG,10
NC_037330.1,NC_032652.1,110635234,117889501,117889502,A,AC,1
NC_037330.1,NC_032652.1,110638739,117893006,117893010,a,ataac,4
NC_037330.1,NC_032652.1,110643951,117898275,117898276,a,ac,1
NC_037330.1,NC_032652.1,110644024,117898349,117898350,g,ga,1
NC_037330.1,NC_032652.1,110646729,117901058,117901060,c,cta,2
NC_037330.1,NC_032652.1,110884385,118142017,118142018,g,gc,1
NC_037330.1,NC_032652.1,110922438,118180563,118180565,T,TCW,2
NC_037330.1,NC_032652.1,110926863,118184990,118184994,t,tgtgK,4
NC_037330.1,NC_032652.1,110938553,118196627,118196628,T,TA,1
NC_037330.1,NC_032652.1,110969022,118224923,118224925,t,tMC,2
NC_037330.1,NC_032652.1,110982610,118238513,118238514,G,GR,1
NC_037330.1,NC_032652.1,110984452,118240356,118240357,g,gt,1
NC_037330.1,NC_032652.1,111048857,118303726,118303727,T,TY,1
NC_037330.1,NC_032652.1,111054667,118309537,118309538,g,gc,1
NC_037330.1,NC_032652.1,111055513,118310382,118310383,g,ga,1
NC_037330.1,NC_032652.1,111055939,118310812,118310814,a,act,2
NC_037330.1,NC_032652.1,111057423,118312294,118312295,C,CA,1
NC_037330.1,NC_032652.1,111058652,118313514,118313515,A,AT,1
NC_037330.1,NC_032652.1,111059344,118314207,118314208,A,AT,1
NC_037330.1,NC_032652.1,111059507,118314370,118314371,g,gt,1
NC_037330.1,NC_032652.1,111063662,118318547,118318552,g,gggggT,5
NC_037330.1,NC_032652.1,111068137,118323029,118323035,G,GATGAGA,6
NC_037330.1,NC_032652.1,111075209,118330076,118330077,a,ag,1
NC_037330.1,NC_032652.1,111077529,118332403,118332406,G,GAGA,3
NC_037330.1,NC_032652.1,111077965,118332842,118332843,G,GS,1
NC_037330.1,NC_032652.1,111091109,118345982,118345983,t,ta,1
NC_037330.1,NC_032652.1,111094227,118349120,118349121,c,ct,1
NC_037330.1,NC_032652.1,111113971,118368691,118368692,C,CG,1
NC_037330.1,NC_032652.1,111132844,118387817,118387818,T,TK,1
NC_037330.1,NC_032652.1,111148835,118403833,118403835,a,aag,2
NC_037330.1,NC_032652.1,111187490,118442505,118442506,T,TY,1
NC_037330.1,NC_032652.1,111252214,118507492,118507493,G,GS,1
NC_037330.1,NC_032652.1,111253373,118508651,118508652,g,ga,1
NC_037330.1,NC_032652.1,111271893,118548159,118548160,a,ac,1
NC_037330.1,NC_032652.1,111283746,118560005,118560006,g,ga,1
NC_037330.1,NC_032652.1,111311011,118587274,118587276,T,TCC,2
NC_037330.1,NC_032652.1,111463451,118738918,118738932,A,ANNNNNNNNNNNNNN,14
NC_037330.1,NC_032652.1,111466177,118741649,118741650,g,gt,1
NC_037330.1,NC_032652.1,111466429,118741901,118741902,c,cg,1
NC_037330.1,NC_032652.1,111466522,118741995,118742003,t,ttttttttc,8
NC_037330.1,NC_032652.1,111493112,118768594,118768595,c,ct,1
NC_037330.1,NC_032652.1,111567591,118843084,118843086,G,GGA,2
NC_037330.1,NC_032652.1,111571495,118846983,118846984,A,AT,1
NC_037330.1,NC_032652.1,111572169,118847658,118847659,G,GC,1
NC_037330.1,NC_032652.1,111580164,118855658,118855661,C,CATG,3
NC_037330.1,NC_032652.1,111603576,118879517,118879519,G,GGS,2
NC_037330.1,NC_032652.1,111626551,118902501,118902504,G,GGCA,3
NC_037330.1,NC_032652.1,111654247,118930169,118930170,A,AC,1
NC_037330.1,NC_032652.1,111656338,118932262,118932263,T,TA,1
NC_037330.1,NC_032652.1,111681515,118957191,118957192,A,AT,1
NC_037330.1,NC_032652.1,111720151,118995454,118995456,A,ACC,2
NC_037330.1,NC_032652.1,111726675,119001979,119001980,c,ca,1
NC_037330.1,NC_032652.1,111747507,119022843,119022844,A,AT,1
NC_037330.1,NC_032652.1,111748609,119023946,119023967,A,AAGGCAGGGCGGCCTCACCTGG,21
NC_037330.1,NC_032652.1,111752165,119027524,119027525,G,GA,1
NC_037330.1,NC_032652.1,112114257,119389572,119389573,a,ac,1
NC_037330.1,NC_032652.1,112447266,119723030,119723031,A,AR,1
NC_037330.1,NC_032652.1,112462186,119737952,119737953,T,TA,1
NC_037330.1,NC_032652.1,112796708,120037434,120037435,C,CY,1
NC_037330.1,NC_032652.1,112811127,120051857,120051858,t,ta,1
NC_037330.1,NC_032652.1,112829236,120070070,120070072,c,ccg,2
NC_037330.1,NC_032652.1,112851011,120091846,120091852,G,GACTCCA,6
NC_037330.1,NC_032652.1,112851017,120091858,120091867,A,AAATATCCCC,9
NC_037330.1,NC_032652.1,112924182,120222577,120222578,C,CA,1
NC_037330.1,NC_032652.1,112948370,120246146,120246147,G,GA,1
NC_037330.1,NC_032652.1,113074077,120371623,120371624,g,gt,1
NC_037330.1,NC_032652.1,113098712,120396264,120396265,C,CY,1
NC_037330.1,NC_032652.1,113294455,120591175,120591176,A,AG,1
NC_037330.1,NC_032652.1,113329298,120626023,120626024,T,TC,1
NC_037330.1,NC_032652.1,113330454,120627174,120627175,G,GA,1
NC_037330.1,NC_032652.1,113405726,120702546,120702547,t,tc,1
NC_037330.1,NC_032652.1,113411291,120708112,120708113,C,CT,1
NC_037330.1,NC_032652.1,113504000,120800857,120800859,t,ttc,2
NC_037330.1,NC_032652.1,113614850,120911737,120911738,a,ag,1
NC_037330.1,NC_032652.1,113632060,120928964,120928966,G,GGC,2
NC_037330.1,NC_032652.1,113653694,120950603,120950605,t,tta,2
NC_037330.1,NC_032652.1,113668654,120965565,120965577,C,CCTCTGGGGACAT,12
NC_037330.1,NC_032652.1,113731304,121028239,121028240,G,GR,1
NC_037330.1,NC_032652.1,113737614,121034575,121034577,c,ctt,2
NC_037330.1,NC_032652.1,113747799,121044757,121044758,G,GA,1
NC_037330.1,NC_032652.1,113761835,121058796,121058797,G,GT,1
NC_037330.1,NC_032652.1,113782645,121079584,121079585,C,CT,1
NC_037330.1,NC_032652.1,113794027,121090942,121090943,C,CT,1
NC_037330.1,NC_032652.1,113797167,121094084,121094085,g,gc,1
NC_037330.1,NC_032652.1,113804013,121100919,121100920,a,at,1
NC_037330.1,NC_032652.1,113808699,121105606,121105608,A,AAT,2
NC_037330.1,NC_032652.1,113810868,121107777,121107779,T,TAA,2
NC_037330.1,NC_032652.1,113819489,121116390,121116391,G,GT,1
NC_037330.1,NC_032652.1,113821985,121118835,121118836,t,tc,1
NC_037330.1,NC_032652.1,113830772,121127643,121127644,T,TG,1
NC_037330.1,NC_032652.1,113830864,121127736,121127740,A,AMCAG,4
NC_037330.1,NC_032652.1,113837851,121134720,121134721,t,ta,1
NC_037330.1,NC_032652.1,113839512,121136383,121136385,t,tta,2
NC_037330.1,NC_032652.1,113843184,121140055,121140056,c,ct,1
NC_037330.1,NC_032652.1,113843377,121140249,121140250,t,tg,1
NC_037330.1,NC_032652.1,113847291,121142284,121142285,g,ga,1
NC_037330.1,NC_032652.1,113853774,121148723,121148724,T,TA,1
NC_037330.1,NC_032652.1,113922475,121217422,121217423,T,TK,1
NC_037330.1,NC_032652.1,113975953,121278610,121278611,C,CM,1
NC_037330.1,NC_032652.1,113977048,121279707,121279708,T,TA,1
NC_037330.1,NC_032652.1,113982911,121285596,121285598,g,gta,2
NC_037330.1,NC_032652.1,113983659,121286346,121286351,T,TGTTTG,5
NC_037330.1,NC_032652.1,114038802,121341491,121341492,t,ta,1
NC_037330.1,NC_032652.1,114054784,121358046,121358047,c,ct,1
NC_037330.1,NC_032652.1,114054796,121358059,121358061,t,tcc,2
NC_037330.1,NC_032652.1,114090170,121393517,121393518,a,at,1
NC_037330.1,NC_032652.1,114090173,121393521,121393522,g,gt,1
NC_037330.1,NC_032652.1,114110975,121415546,121415547,T,TY,1
NC_037330.1,NC_032652.1,114113553,121418153,121418155,A,AAC,2
NC_037330.1,NC_032652.1,114126355,121430992,121430993,c,ca,1
NC_037330.1,NC_032652.1,114131285,121435924,121435928,c,ctctg,4
NC_037330.1,NC_032652.1,114143910,121448539,121448541,a,aat,2
NC_037330.1,NC_032652.1,114157849,121465456,121465457,a,at,1
NC_037330.1,NC_032652.1,114158043,121465651,121465652,t,tc,1
NC_037330.1,NC_032652.1,114159167,121466776,121466777,A,AR,1
NC_037330.1,NC_032652.1,114159262,121466873,121466882,t,tcataggaag,9
NC_037330.1,NC_032652.1,114164921,121472542,121472545,a,aagc,3
NC_037330.1,NC_032652.1,114165480,121473105,121473106,t,tg,1
NC_037330.1,NC_032652.1,114170547,121478172,121478175,g,gaga,3
NC_037330.1,NC_032652.1,114206617,121526793,121526797,T,TGTTA,4
NC_037330.1,NC_032652.1,114269070,121598529,121598530,a,at,1
NC_037330.1,NC_032652.1,114332079,121661543,121661544,t,tc,1
NC_037330.1,NC_032652.1,114348503,121678086,121678087,a,ag,1
NC_037330.1,NC_032652.1,114348980,121678565,121678566,t,ta,1
NC_037330.1,NC_032652.1,114356496,121686082,121686083,t,tg,1
NC_037330.1,NC_032652.1,114366596,121696183,121696184,t,tc,1
NC_037330.1,NC_032652.1,114366675,121696263,121696266,t,tctc,3
NC_037330.1,NC_032652.1,114525775,121856390,121856392,t,tta,2
NC_037330.1,NC_032652.1,114540752,121871369,121871370,c,cg,1
NC_037330.1,NC_032652.1,114560281,121890900,121890903,T,TAGA,3
NC_037330.1,NC_032652.1,114575084,121905710,121905711,a,aR,1
NC_037330.1,NC_032652.1,114647968,122058452,122058453,G,GA,1
NC_037330.1,NC_032652.1,114648712,122059185,122059186,t,tg,1
NC_037330.1,NC_032652.1,114667034,122077512,122077513,g,ga,1
NC_037330.1,NC_032652.1,114667034,121987388,121987389,g,ga,1
NC_037330.1,NC_032652.1,114667617,122078095,122078096,g,gc,1
NC_037330.1,NC_032652.1,114667617,121987971,121987972,g,gc,1
NC_037330.1,NC_032652.1,114673518,121993873,121993874,G,GA,1
NC_037330.1,NC_032652.1,114673755,121994110,121994111,A,AC,1
NC_037330.1,NC_032652.1,114685387,122005576,122005740,A,AGATTGTCTTCAGGCCATTATCATAGGATAGGGACATTTTAATTGTCAACAGAATTTTCTGTCTATTCTTCTACAAAATTATGGGGGCCACATTGCTGCTCATTTGTATCTGAATGACTGAGCCATCACTGTGTCGARGCTTTAATGTTGTGATTATCTCCTGGT,164
NC_037330.1,NC_032652.1,114686867,122007220,122007221,c,ct,1
NC_037330.1,NC_032652.1,114697731,122018084,122018085,a,at,1
NC_037330.1,NC_032652.1,114702332,122022687,122022688,C,CG,1
NC_037330.1,NC_032652.1,114705219,122025642,122025644,a,att,2
NC_037330.1,NC_032652.1,114706116,122026540,122026541,C,CA,1
NC_037330.1,NC_032652.1,114706485,122026910,122026911,C,CT,1
NC_037330.1,NC_032652.1,114709822,122030243,122030244,T,TK,1
NC_037330.1,NC_032652.1,114713893,122034314,122034315,A,AR,1
NC_037330.1,NC_032652.1,114714795,122035220,122035222,a,atg,2
NC_037330.1,NC_032652.1,114715542,122035955,122035956,G,GC,1
NC_037330.1,NC_032652.1,114715600,122036014,122036015,g,gR,1
NC_037330.1,NC_032652.1,114731106,122051503,122051504,A,AC,1
NC_037330.1,NC_032652.1,114835404,122210972,122210973,A,AW,1
NC_037330.1,NC_032652.1,114837246,122212832,122212833,A,AC,1
NC_037330.1,NC_032652.1,114889476,122264733,122264736,A,AAGG,3
NC_037330.1,NC_032652.1,114935503,122313124,122313125,c,ct,1
NC_037330.1,NC_032652.1,114943307,122320929,122320931,A,AAG,2
NC_037330.1,NC_032652.1,114952281,122329906,122329907,A,AG,1
NC_037330.1,NC_032652.1,114973936,122351565,122351566,G,GA,1
NC_037330.1,NC_032652.1,114996755,122374390,122374391,G,GA,1
NC_037330.1,NC_032652.1,115000755,122378390,122378391,C,CT,1
NC_037330.1,NC_032652.1,115001821,122379457,122379458,A,AR,1
NC_037330.1,NC_032652.1,115002711,122380510,122380511,C,CG,1
NC_037330.1,NC_032652.1,115023134,122400937,122400938,T,TR,1
NC_037330.1,NC_032652.1,115024060,122401864,122401865,A,AG,1
NC_037330.1,NC_032652.1,115119648,122503342,122503344,C,CTY,2
NC_037330.1,NC_032652.1,115263549,122740094,122740095,G,GA,1
NC_037330.1,NC_032652.1,115299361,122777722,122777724,a,att,2
NC_037330.1,NC_032652.1,115305090,122783345,122783350,a,actgat,5
NC_037330.1,NC_032652.1,115306579,122784838,122784839,G,GT,1
NC_037330.1,NC_032652.1,115319241,122797584,122797586,A,ASM,2
NC_037330.1,NC_032652.1,115408620,122887027,122887030,C,CGTT,3
NC_037330.1,NC_032652.1,115416943,122895356,122895357,A,AT,1
NC_037330.1,NC_032652.1,115479699,122957878,122957879,T,TA,1
NC_037330.1,NC_032652.1,115506798,122984982,122984983,T,TC,1
NC_037330.1,NC_032652.1,115544674,123022887,123022900,t,tttttttgtttttW,13
NC_037330.1,NC_032652.1,115569897,123048563,123048579,g,ggcaccaGTCGGAACGA,16
NC_037330.1,NC_032652.1,115610824,123089328,123089329,c,cg,1
NC_037330.1,NC_032652.1,115610826,123089331,123089333,g,gat,2
NC_037330.1,NC_032652.1,115631321,123108473,123108474,t,tc,1
NC_037330.1,NC_032652.1,115645790,123122704,123122705,G,GR,1
NC_037330.1,NC_032652.1,115758566,123235324,123235325,A,AG,1
NC_037330.1,NC_032652.1,115760198,123236960,123236962,c,cca,2
NC_037330.1,NC_032652.1,115799240,123276190,123276192,c,cgt,2
NC_037330.1,NC_032652.1,115800813,123277766,123277767,T,TA,1
NC_037330.1,NC_032652.1,115814738,123291693,123291694,G,GY,1
NC_037330.1,NC_032652.1,115817256,123294733,123294734,C,CG,1
NC_037330.1,NC_032652.1,115836836,123314184,123314185,c,ct,1
NC_037330.1,NC_032652.1,115839588,123319961,123319962,t,tc,1
NC_037330.1,NC_032652.1,115839597,123319971,123319972,t,ta,1
NC_037330.1,NC_032652.1,115868740,123349188,123349189,T,TA,1
NC_037330.1,NC_032652.1,115872646,123353321,123353322,a,at,1
NC_037330.1,NC_032652.1,115903158,123408281,123408283,G,GGA,2
NC_037330.1,NC_032652.1,115971025,123464975,123464976,t,ta,1
NC_037330.1,NC_032652.1,115975525,123469478,123469483,A,ACTCGT,5
NC_037330.1,NC_032652.1,115992305,123486282,123486283,t,tN,1
NC_037330.1,NC_032652.1,115999833,123493810,123493811,A,AG,1
NC_037330.1,NC_032652.1,116003603,123497581,123497582,c,ca,1
NC_037330.1,NC_032652.1,116003610,123497589,123497590,a,ac,1
NC_037330.1,NC_032652.1,116020662,123514659,123514660,A,AR,1
NC_037330.1,NC_032652.1,116023027,123516953,123516954,C,CT,1
NC_037330.1,NC_032652.1,116027008,123520936,123520937,a,ac,1
NC_037330.1,NC_032652.1,116034425,123528355,123528356,C,CT,1
NC_037330.1,NC_032652.1,116041194,123535127,123535128,A,AG,1
NC_037330.1,NC_032652.1,116074731,123568669,123568670,G,GA,1
NC_037330.1,NC_032652.1,116105107,123598937,123598939,t,tNN,2
NC_037330.1,NC_032652.1,116151049,123644877,123644878,a,at,1
NC_037330.1,NC_032652.1,116160553,123654381,123654382,C,CT,1
NC_037330.1,NC_032652.1,116163542,123657375,123657377,t,ttg,2
NC_037330.1,NC_032652.1,116169359,123663219,123663220,t,tg,1
NC_037330.1,NC_032652.1,116170317,123664185,123664186,g,ga,1
NC_037330.1,NC_032652.1,116170791,123664661,123664662,c,ct,1
NC_037330.1,NC_032652.1,116180810,123674683,123674684,g,gt,1
NC_037330.1,NC_032652.1,116186231,123680054,123680056,T,TGA,2
NC_037330.1,NC_032652.1,116234268,123728096,123728097,t,ta,1
NC_037330.1,NC_032652.1,116292180,123825863,123825864,g,ga,1
NC_037330.1,NC_032652.1,116303974,123837656,123837657,T,TY,1
NC_037330.1,NC_032652.1,116310795,123844477,123844478,G,GR,1
NC_037330.1,NC_032652.1,116322721,123856404,123856405,a,at,1
NC_037330.1,NC_032652.1,116343779,123877485,123877486,T,TC,1
NC_037330.1,NC_032652.1,116352855,123886564,123886565,C,CY,1
NC_037330.1,NC_032652.1,116393765,123927539,123927540,g,ga,1
NC_037330.1,NC_032652.1,116409433,123943214,123943215,a,ac,1
NC_037330.1,NC_032652.1,116445603,123979389,123979390,T,TC,1
NC_037330.1,NC_032652.1,116447713,123981500,123981501,T,TY,1
NC_037330.1,NC_032652.1,116447733,123981521,123981522,C,CY,1
NC_037330.1,NC_032652.1,116551988,124086256,124086259,a,aaNN,3
NC_037330.1,NC_032652.1,116614471,124149005,124149006,A,AG,1
NC_037330.1,NC_032652.1,116627483,124162009,124162010,t,tY,1
NC_037330.1,NC_032652.1,116741321,124276083,124276085,c,cct,2
NC_037330.1,NC_032652.1,116765710,124300478,124300479,C,CY,1
NC_037330.1,NC_032652.1,116781821,124320559,124320562,c,caca,3
NC_037330.1,NC_032652.1,116795676,124334417,124334419,a,aat,2
NC_037330.1,NC_032652.1,116812103,124350853,124350854,T,TG,1
NC_037330.1,NC_032652.1,116852068,124398301,124398303,C,CAT,2
NC_037330.1,NC_032652.1,116884986,124430552,124430554,c,caa,2
NC_037330.1,NC_032652.1,116905711,124451229,124451230,T,TC,1
NC_037330.1,NC_032652.1,116906264,124451783,124451787,T,TAGTY,4
NC_037330.1,NC_032652.1,116929950,124475189,124475190,T,TC,1
NC_037330.1,NC_032652.1,116933952,124479190,124479191,t,ta,1
NC_037330.1,NC_032652.1,116936619,124481855,124481856,C,CA,1
NC_037330.1,NC_032652.1,117049598,124593713,124593716,A,AAGC,3
NC_037330.1,NC_032652.1,117072447,124622049,124622050,t,tg,1
NC_037330.1,NC_032652.1,117082204,124631812,124631813,T,TC,1
NC_037330.1,NC_032652.1,117125668,124711777,124711778,a,at,1
NC_037330.1,NC_032652.1,117127761,124713869,124713870,G,GA,1
NC_037330.1,NC_032652.1,117154189,124740155,124740156,G,GN,1
NC_037330.1,NC_032652.1,117182260,124766707,124766708,G,GT,1
NC_037330.1,NC_032652.1,117307571,124891619,124891620,C,CG,1
NC_037330.1,NC_032652.1,117314573,124898623,124898626,T,TGAA,3
NC_037330.1,NC_032652.1,117388355,124971194,124971199,t,ttttta,5
NC_037330.1,NC_032652.1,117396042,124978888,124978889,A,AC,1
NC_037330.1,NC_032652.1,117439159,125028862,125028878,T,TCAGGAGGAGGCGGCGG,16
NC_037330.1,NC_032652.1,117440377,125030089,125030090,A,AW,1
NC_037330.1,NC_032652.1,117470263,125059981,125059982,C,CT,1
NC_037330.1,NC_032652.1,117475328,125065047,125065048,A,AR,1
NC_037330.1,NC_032652.1,117485884,125075146,125075149,a,accc,3
NC_037330.1,NC_032652.1,117489391,125078395,125078396,C,CN,1
NC_037330.1,NC_032652.1,117497364,125086565,125086566,C,CY,1
NC_037330.1,NC_032652.1,117562487,125151506,125151507,a,at,1
NC_037330.1,NC_032652.1,117628232,125224025,125224026,C,CA,1
NC_037330.1,NC_032652.1,117628235,125224029,125224030,T,TC,1
NC_037330.1,NC_032652.1,117643786,125243421,125243423,G,GGA,2
NC_037330.1,NC_032652.1,117644493,125244130,125244131,a,ag,1
NC_037330.1,NC_032652.1,117686522,125286193,125286220,G,GAGATGGGGTTGTCATCATTTGAAGATA,27
NC_037330.1,NC_032652.1,117703384,125303342,125303343,C,CY,1
NC_037330.1,NC_032652.1,117769167,125371458,125371459,A,AG,1
NC_037330.1,NC_032652.1,117889353,125408009,125408010,a,ac,1
NC_037330.1,NC_032652.1,117994786,125513583,125513599,a,aatgtgtgtgtgtgtgt,16
NC_037330.1,NC_032652.1,118010508,125529324,125529325,C,CR,1
NC_037330.1,NC_032652.1,118030209,125549029,125549030,A,AC,1
NC_037330.1,NC_032652.1,118121127,125641599,125641606,C,CCAAANNN,7
NC_037330.1,NC_032652.1,118130650,125651132,125651133,t,ta,1
NC_037330.1,NC_032652.1,118134652,125655131,125655138,t,tctctttc,7
NC_037330.1,NC_032652.1,118183285,125703758,125703759,T,TA,1
NC_037330.1,NC_032652.1,118235155,125755341,125755343,A,AAM,2
NC_037330.1,NC_032652.1,118271245,125791323,125791327,c,cgaaA,4
NC_037330.1,NC_032652.1,118285463,125805543,125805544,C,CM,1
NC_037330.1,NC_032652.1,118286869,125806951,125806952,C,CT,1
NC_037330.1,NC_032652.1,119940045,125837251,125837253,a,acg,2
NC_037330.1,NC_032652.1,119982086,125879893,125879894,C,CA,1
NC_037330.1,NC_032652.1,119982964,125880772,125880774,C,CCA,2
NC_037330.1,NC_032652.1,120030672,125928700,125928701,C,CM,1
NC_037330.1,NC_032652.1,120031643,125929673,125929674,T,TG,1
NC_037330.1,NC_032652.1,120031800,125929831,125929833,G,GTC,2
NC_037330.1,NC_032652.1,120075164,125973015,125973018,g,gtcc,3
NC_037330.1,NC_032652.1,120128608,126025468,126025469,G,GA,1
NC_037330.1,NC_032652.1,120274000,126171474,126171480,T,TTCAGTA,6
NC_037330.1,NC_032652.1,120274015,126171495,126171496,C,CT,1
NC_037330.1,NC_032652.1,120274019,126171500,126171507,G,GGCTCGGT,7
NC_037330.1,NC_032652.1,120369712,126266886,126266887,C,CA,1
NC_037330.1,NC_032652.1,120370176,126267351,126267352,A,AG,1
NC_037330.1,NC_032652.1,120374939,126272116,126272117,G,GA,1
NC_037330.1,NC_032652.1,120394570,126291387,126291388,C,CT,1
NC_037330.1,NC_032652.1,120396515,126293333,126293334,A,AC,1
NC_037330.1,NC_032652.1,120489586,126384546,126384547,c,ct,1
NC_037330.1,NC_032652.1,120491510,126386471,126386472,G,GA,1
NC_037330.1,NC_032652.1,120636230,126533260,126533262,A,AAC,2
NC_037330.1,NC_032652.1,120712413,126671176,126671177,C,CA,1
NC_037330.1,NC_032652.1,120728486,126687258,126687268,G,GGCANNNNNNN,10
NC_037330.1,NC_032652.1,120747203,126705565,126705567,C,CYT,2
NC_037330.1,NC_032652.1,120747221,126705585,126705586,T,TG,1
NC_037330.1,NC_032652.1,120758069,126716440,126716442,T,TAA,2
NC_037330.1,NC_032652.1,120774179,126732556,126732557,T,TK,1
NC_037330.1,NC_032652.1,120779080,126737458,126737459,G,GA,1
NC_037330.1,NC_032652.1,120779437,126737816,126737817,g,gt,1
NC_037330.1,NC_032652.1,120799237,126757623,126757625,c,cca,2
NC_037330.1,NC_032652.1,120800322,126758711,126758716,t,ttaaaa,5
NC_037330.1,NC_032652.1,120811312,126769780,126769782,a,aag,2
NC_037330.1,NC_032652.1,120831589,126790008,126790009,g,gc,1
NC_037330.1,NC_032652.1,120943934,126902815,126902816,C,CG,1
