Reference ID,Query ID,Reference POS,Query POS,Query END,REF,ALT,SVLEN
NC_037345.1,NC_032667.1,745017,33237,33239,a,aNN,2
NC_037345.1,NC_032667.1,751444,39664,39665,t,ta,1
NC_037345.1,NC_032667.1,833868,122087,122088,a,ag,1
NC_037345.1,NC_032667.1,834249,122469,122473,c,cagtt,4
NC_037345.1,NC_032667.1,999628,290838,290839,C,CG,1
NC_037345.1,NC_032667.1,1035992,328106,328107,A,AC,1
NC_037345.1,NC_032667.1,1164359,498188,498189,C,CA,1
NC_037345.1,NC_032667.1,1465053,816038,816045,c,cNNNNNNN,7
NC_037345.1,NC_032667.1,1467452,818444,818445,G,GA,1
NC_037345.1,NC_032667.1,1467454,818447,818448,T,TA,1
NC_037345.1,NC_032667.1,1467489,818483,818486,C,CCCT,3
NC_037345.1,NC_032667.1,1482391,833389,833390,G,GA,1
NC_037345.1,NC_032667.1,1715460,1066143,1066144,T,TA,1
NC_037345.1,NC_032667.1,1858724,1209812,1209813,G,GC,1
NC_037345.1,NC_032667.1,1890108,1231268,1231269,T,TY,1
NC_037345.1,NC_032667.1,1926046,1268579,1268582,C,CAGA,3
NC_037345.1,NC_032667.1,1974243,1340701,1340707,t,tttttta,6
NC_037345.1,NC_032667.1,1977531,1344086,1344088,t,tta,2
NC_037345.1,NC_032667.1,2013483,1379554,1379556,T,TTA,2
NC_037345.1,NC_032667.1,2194536,1569277,1569279,c,cat,2
NC_037345.1,NC_032667.1,2298092,1672692,1672704,A,AAGTTCCTTCTCT,12
NC_037345.1,NC_032667.1,2309407,1684026,1684029,T,TCTC,3
NC_037345.1,NC_032667.1,2456883,1831520,1831522,G,GGC,2
NC_037345.1,NC_032667.1,2475461,1855220,1855221,c,ca,1
NC_037345.1,NC_032667.1,2484054,1863814,1863824,a,atacttatttc,10
NC_037345.1,NC_032667.1,2484171,1863941,1863947,t,tatacta,6
NC_037345.1,NC_032667.1,2493269,1873042,1873044,t,tca,2
NC_037345.1,NC_032667.1,2496849,1876625,1876629,t,ttttg,4
NC_037345.1,NC_032667.1,2496913,1876693,1876696,T,TCCA,3
NC_037345.1,NC_032667.1,2498037,1877820,1877821,g,gt,1
NC_037345.1,NC_032667.1,2498449,1878233,1878234,g,gt,1
NC_037345.1,NC_032667.1,2499661,1879447,1879448,t,tg,1
NC_037345.1,NC_032667.1,2499738,1879525,1879528,t,tttc,3
NC_037345.1,NC_032667.1,2500549,1880338,1880339,g,gR,1
NC_037345.1,NC_032667.1,2501382,1881173,1881174,G,GR,1
NC_037345.1,NC_032667.1,2581358,1996717,1996718,A,AM,1
NC_037345.1,NC_032667.1,2625677,2040547,2040549,A,AAT,2
NC_037345.1,NC_032667.1,2626117,2040989,2040990,T,TC,1
NC_037345.1,NC_032667.1,2630526,2045366,2045367,G,GK,1
NC_037345.1,NC_032667.1,2637776,2053399,2053404,A,ACAGGG,5
NC_037345.1,NC_032667.1,2657799,2073418,2073421,G,GGGT,3
NC_037345.1,NC_032667.1,2662100,2077722,2077723,A,AM,1
NC_037345.1,NC_032667.1,2667442,2083064,2083065,T,TA,1
NC_037345.1,NC_032667.1,2681142,2096772,2096773,g,ga,1
NC_037345.1,NC_032667.1,2681157,2096788,2096789,C,CT,1
NC_037345.1,NC_032667.1,2681267,2096898,2096899,a,ac,1
NC_037345.1,NC_032667.1,2692662,2108498,2108499,t,tg,1
NC_037345.1,NC_032667.1,2733713,2149555,2149556,C,CT,1
NC_037345.1,NC_032667.1,2735339,2151183,2151185,T,TAC,2
NC_037345.1,NC_032667.1,2739620,2155467,2155469,C,CCT,2
NC_037345.1,NC_032667.1,2744504,2160358,2160360,A,ATT,2
NC_037345.1,NC_032667.1,2751178,2167030,2167040,c,caaaaaaaaaa,10
NC_037345.1,NC_032667.1,2751410,2167296,2167299,t,taaa,3
NC_037345.1,NC_032667.1,2790137,2206048,2206052,c,cagtt,4
NC_037345.1,NC_032667.1,2803643,2219578,2219580,T,TCC,2
NC_037345.1,NC_032667.1,2805293,2221235,2221236,A,AG,1
NC_037345.1,NC_032667.1,2805371,2221314,2221318,C,CTAGT,4
NC_037345.1,NC_032667.1,2809808,2225755,2225758,G,GAGA,3
NC_037345.1,NC_032667.1,2810317,2226266,2226267,g,gN,1
NC_037345.1,NC_032667.1,2816245,2232194,2232199,T,TTAATA,5
NC_037345.1,NC_032667.1,2816565,2232522,2232524,t,tca,2
NC_037345.1,NC_032667.1,2835698,2251661,2251662,C,CA,1
NC_037345.1,NC_032667.1,2852079,2268045,2268046,C,CT,1
NC_037345.1,NC_032667.1,2872700,2288741,2288742,T,TA,1
NC_037345.1,NC_032667.1,2879291,2295332,2295334,c,ctt,2
NC_037345.1,NC_032667.1,2946889,2363920,2363925,G,GTTTTC,5
NC_037345.1,NC_032667.1,2960753,2377851,2377852,G,GA,1
NC_037345.1,NC_032667.1,2980526,2397696,2397697,G,GK,1
NC_037345.1,NC_032667.1,3003058,2420232,2420233,T,TY,1
NC_037345.1,NC_032667.1,3004506,2421389,2421390,c,cg,1
NC_037345.1,NC_032667.1,3038063,2481172,2481174,a,aac,2
NC_037345.1,NC_032667.1,3039316,2482428,2482429,a,at,1
NC_037345.1,NC_032667.1,3047597,2490710,2490711,t,tN,1
NC_037345.1,NC_032667.1,3047648,2490763,2490764,C,CA,1
NC_037345.1,NC_032667.1,3051029,2494146,2494147,G,GR,1
NC_037345.1,NC_032667.1,3058242,2501427,2501428,T,TG,1
NC_037345.1,NC_032667.1,3058288,2501474,2501475,G,GC,1
NC_037345.1,NC_032667.1,3067757,2510981,2510983,C,CTG,2
NC_037345.1,NC_032667.1,3074515,2517741,2517743,a,att,2
NC_037345.1,NC_032667.1,3098217,2545702,2545703,G,GT,1
NC_037345.1,NC_032667.1,3099128,2546604,2546605,t,ta,1
NC_037345.1,NC_032667.1,3106536,2554013,2554014,G,GA,1
NC_037345.1,NC_032667.1,3106672,2554150,2554151,C,CA,1
NC_037345.1,NC_032667.1,3111786,2559273,2559274,A,AY,1
NC_037345.1,NC_032667.1,3117901,2565393,2565395,C,CTG,2
NC_037345.1,NC_032667.1,3121139,2568652,2568653,a,ag,1
NC_037345.1,NC_032667.1,3131945,2579461,2579477,T,TGGGAGAGGCTATACGA,16
NC_037345.1,NC_032667.1,3132881,2580413,2580416,t,tagc,3
NC_037345.1,NC_032667.1,3133165,2580700,2580701,t,ta,1
NC_037345.1,NC_032667.1,3152139,2600259,2600260,t,ta,1
NC_037345.1,NC_032667.1,3152686,2600807,2600809,T,TTC,2
NC_037345.1,NC_032667.1,3164511,2612074,2612076,a,agc,2
NC_037345.1,NC_032667.1,3200491,2649590,2649591,A,AG,1
NC_037345.1,NC_032667.1,3217415,2666628,2666630,c,cag,2
NC_037345.1,NC_032667.1,3318550,2764169,2764170,a,at,1
NC_037345.1,NC_032667.1,3349765,2795405,2795415,C,CAGAAGGGGTT,10
NC_037345.1,NC_032667.1,3350909,2796559,2796560,t,ta,1
NC_037345.1,NC_032667.1,3365218,2810869,2810870,t,ta,1
NC_037345.1,NC_032667.1,3369277,2814925,2814926,g,ga,1
NC_037345.1,NC_032667.1,3434039,2879833,2879834,a,aT,1
NC_037345.1,NC_032667.1,4096626,2933676,2933679,c,catt,3
NC_037345.1,NC_032667.1,4110423,2947502,2947503,C,CA,1
NC_037345.1,NC_032667.1,4115698,2952778,2952779,a,ac,1
NC_037345.1,NC_032667.1,4155043,2992130,2992131,T,TW,1
NC_037345.1,NC_032667.1,4158469,2995560,2995561,A,AW,1
NC_037345.1,NC_032667.1,4159326,2996418,2996421,A,AAAT,3
NC_037345.1,NC_032667.1,4161213,2998307,2998309,a,aag,2
NC_037345.1,NC_032667.1,4165194,3002295,3002297,c,ctg,2
NC_037345.1,NC_032667.1,4202392,3039500,3039502,t,taa,2
NC_037345.1,NC_032667.1,4202397,3039507,3039515,t,taaaaaaaa,8
NC_037345.1,NC_032667.1,4203117,3040229,3040230,a,at,1
NC_037345.1,NC_032667.1,4207309,3044420,3044424,c,cagaa,4
NC_037345.1,NC_032667.1,4208515,3045630,3045643,a,actatggagaacag,13
NC_037345.1,NC_032667.1,4218494,3055936,3055937,A,AR,1
NC_037345.1,NC_032667.1,4248398,3086040,3086041,G,GC,1
NC_037345.1,NC_032667.1,4291295,3128964,3128966,C,CCA,2
NC_037345.1,NC_032667.1,4319243,3226407,3226408,C,CA,1
NC_037345.1,NC_032667.1,4370120,3196297,3196299,t,ttg,2
NC_037345.1,NC_032667.1,4370460,3196639,3196651,t,tcactttgctgta,12
NC_037345.1,NC_032667.1,4373247,3199438,3199439,c,cg,1
NC_037345.1,NC_032667.1,4384454,3210651,3210652,C,CS,1
NC_037345.1,NC_032667.1,4399016,3281501,3281503,a,att,2
NC_037345.1,NC_032667.1,4518815,3402040,3402041,c,ca,1
NC_037345.1,NC_032667.1,4532245,3415457,3415458,T,TA,1
NC_037345.1,NC_032667.1,4636003,3519098,3519100,A,AAT,2
NC_037345.1,NC_032667.1,4636059,3519156,3519157,T,TY,1
NC_037345.1,NC_032667.1,4679586,3563987,3563988,A,AG,1
NC_037345.1,NC_032667.1,4775392,3659790,3659791,T,TC,1
NC_037345.1,NC_032667.1,4884079,3768061,3768062,T,TA,1
NC_037345.1,NC_032667.1,4891715,3775694,3775695,C,CA,1
NC_037345.1,NC_032667.1,4901036,3781783,3781784,g,gt,1
NC_037345.1,NC_032667.1,4901566,3782314,3782315,G,GA,1
NC_037345.1,NC_032667.1,4901570,3782319,3782320,G,GC,1
NC_037345.1,NC_032667.1,4918509,3799259,3799260,T,TW,1
NC_037345.1,NC_032667.1,4925879,3806625,3806626,C,CA,1
NC_037345.1,NC_032667.1,4927857,3808605,3808608,a,aaat,3
NC_037345.1,NC_032667.1,4991175,3871465,3871466,C,CA,1
NC_037345.1,NC_032667.1,5014357,3894515,3894516,a,ac,1
NC_037345.1,NC_032667.1,5024013,3904177,3904178,a,aN,1
NC_037345.1,NC_032667.1,5031881,3912047,3912053,a,aNNNNNN,6
NC_037345.1,NC_032667.1,5043662,3923835,3923836,A,AW,1
NC_037345.1,NC_032667.1,5051493,3931667,3931679,G,GCAGCCCCTGTCT,12
NC_037345.1,NC_032667.1,5053505,3933691,3933692,A,AM,1
NC_037345.1,NC_032667.1,5121654,4001801,4001802,T,TC,1
NC_037345.1,NC_032667.1,5136327,4016185,4016186,C,CA,1
NC_037345.1,NC_032667.1,5136510,4016369,4016370,G,GC,1
NC_037345.1,NC_032667.1,5140731,4020591,4020593,G,GAT,2
NC_037345.1,NC_032667.1,5170094,4049952,4049953,A,AR,1
NC_037345.1,NC_032667.1,5213179,4093010,4093011,C,CY,1
NC_037345.1,NC_032667.1,5218186,4098160,4098163,t,tagc,3
NC_037345.1,NC_032667.1,5219103,4099076,4099100,A,ATCACAAGACTGGACCAGAGATGGG,24
NC_037345.1,NC_032667.1,5219700,4099697,4099698,C,CG,1
NC_037345.1,NC_032667.1,5221081,4101079,4101080,a,ac,1
NC_037345.1,NC_032667.1,5221613,4101610,4101611,a,ac,1
NC_037345.1,NC_032667.1,5302688,4182482,4182483,T,TY,1
NC_037345.1,NC_032667.1,5591917,4467954,4467955,T,TA,1
NC_037345.1,NC_032667.1,5643609,4520100,4520101,C,CT,1
NC_037345.1,NC_032667.1,5675413,4551906,4551907,A,AG,1
NC_037345.1,NC_032667.1,5711316,4587810,4587811,a,at,1
NC_037345.1,NC_032667.1,5713855,4590351,4590352,g,ga,1
NC_037345.1,NC_032667.1,6015464,4897757,4897758,G,GT,1
NC_037345.1,NC_032667.1,6275156,5247619,5247620,G,GA,1
NC_037345.1,NC_032667.1,6329205,5301016,5301017,c,ct,1
NC_037345.1,NC_032667.1,6350270,5322084,5322085,g,gc,1
NC_037345.1,NC_032667.1,6353184,5324999,5325000,G,GA,1
NC_037345.1,NC_032667.1,6379714,5351567,5351568,C,CS,1
NC_037345.1,NC_032667.1,6384283,5356140,5356142,C,CTG,2
NC_037345.1,NC_032667.1,6390485,5362343,5362344,t,tN,1
NC_037345.1,NC_032667.1,6419321,5391180,5391181,G,GT,1
NC_037345.1,NC_032667.1,6425956,5397816,5397817,C,CA,1
NC_037345.1,NC_032667.1,6427138,5398999,5399005,a,aatatat,6
NC_037345.1,NC_032667.1,6428401,5400268,5400269,t,ta,1
NC_037345.1,NC_032667.1,6428674,5400542,5400543,g,ga,1
NC_037345.1,NC_032667.1,6429655,5401524,5401576,G,GATACACGCTGTGCRTTAACAtgtcacacacaaacacactgtgTGTGTTGGAC,52
NC_037345.1,NC_032667.1,6483281,5455234,5455235,T,TW,1
NC_037345.1,NC_032667.1,6483535,5455479,5455481,C,CAG,2
NC_037345.1,NC_032667.1,6483586,5455532,5455533,A,AR,1
NC_037345.1,NC_032667.1,6492395,5464329,5464330,C,CM,1
NC_037345.1,NC_032667.1,6496976,5468936,5468937,c,ca,1
NC_037345.1,NC_032667.1,6578845,5550832,5550856,A,AACCCAGAAGGCTGGAGTGGATGGT,24
NC_037345.1,NC_032667.1,6587290,5559311,5559313,t,tta,2
NC_037345.1,NC_032667.1,6587465,5559488,5559491,T,TTAA,3
NC_037345.1,NC_032667.1,6589990,5562015,5562020,T,TTTATC,5
NC_037345.1,NC_032667.1,6604316,5576351,5576362,C,CAGGAGGTGGTT,11
NC_037345.1,NC_032667.1,6612359,5584408,5584409,A,AG,1
NC_037345.1,NC_032667.1,6717199,5689792,5689801,T,TTCACAATTA,9
NC_037345.1,NC_032667.1,6758812,5731417,5731418,T,TK,1
NC_037345.1,NC_032667.1,6819256,5791851,5791852,C,CG,1
NC_037345.1,NC_032667.1,6829511,5802099,5802108,a,acaaaaaaac,9
NC_037345.1,NC_032667.1,6837769,5810387,5810393,t,tNNNNNN,6
NC_037345.1,NC_032667.1,6846635,5819258,5819272,A,AGCAATGGTAATGGT,14
NC_037345.1,NC_032667.1,6858572,5831213,5831214,A,AC,1
NC_037345.1,NC_032667.1,6858572,5902288,5902289,A,AC,1
NC_037345.1,NC_032667.1,6860430,5833072,5833075,A,AGAC,3
NC_037345.1,NC_032667.1,6860430,5904147,5904150,A,AGAC,3
NC_037345.1,NC_032667.1,6861833,5834478,5834479,A,AG,1
NC_037345.1,NC_032667.1,6861833,5905553,5905554,A,AG,1
NC_037345.1,NC_032667.1,6867278,5911004,5911014,c,cctgtccgact,10
NC_037345.1,NC_032667.1,6872665,5916256,5916257,G,GA,1
NC_037345.1,NC_032667.1,6879478,5923069,5923070,a,aN,1
NC_037345.1,NC_032667.1,6881505,5925098,5925100,G,GTT,2
NC_037345.1,NC_032667.1,6883036,5926631,5926632,G,GC,1
NC_037345.1,NC_032667.1,6885336,5928932,5928933,A,AN,1
NC_037345.1,NC_032667.1,6901654,5945253,5945262,g,gtgtgtgtgt,9
NC_037345.1,NC_032667.1,6911312,5954928,5954929,C,CT,1
NC_037345.1,NC_032667.1,6921919,5965536,5965538,c,caa,2
NC_037345.1,NC_032667.1,6923856,5967475,5967477,g,ggt,2
NC_037345.1,NC_032667.1,6946731,5990353,5990354,T,TA,1
NC_037345.1,NC_032667.1,6948428,5992051,5992059,g,gaaaaaaaa,8
NC_037345.1,NC_032667.1,6980544,6024203,6024204,C,CT,1
NC_037345.1,NC_032667.1,6998443,6042097,6042098,A,AG,1
NC_037345.1,NC_032667.1,7055623,6099417,6099419,C,CCA,2
NC_037345.1,NC_032667.1,7084867,6128662,6128666,A,ACTAT,4
NC_037345.1,NC_032667.1,7087790,6131592,6131593,C,CA,1
NC_037345.1,NC_032667.1,7105461,6149266,6149267,A,AG,1
NC_037345.1,NC_032667.1,7110869,6154677,6154678,c,ca,1
NC_037345.1,NC_032667.1,7117623,6161434,6161435,C,CG,1
NC_037345.1,NC_032667.1,7123124,6166938,6166939,t,tg,1
NC_037345.1,NC_032667.1,7326429,6380610,6380611,G,GR,1
NC_037345.1,NC_032667.1,7365016,6418964,6418965,G,GY,1
NC_037345.1,NC_032667.1,7370832,6424751,6424767,T,TCATAATATTACCCAAC,16
NC_037345.1,NC_032667.1,7379252,6433183,6433191,a,aNNNNNNNN,8
NC_037345.1,NC_032667.1,7426076,6480016,6480017,t,ta,1
NC_037345.1,NC_032667.1,7452109,6506061,6506062,t,ta,1
NC_037345.1,NC_032667.1,7452147,6506100,6506102,g,ggt,2
NC_037345.1,NC_032667.1,7457461,6511543,6511544,T,TA,1
NC_037345.1,NC_032667.1,7457501,6511584,6511585,c,ca,1
NC_037345.1,NC_032667.1,7482400,6536504,6536512,a,atatatgtg,8
NC_037345.1,NC_032667.1,7483139,6537251,6537252,A,AT,1
NC_037345.1,NC_032667.1,7500230,6554343,6554344,T,TA,1
NC_037345.1,NC_032667.1,7527804,6581916,6581918,c,cat,2
NC_037345.1,NC_032667.1,7532667,6586788,6586794,a,atgaggt,6
NC_037345.1,NC_032667.1,7589154,6642301,6642302,a,at,1
NC_037345.1,NC_032667.1,7609485,6662514,6662515,g,gt,1
NC_037345.1,NC_032667.1,7859169,6930455,6930456,A,AR,1
NC_037345.1,NC_032667.1,7879516,6951178,6951180,t,tag,2
NC_037345.1,NC_032667.1,7882368,6954030,6954031,t,ta,1
NC_037345.1,NC_032667.1,7888113,6959775,6959784,C,CTAATTATCT,9
NC_037345.1,NC_032667.1,7917167,6989536,6989539,G,GCCT,3
NC_037345.1,NC_032667.1,7919660,6992032,6992033,G,GA,1
NC_037345.1,NC_032667.1,8041535,7113933,7113934,G,GA,1
NC_037345.1,NC_032667.1,8129802,7200251,7200252,T,TG,1
NC_037345.1,NC_032667.1,8132961,7203410,7203411,c,ca,1
NC_037345.1,NC_032667.1,8137001,7207452,7207453,C,CA,1
NC_037345.1,NC_032667.1,8137008,7207460,7207461,C,CN,1
NC_037345.1,NC_032667.1,8158621,7229074,7229075,c,cg,1
NC_037345.1,NC_032667.1,8241783,7312241,7312245,g,gtatt,4
NC_037345.1,NC_032667.1,8280295,7350742,7350743,G,GT,1
NC_037345.1,NC_032667.1,8325068,7395519,7395520,t,tc,1
NC_037345.1,NC_032667.1,8343038,7413492,7413493,G,GR,1
NC_037345.1,NC_032667.1,8358404,7428859,7428861,C,CCT,2
NC_037345.1,NC_032667.1,8361356,7430872,7430873,A,AG,1
NC_037345.1,NC_032667.1,8475620,7549940,7549943,A,ATAC,3
NC_037345.1,NC_032667.1,8488411,7571386,7571388,T,TTA,2
NC_037345.1,NC_032667.1,8522667,7605688,7605698,t,tcaggtggcca,10
NC_037345.1,NC_032667.1,8523047,7606077,7606085,c,ccactgttt,8
NC_037345.1,NC_032667.1,8532437,7615454,7615456,a,atc,2
NC_037345.1,NC_032667.1,8533022,7616041,7616042,A,AG,1
NC_037345.1,NC_032667.1,8646877,7783144,7783145,G,GN,1
NC_037345.1,NC_032667.1,8708696,7844968,7844969,c,ct,1
NC_037345.1,NC_032667.1,8723608,7859883,7859899,A,ACCTGGGCTGGCTGTGC,16
NC_037345.1,NC_032667.1,8727445,7863736,7863752,C,CTTCCCAATGCCTGCTT,16
NC_037345.1,NC_032667.1,8748900,7885206,7885208,T,TTA,2
NC_037345.1,NC_032667.1,8769509,7905630,7905631,C,CT,1
NC_037345.1,NC_032667.1,8769550,7905672,7905673,G,GT,1
NC_037345.1,NC_032667.1,8820040,7957887,7957888,a,aN,1
NC_037345.1,NC_032667.1,8820117,7957965,7957966,t,tc,1
NC_037345.1,NC_032667.1,8820241,7958090,7958093,c,cttt,3
NC_037345.1,NC_032667.1,8824702,7965165,7965166,t,ta,1
NC_037345.1,NC_032667.1,8826157,7966621,7966622,t,ta,1
NC_037345.1,NC_032667.1,8831406,7964291,7964292,a,ag,1
NC_037345.1,NC_032667.1,8832065,7964951,7964952,a,ac,1
NC_037345.1,NC_032667.1,8847472,8051951,8051967,T,TACTACAGGAATGCTAC,16
NC_037345.1,NC_032667.1,8901912,8106434,8106435,T,TW,1
NC_037345.1,NC_032667.1,8931416,8135963,8135964,G,GT,1
NC_037345.1,NC_032667.1,8932288,8136828,8136829,g,gR,1
NC_037345.1,NC_032667.1,8974817,8170471,8170472,A,AG,1
NC_037345.1,NC_032667.1,8991585,8187242,8187243,A,AG,1
NC_037345.1,NC_032667.1,9014474,8211571,8211582,C,CTGCAACTTGCA,11
NC_037345.1,NC_032667.1,9014479,8211587,8211594,T,TGTAGAGA,7
NC_037345.1,NC_032667.1,9038753,8236060,8236061,A,AY,1
NC_037345.1,NC_032667.1,9046909,8244210,8244223,A,ATACCCATATGGGT,13
NC_037345.1,NC_032667.1,9049656,8246948,8246955,A,AAGAGAAC,7
NC_037345.1,NC_032667.1,9051358,8248657,8248658,a,ag,1
NC_037345.1,NC_032667.1,9071364,8269657,8269658,T,TA,1
NC_037345.1,NC_032667.1,9097163,8295479,8295480,g,gt,1
NC_037345.1,NC_032667.1,9117355,8315682,8315684,g,gga,2
NC_037345.1,NC_032667.1,9117362,8315691,8315694,a,acgt,3
NC_037345.1,NC_032667.1,9120038,8318369,8318370,A,AC,1
NC_037345.1,NC_032667.1,9120333,8318665,8318666,C,CG,1
NC_037345.1,NC_032667.1,9149268,8347765,8347771,g,ggaaaaa,6
NC_037345.1,NC_032667.1,9162127,8360630,8360632,t,tNN,2
NC_037345.1,NC_032667.1,9233214,8431740,8431742,c,ctt,2
NC_037345.1,NC_032667.1,9237571,8436097,8436126,T,TNNNNNNNNNNNNNNNNNNNNNNNNNNNNN,29
NC_037345.1,NC_032667.1,9245929,8444484,8444485,g,ga,1
NC_037345.1,NC_032667.1,9300285,8498746,8498750,A,AAGAT,4
NC_037345.1,NC_032667.1,9301796,8500260,8500332,t,ttttNNNNNNNNNNNNNNNNNNNNNNNNNNNNNNNNNNNNNNNNNNNNNNNTGGATCCATATTTTCACTTCTG,72
NC_037345.1,NC_032667.1,9321350,8519884,8519885,C,CT,1
NC_037345.1,NC_032667.1,9322657,8521195,8521196,t,ta,1
NC_037345.1,NC_032667.1,9323887,8522428,8522429,A,AC,1
NC_037345.1,NC_032667.1,9325375,8523919,8523922,c,caca,3
NC_037345.1,NC_032667.1,9329548,8528104,8528105,C,CA,1
NC_037345.1,NC_032667.1,9331125,8529682,8529683,c,ca,1
NC_037345.1,NC_032667.1,9333298,8531854,8531855,T,TG,1
NC_037345.1,NC_032667.1,9333576,8532132,8532133,T,TC,1
NC_037345.1,NC_032667.1,9333940,8532498,8532499,A,AC,1
NC_037345.1,NC_032667.1,9333968,8532526,8532527,T,TG,1
NC_037345.1,NC_032667.1,9334933,8533479,8533480,a,ac,1
NC_037345.1,NC_032667.1,9336669,8535220,8535221,C,CS,1
NC_037345.1,NC_032667.1,9339405,8537955,8537956,A,AG,1
NC_037345.1,NC_032667.1,9374422,8572979,8572980,C,CA,1
NC_037345.1,NC_032667.1,9392131,8590694,8590705,T,TAACTCAGAGTA,11
NC_037345.1,NC_032667.1,9417924,8616413,8616416,G,GGGT,3
NC_037345.1,NC_032667.1,9422508,8620988,8620989,C,CR,1
NC_037345.1,NC_032667.1,9425254,8623756,8623757,C,CY,1
NC_037345.1,NC_032667.1,9432920,8631424,8631426,G,GGA,2
NC_037345.1,NC_032667.1,9432950,8631456,8631457,G,GS,1
NC_037345.1,NC_032667.1,9445064,8643571,8643572,T,TG,1
NC_037345.1,NC_032667.1,9469152,8667662,8667663,C,CA,1
NC_037345.1,NC_032667.1,9565150,8763684,8763685,C,CM,1
NC_037345.1,NC_032667.1,9571599,8770135,8770136,t,ta,1
NC_037345.1,NC_032667.1,9604483,8803079,8803080,a,ag,1
NC_037345.1,NC_032667.1,9614252,8812851,8812852,G,GK,1
NC_037345.1,NC_032667.1,9621380,8819980,8819981,g,gt,1
NC_037345.1,NC_032667.1,9622168,8820763,8820764,t,tc,1
NC_037345.1,NC_032667.1,9622512,8821108,8821111,A,ATGG,3
NC_037345.1,NC_032667.1,9681761,8880366,8880367,T,TG,1
NC_037345.1,NC_032667.1,9761811,8964500,8964501,T,TY,1
NC_037345.1,NC_032667.1,9786807,8989504,8989505,A,AT,1
NC_037345.1,NC_032667.1,9853896,9057165,9057168,T,TGAC,3
NC_037345.1,NC_032667.1,9913438,9116718,9116719,C,CY,1
NC_037345.1,NC_032667.1,9914386,9117667,9117669,a,att,2
NC_037345.1,NC_032667.1,9979575,9182880,9182882,g,gaa,2
NC_037345.1,NC_032667.1,9985246,9188552,9188553,C,CG,1
NC_037345.1,NC_032667.1,9999008,9202318,9202321,t,tCTC,3
NC_037345.1,NC_032667.1,10012455,9216325,9216327,G,GWT,2
NC_037345.1,NC_032667.1,10022202,9226065,9226066,t,tc,1
NC_037345.1,NC_032667.1,10022223,9226087,9226088,c,ca,1
NC_037345.1,NC_032667.1,10022223,9229807,9229808,c,ca,1
NC_037345.1,NC_032667.1,10065276,9273040,9273041,g,gt,1
NC_037345.1,NC_032667.1,10110597,9318014,9318015,T,TG,1
NC_037345.1,NC_032667.1,10236694,9444136,9444138,c,caa,2
NC_037345.1,NC_032667.1,10276445,9483893,9483894,t,tc,1
NC_037345.1,NC_032667.1,10300280,9505195,9505252,T,TGTGTGCTGACTTCCTGGACCCAACACCATTCTCACTCTGTGTGGGAAGTCTTTTTGC,57
NC_037345.1,NC_032667.1,10336329,9541254,9541257,T,TGTA,3
NC_037345.1,NC_032667.1,10373542,9570879,9570880,A,AG,1
NC_037345.1,NC_032667.1,10375120,9572330,9572331,T,TR,1
NC_037345.1,NC_032667.1,10433758,9630466,9630468,C,CGA,2
NC_037345.1,NC_032667.1,10488328,9685017,9685018,C,CG,1
NC_037345.1,NC_032667.1,10503595,9700291,9700292,C,CM,1
NC_037345.1,NC_032667.1,10511112,9707809,9707810,C,CY,1
NC_037345.1,NC_032667.1,10541879,9738946,9738947,T,TG,1
NC_037345.1,NC_032667.1,10685554,9884047,9884094,g,ggacacaactgagcgactMacacacaacacacacacacacacacacac,47
NC_037345.1,NC_032667.1,10695127,9893699,9893700,A,AG,1
NC_037345.1,NC_032667.1,10705262,9903830,9903831,C,CR,1
NC_037345.1,NC_032667.1,10748541,9979745,9979756,G,GTTGTCGATAAC,11
NC_037345.1,NC_032667.1,10773830,10005034,10005035,C,CA,1
NC_037345.1,NC_032667.1,10775487,10006692,10006693,c,ct,1
NC_037345.1,NC_032667.1,10820764,10051018,10051019,C,CS,1
NC_037345.1,NC_032667.1,10835499,10065889,10065890,T,TC,1
NC_037345.1,NC_032667.1,10874651,10105071,10105075,T,TCTGA,4
NC_037345.1,NC_032667.1,10925764,10156102,10156103,G,GC,1
NC_037345.1,NC_032667.1,10994745,10226501,10226502,C,CG,1
NC_037345.1,NC_032667.1,11113954,10345883,10345884,C,CG,1
NC_037345.1,NC_032667.1,11145518,10377453,10377456,A,AGTT,3
NC_037345.1,NC_032667.1,11153459,10385408,10385413,C,CTTTTM,5
NC_037345.1,NC_032667.1,11157135,10389090,10389092,C,CTG,2
NC_037345.1,NC_032667.1,11262991,10495120,10495121,A,AG,1
NC_037345.1,NC_032667.1,11316368,10548501,10548502,a,ag,1
NC_037345.1,NC_032667.1,11359659,10591794,10591795,c,cY,1
NC_037345.1,NC_032667.1,11613182,10848543,10848544,g,gc,1
NC_037345.1,NC_032667.1,11793398,11010047,11010048,G,GT,1
NC_037345.1,NC_032667.1,11793443,11010093,11010095,a,aag,2
NC_037345.1,NC_032667.1,11794709,11011358,11011359,G,GA,1
NC_037345.1,NC_032667.1,11794819,11011469,11011470,T,TY,1
NC_037345.1,NC_032667.1,11804541,11021192,11021193,G,GA,1
NC_037345.1,NC_032667.1,11822934,11039584,11039585,T,TG,1
NC_037345.1,NC_032667.1,11903091,11150748,11150749,G,GR,1
NC_037345.1,NC_032667.1,12024463,11272125,11272126,G,GR,1
NC_037345.1,NC_032667.1,12036651,11284314,11284315,C,CM,1
NC_037345.1,NC_032667.1,12100954,11348623,11348625,G,GGC,2
NC_037345.1,NC_032667.1,12286489,11534255,11534256,T,TC,1
NC_037345.1,NC_032667.1,12341816,11591834,11591835,C,CG,1
NC_037345.1,NC_032667.1,12484405,11734551,11734552,g,gc,1
NC_037345.1,NC_032667.1,12546301,11796453,11796455,c,caa,2
NC_037345.1,NC_032667.1,12920258,12189311,12189312,t,tg,1
NC_037345.1,NC_032667.1,12981425,12250170,12250172,a,aNN,2
NC_037345.1,NC_032667.1,13121092,12390009,12390010,C,CT,1
NC_037345.1,NC_032667.1,13165309,12433935,12433936,T,TY,1
NC_037345.1,NC_032667.1,13171761,12440388,12440389,C,CS,1
NC_037345.1,NC_032667.1,13307831,12576673,12576677,G,GCCGT,4
NC_037345.1,NC_032667.1,13870095,12867573,12867574,G,GN,1
NC_037345.1,NC_032667.1,14008682,13006425,13006426,G,GA,1
NC_037345.1,NC_032667.1,14008750,13006495,13006496,T,TC,1
NC_037345.1,NC_032667.1,14174081,13180087,13180100,G,GGAGCTGCAGCTCC,13
NC_037345.1,NC_032667.1,14176512,13182530,13182531,G,GT,1
NC_037345.1,NC_032667.1,14182081,13188101,13188102,T,TG,1
NC_037345.1,NC_032667.1,14242562,13248585,13248586,C,CA,1
NC_037345.1,NC_032667.1,14255798,13261957,13261959,G,GCC,2
NC_037345.1,NC_032667.1,14519485,13558460,13558461,T,TY,1
NC_037345.1,NC_032667.1,14867568,13943609,13943610,a,at,1
NC_037345.1,NC_032667.1,14867626,13943667,13943670,a,aggg,3
NC_037345.1,NC_032667.1,14868141,13944186,13944187,t,tc,1
NC_037345.1,NC_032667.1,14877591,13953637,13953638,g,ga,1
NC_037345.1,NC_032667.1,15123716,14208424,14208425,A,AG,1
NC_037345.1,NC_032667.1,15168971,14253612,14253615,c,caca,3
NC_037345.1,NC_032667.1,15172509,14257153,14257154,C,CA,1
NC_037345.1,NC_032667.1,15187541,14260406,14260407,g,gc,1
NC_037345.1,NC_032667.1,15218302,14291074,14291075,c,ct,1
NC_037345.1,NC_032667.1,15233247,14306009,14306010,T,TN,1
NC_037345.1,NC_032667.1,15241213,14378003,14378004,c,ca,1
NC_037345.1,NC_032667.1,15241213,14313984,14313985,c,ca,1
NC_037345.1,NC_032667.1,15250872,14387669,14387670,g,ga,1
NC_037345.1,NC_032667.1,15250872,14323650,14323651,g,ga,1
NC_037345.1,NC_032667.1,15250957,14323735,14323739,g,gttta,4
NC_037345.1,NC_032667.1,15261822,14399310,14399317,a,aaaaatac,7
NC_037345.1,NC_032667.1,15261822,14334599,14334606,a,aaaaatac,7
NC_037345.1,NC_032667.1,15261922,14399416,14399418,c,ctt,2
NC_037345.1,NC_032667.1,15261922,14334706,14334708,c,ctt,2
NC_037345.1,NC_032667.1,15263680,14336466,14336469,G,GGTA,3
NC_037345.1,NC_032667.1,15263683,14336472,14336473,C,CT,1
NC_037345.1,NC_032667.1,15268931,14406412,14406413,A,AT,1
NC_037345.1,NC_032667.1,15268931,14341721,14341722,A,AT,1
NC_037345.1,NC_032667.1,15271435,14344226,14344227,T,TA,1
NC_037345.1,NC_032667.1,15271435,14408097,14408098,T,TA,1
NC_037345.1,NC_032667.1,15283065,14419726,14419727,a,aN,1
NC_037345.1,NC_032667.1,15283345,14420007,14420010,a,acac,3
NC_037345.1,NC_032667.1,15311077,14447746,14447750,C,CTTCA,4
NC_037345.1,NC_032667.1,15312697,14449370,14449377,C,CTGGACTG,7
NC_037345.1,NC_032667.1,15320282,14456325,14456326,G,GT,1
NC_037345.1,NC_032667.1,15331922,14468174,14468175,G,GA,1
NC_037345.1,NC_032667.1,15352520,14488512,14488513,A,AY,1
NC_037345.1,NC_032667.1,15353066,14489059,14489060,a,at,1
NC_037345.1,NC_032667.1,15517784,14654990,14654998,g,gGATGAACA,8
NC_037345.1,NC_032667.1,15523155,14660366,14660375,a,agcagcagcR,9
NC_037345.1,NC_032667.1,15592949,14730755,14730756,A,AT,1
NC_037345.1,NC_032667.1,15618037,14755847,14755848,A,AG,1
NC_037345.1,NC_032667.1,15645234,14783046,14783047,c,ct,1
NC_037345.1,NC_032667.1,15789796,14927146,14927148,C,CTT,2
NC_037345.1,NC_032667.1,15789898,14927250,14927251,T,TC,1
NC_037345.1,NC_032667.1,15797194,14934547,14934548,t,tc,1
NC_037345.1,NC_032667.1,15895184,15032555,15032556,c,ct,1
NC_037345.1,NC_032667.1,15897430,15034800,15034809,t,tggacAGGGA,9
NC_037345.1,NC_032667.1,15937640,15080057,15080058,g,gc,1
NC_037345.1,NC_032667.1,16110816,15253409,15253410,T,TC,1
NC_037345.1,NC_032667.1,16110818,15253412,15253413,A,AT,1
NC_037345.1,NC_032667.1,16122714,15265310,15265311,T,TG,1
NC_037345.1,NC_032667.1,16126369,15268966,15268989,G,GTATAGTCTCTCTATTCAGASAGC,23
NC_037345.1,NC_032667.1,16155874,15300486,15300487,a,ac,1
NC_037345.1,NC_032667.1,16186029,15337861,15337865,g,gcgcc,4
NC_037345.1,NC_032667.1,16196018,15347878,15347879,a,ac,1
NC_037345.1,NC_032667.1,16196115,15347961,15347962,t,tg,1
NC_037345.1,NC_032667.1,16197578,15356026,15356039,t,tggttccaaaagga,13
NC_037345.1,NC_032667.1,16208525,15366994,15366995,G,GC,1
NC_037345.1,NC_032667.1,16216774,15375252,15375253,c,ca,1
NC_037345.1,NC_032667.1,16216783,15375262,15375264,c,ctt,2
NC_037345.1,NC_032667.1,16247406,15405883,15405884,T,TA,1
NC_037345.1,NC_032667.1,16269970,15428448,15428449,a,at,1
NC_037345.1,NC_032667.1,16343699,15502151,15502152,c,ct,1
NC_037345.1,NC_032667.1,16364219,15524259,15524261,A,ACT,2
NC_037345.1,NC_032667.1,16385749,15545815,15545834,A,AAGTGACAGGGCCTTCCCTY,19
NC_037345.1,NC_032667.1,16397857,15557941,15557942,t,tg,1
NC_037345.1,NC_032667.1,16433347,15593363,15593364,a,at,1
NC_037345.1,NC_032667.1,16444917,15604934,15604935,C,CG,1
NC_037345.1,NC_032667.1,16474692,15634716,15634717,A,AG,1
NC_037345.1,NC_032667.1,16477806,15637829,15637831,A,ATG,2
NC_037345.1,NC_032667.1,16477835,15637860,15637861,T,TA,1
NC_037345.1,NC_032667.1,16539422,15827226,15827232,A,AAGAAGG,6
NC_037345.1,NC_032667.1,16546045,15833854,15833858,A,AATTG,4
NC_037345.1,NC_032667.1,16572060,15858665,15858668,a,acac,3
NC_037345.1,NC_032667.1,16635288,15937722,15937726,t,tNNNN,4
NC_037345.1,NC_032667.1,16641555,15943998,15943999,a,ag,1
NC_037345.1,NC_032667.1,16672260,15975642,15975644,A,AAG,2
NC_037345.1,NC_032667.1,16676492,15979880,15979882,T,TTC,2
NC_037345.1,NC_032667.1,16683138,15986532,15986533,G,GC,1
NC_037345.1,NC_032667.1,16720073,16023469,16023470,a,ag,1
NC_037345.1,NC_032667.1,16823023,16125989,16125991,g,gtc,2
NC_037345.1,NC_032667.1,16837323,16152740,16152741,A,AC,1
NC_037345.1,NC_032667.1,16843554,16158972,16158973,G,GA,1
NC_037345.1,NC_032667.1,16844671,16160090,16160091,a,ac,1
NC_037345.1,NC_032667.1,16845536,16160956,16160957,a,at,1
NC_037345.1,NC_032667.1,16870616,16186042,16186043,A,AC,1
NC_037345.1,NC_032667.1,16924518,16249208,16249210,a,act,2
NC_037345.1,NC_032667.1,16936329,16261028,16261029,C,CT,1
NC_037345.1,NC_032667.1,16937727,16262427,16262428,T,TG,1
NC_037345.1,NC_032667.1,16973441,16297802,16297804,A,AAG,2
NC_037345.1,NC_032667.1,16980379,16304745,16304747,C,CTG,2
NC_037345.1,NC_032667.1,17044395,16368656,16368657,t,tg,1
NC_037345.1,NC_032667.1,17095060,16421682,16421683,t,ta,1
NC_037345.1,NC_032667.1,17220888,16547686,16547688,t,tga,2
NC_037345.1,NC_032667.1,17316093,16642820,16642821,G,GR,1
NC_037345.1,NC_032667.1,17319229,16645957,16645958,a,at,1
NC_037345.1,NC_032667.1,17351790,16678275,16678278,t,tata,3
NC_037345.1,NC_032667.1,17354160,16680650,16680651,T,TR,1
NC_037345.1,NC_032667.1,17372916,16699012,16699013,C,CA,1
NC_037345.1,NC_032667.1,17429452,16755557,16755558,T,TG,1
NC_037345.1,NC_032667.1,17438742,16764847,16764852,c,caggga,5
NC_037345.1,NC_032667.1,17448111,16774218,16774219,A,AW,1
NC_037345.1,NC_032667.1,17448157,16774265,16774266,G,GR,1
NC_037345.1,NC_032667.1,17449802,16775912,16775913,G,GC,1
NC_037345.1,NC_032667.1,17460400,16848046,16848049,t,ttta,3
NC_037345.1,NC_032667.1,17491812,16879469,16879470,C,CG,1
NC_037345.1,NC_032667.1,17498475,16886133,16886140,T,TGTGAGGG,7
NC_037345.1,NC_032667.1,17498477,16886142,16886144,A,ATG,2
NC_037345.1,NC_032667.1,17516792,16904469,16904470,g,ga,1
NC_037345.1,NC_032667.1,17553016,16942319,16942320,C,CA,1
NC_037345.1,NC_032667.1,17556785,16807953,16807954,a,ac,1
NC_037345.1,NC_032667.1,17556785,16946086,16946087,a,ac,1
NC_037345.1,NC_032667.1,17566837,16797451,16797454,t,ttaa,3
NC_037345.1,NC_032667.1,17566837,16954798,16954801,t,ttaa,3
NC_037345.1,NC_032667.1,17573069,16791198,16791199,A,AG,1
NC_037345.1,NC_032667.1,17573069,16961293,16961294,A,AG,1
NC_037345.1,NC_032667.1,17585158,16973374,16973375,g,gS,1
NC_037345.1,NC_032667.1,17600630,16988857,16988860,g,gNNN,3
NC_037345.1,NC_032667.1,18063442,17106743,17106744,A,AG,1
NC_037345.1,NC_032667.1,18183430,17223813,17223815,c,ctt,2
NC_037345.1,NC_032667.1,18228914,17269312,17269313,A,AM,1
NC_037345.1,NC_032667.1,18307866,17348273,17348288,C,CCGCTCGNNCCGCAGG,15
NC_037345.1,NC_032667.1,18442477,17482990,17482991,T,TG,1
NC_037345.1,NC_032667.1,18475867,17516382,17516385,A,ACAT,3
NC_037345.1,NC_032667.1,18547792,17588327,17588328,a,ag,1
NC_037345.1,NC_032667.1,18766027,17821033,17821034,C,CA,1
NC_037345.1,NC_032667.1,18766134,17821138,17821139,T,TA,1
NC_037345.1,NC_032667.1,18780892,17835895,17835896,T,TA,1
NC_037345.1,NC_032667.1,18780896,17835900,17835901,T,TG,1
NC_037345.1,NC_032667.1,18813672,17868970,17868972,t,taa,2
NC_037345.1,NC_032667.1,18949329,18004630,18004631,C,CG,1
NC_037345.1,NC_032667.1,19203763,18258927,18258928,T,TY,1
NC_037345.1,NC_032667.1,19257226,18435697,18435699,a,aag,2
NC_037345.1,NC_032667.1,19257259,18435732,18435738,a,aNNNNNN,6
NC_037345.1,NC_032667.1,19345670,18491720,18491721,A,AR,1
NC_037345.1,NC_032667.1,19513676,18659724,18659725,t,tg,1
NC_037345.1,NC_032667.1,19513750,18659799,18659800,t,tc,1
NC_037345.1,NC_032667.1,19608834,18754824,18754825,T,TC,1
NC_037345.1,NC_032667.1,19608844,18754835,18754836,T,TA,1
NC_037345.1,NC_032667.1,19626228,18772221,18772223,T,TGK,2
NC_037345.1,NC_032667.1,19703106,18849095,18849096,T,TG,1
NC_037345.1,NC_032667.1,19722192,18868129,18868130,g,gA,1
NC_037345.1,NC_032667.1,19767775,18914515,18914516,t,tc,1
NC_037345.1,NC_032667.1,19768053,18914794,18914795,t,ta,1
NC_037345.1,NC_032667.1,19827120,18973884,18973887,a,actc,3
NC_037345.1,NC_032667.1,20143586,19306045,19306046,T,TG,1
NC_037345.1,NC_032667.1,20304461,19548330,19548331,t,ta,1
NC_037345.1,NC_032667.1,20522424,19755668,19755687,C,CTTTGGTATATAGGTCTATA,19
NC_037345.1,NC_032667.1,20596416,19829675,19829677,T,TTA,2
NC_037345.1,NC_032667.1,20664661,19897751,19897758,A,ATGAAGCT,7
NC_037345.1,NC_032667.1,20676864,19909960,19909961,T,TC,1
NC_037345.1,NC_032667.1,20736163,19968602,19968604,c,cca,2
NC_037345.1,NC_032667.1,20795998,20028853,20028854,a,at,1
NC_037345.1,NC_032667.1,20919320,20151775,20151777,A,ATT,2
NC_037345.1,NC_032667.1,20931461,20163919,20163920,T,TY,1
NC_037345.1,NC_032667.1,20967388,20200631,20200632,t,tc,1
NC_037345.1,NC_032667.1,20967397,20200641,20200645,t,tttta,4
NC_037345.1,NC_032667.1,20972141,20204504,20204505,G,GA,1
NC_037345.1,NC_032667.1,20975971,20208335,20208336,C,CM,1
NC_037345.1,NC_032667.1,20982559,20221736,20221737,G,GC,1
NC_037345.1,NC_032667.1,21041039,20277639,20277641,a,aNN,2
NC_037345.1,NC_032667.1,21079085,20315056,20315086,A,AGCACAACATGTCACCTATTTAGGAATCTCT,30
NC_037345.1,NC_032667.1,21103799,20339739,20339741,T,TTG,2
NC_037345.1,NC_032667.1,21145785,20437102,20437103,g,ga,1
NC_037345.1,NC_032667.1,21166417,20457556,20457566,t,ttatatatata,10
NC_037345.1,NC_032667.1,21175235,20466381,20466382,g,ga,1
NC_037345.1,NC_032667.1,21374605,20657452,20657453,t,tc,1
NC_037345.1,NC_032667.1,21416232,20698773,20698774,c,ca,1
NC_037345.1,NC_032667.1,21417826,20700367,20700377,g,gctcctctgtc,10
NC_037345.1,NC_032667.1,21420510,20703062,20703065,A,AGCC,3
NC_037345.1,NC_032667.1,21425362,20707932,20707933,C,CT,1
NC_037345.1,NC_032667.1,21468498,20750823,20750824,T,TK,1
NC_037345.1,NC_032667.1,21505348,20787678,20787679,G,GR,1
NC_037345.1,NC_032667.1,21553243,20836026,20836027,t,ta,1
NC_037345.1,NC_032667.1,21593844,20877163,20877166,a,aacg,3
NC_037345.1,NC_032667.1,21598026,20881347,20881361,G,GAATTTGTGTTCTGA,14
NC_037345.1,NC_032667.1,21678411,20961685,20961686,G,GT,1
NC_037345.1,NC_032667.1,21678426,20961701,20961702,C,CT,1
NC_037345.1,NC_032667.1,21745652,21028933,21028934,T,TG,1
NC_037345.1,NC_032667.1,21808535,21092887,21092896,C,CGTTGAATCT,9
NC_037345.1,NC_032667.1,21893451,21177828,21177832,t,tcaga,4
NC_037345.1,NC_032667.1,21901916,21186298,21186299,A,AC,1
NC_037345.1,NC_032667.1,21910158,21194541,21194543,t,tNN,2
NC_037345.1,NC_032667.1,22029076,21313392,21313402,A,AAGGACCCTTG,10
NC_037345.1,NC_032667.1,22029393,21313719,21313720,t,ta,1
NC_037345.1,NC_032667.1,22042580,21326907,21326911,a,aNNNN,4
NC_037345.1,NC_032667.1,22049408,21333738,21333739,t,tc,1
NC_037345.1,NC_032667.1,22065600,21349932,21349933,t,ta,1
NC_037345.1,NC_032667.1,22105268,21393541,21393549,g,gtgtgtgtR,8
NC_037345.1,NC_032667.1,22274333,21704853,21704856,t,tagc,3
NC_037345.1,NC_032667.1,22286669,21717188,21717190,a,aac,2
NC_037345.1,NC_032667.1,22453345,21897027,21897028,g,gS,1
NC_037345.1,NC_032667.1,22456210,21899893,21899894,G,GC,1
NC_037345.1,NC_032667.1,22602798,22064270,22064271,T,TA,1
NC_037345.1,NC_032667.1,22630556,22095074,22095076,a,aNN,2
NC_037345.1,NC_032667.1,22631222,22095742,22095743,a,at,1
NC_037345.1,NC_032667.1,22651548,22116070,22116071,G,GS,1
NC_037345.1,NC_032667.1,22991601,22455211,22455212,G,GC,1
NC_037345.1,NC_032667.1,22991610,22455221,22455222,A,AG,1
NC_037345.1,NC_032667.1,22994777,22458389,22458391,a,aag,2
NC_037345.1,NC_032667.1,23103501,22568734,22568735,t,tg,1
NC_037345.1,NC_032667.1,23116775,22582016,22582041,A,ATGNNNNNNNNNNNNNNNNNNNNNNN,25
NC_037345.1,NC_032667.1,23374600,22844523,22844525,a,aNN,2
NC_037345.1,NC_032667.1,23410480,22880406,22880407,c,ca,1
NC_037345.1,NC_032667.1,23410962,22880890,22880891,C,CA,1
NC_037345.1,NC_032667.1,23611484,23125381,23125382,T,TA,1
NC_037345.1,NC_032667.1,23642870,23156972,23156973,t,tg,1
NC_037345.1,NC_032667.1,23835601,23353469,23353472,T,TCCC,3
NC_037345.1,NC_032667.1,23835606,23353477,23353482,C,CACATN,5
NC_037345.1,NC_032667.1,23908937,23499802,23499826,A,ANNNNNNNNNNNNNNNNNNNNNNNN,24
NC_037345.1,NC_032667.1,24040954,23621684,23621685,a,at,1
NC_037345.1,NC_032667.1,24052124,23632857,23632858,g,ga,1
NC_037345.1,NC_032667.1,24075029,23655760,23655761,g,gc,1
NC_037345.1,NC_032667.1,24106872,23687605,23687606,C,CA,1
NC_037345.1,NC_032667.1,24107010,23687748,23687749,t,ta,1
NC_037345.1,NC_032667.1,24147384,23729947,23729948,c,cM,1
NC_037345.1,NC_032667.1,24219122,23801415,23801416,c,ct,1
NC_037345.1,NC_032667.1,24249205,23831253,23831254,A,AC,1
NC_037345.1,NC_032667.1,24249209,23831258,23831260,A,AGT,2
NC_037345.1,NC_032667.1,24575420,24157340,24157341,a,at,1
NC_037345.1,NC_032667.1,24595323,24177243,24177244,T,TG,1
NC_037345.1,NC_032667.1,24595449,24177372,24177373,A,AG,1
NC_037345.1,NC_032667.1,24595475,24177399,24177400,T,TA,1
NC_037345.1,NC_032667.1,24712158,24291811,24291812,C,CY,1
NC_037345.1,NC_032667.1,24712166,24291820,24291821,T,TC,1
NC_037345.1,NC_032667.1,24726238,24305894,24305895,t,tN,1
NC_037345.1,NC_032667.1,24737674,24317331,24317334,c,ctct,3
NC_037345.1,NC_032667.1,24850082,24429096,24429097,t,tY,1
NC_037345.1,NC_032667.1,25045384,24624831,24624833,G,GGT,2
NC_037345.1,NC_032667.1,25115392,24694842,24694845,t,tctc,3
NC_037345.1,NC_032667.1,25115521,24694974,24694975,c,ct,1
NC_037345.1,NC_032667.1,25179946,24759773,24759774,T,TY,1
NC_037345.1,NC_032667.1,25266475,25033696,25033697,T,TC,1
NC_037345.1,NC_032667.1,25665307,25667331,25667332,T,TC,1
NC_037345.1,NC_032667.1,25835264,25837380,25837381,a,ac,1
NC_037345.1,NC_032667.1,26002246,26003983,26003984,g,gt,1
NC_037345.1,NC_032667.1,26050842,26052582,26052583,C,CN,1
NC_037345.1,NC_032667.1,26050889,26052630,26052631,C,CT,1
NC_037345.1,NC_032667.1,26050892,26052634,26052635,A,AT,1
NC_037345.1,NC_032667.1,26072155,26073793,26073796,t,tctc,3
NC_037345.1,NC_032667.1,26175082,26177220,26177222,A,ANN,2
NC_037345.1,NC_032667.1,26397358,26399151,26399152,a,ag,1
NC_037345.1,NC_032667.1,26409472,26411266,26411281,C,CCAACCCTCCAACTCT,15
NC_037345.1,NC_032667.1,26596090,26596754,26596756,g,gga,2
NC_037345.1,NC_032667.1,26759079,26777897,26777900,C,CCTT,3
NC_037345.1,NC_032667.1,26759446,26778267,26778268,G,GR,1
NC_037345.1,NC_032667.1,27125402,27144628,27144629,a,ac,1
NC_037345.1,NC_032667.1,27136050,27155294,27155295,c,cg,1
NC_037345.1,NC_032667.1,27249060,27316538,27316539,a,ac,1
NC_037345.1,NC_032667.1,27547588,27610804,27610806,a,agg,2
NC_037345.1,NC_032667.1,27880081,27668215,27668216,a,ac,1
NC_037345.1,NC_032667.1,28032382,27821164,27821165,t,tg,1
NC_037345.1,NC_032667.1,28032427,27821210,27821212,a,act,2
NC_037345.1,NC_032667.1,28608258,28397091,28397092,c,ca,1
NC_037345.1,NC_032667.1,28691590,28479869,28479871,T,TAA,2
NC_037345.1,NC_032667.1,28701424,28489602,28489603,G,GC,1
NC_037345.1,NC_032667.1,28707593,28495772,28495773,a,at,1
NC_037345.1,NC_032667.1,28707605,28495785,28495787,t,ttg,2
NC_037345.1,NC_032667.1,28749476,28537653,28537654,t,ta,1
NC_037345.1,NC_032667.1,28749478,28537656,28537657,c,cg,1
NC_037345.1,NC_032667.1,28749511,28537690,28537691,c,ct,1
NC_037345.1,NC_032667.1,28785418,28573360,28573362,a,aNN,2
NC_037345.1,NC_032667.1,28856618,28651487,28651488,C,CM,1
NC_037345.1,NC_032667.1,28948765,28744007,28744008,c,ct,1
NC_037345.1,NC_032667.1,29015635,28837795,28837797,c,cNN,2
NC_037345.1,NC_032667.1,29035520,28857681,28857682,t,ta,1
NC_037345.1,NC_032667.1,29082619,28904781,28904782,C,CA,1
NC_037345.1,NC_032667.1,29275731,29098341,29098342,t,tK,1
NC_037345.1,NC_032667.1,29443333,29266070,29266087,T,TNNNNNNNNNNNNNNNNN,17
NC_037345.1,NC_032667.1,29526342,29349805,29349807,a,aNN,2
NC_037345.1,NC_032667.1,30902269,29919548,29919596,t,tgtttGGAACTTTCANNNNNNNNNNNNNNNNNNNNNNNNNNNNNNNNNg,48
NC_037345.1,NC_032667.1,30950778,29968107,29968108,g,ga,1
NC_037345.1,NC_032667.1,30984612,30001778,30001779,T,TG,1
NC_037345.1,NC_032667.1,30987591,30004759,30004760,A,AG,1
NC_037345.1,NC_032667.1,31264522,30296547,30296548,T,TA,1
NC_037345.1,NC_032667.1,31389049,30421258,30421260,a,atg,2
NC_037345.1,NC_032667.1,31444155,30476284,30476285,g,gt,1
NC_037345.1,NC_032667.1,31546292,30578423,30578424,g,ga,1
NC_037345.1,NC_032667.1,31644363,30676486,30676488,a,atg,2
NC_037345.1,NC_032667.1,31808790,30844001,30844003,T,TCG,2
NC_037345.1,NC_032667.1,31856406,30891723,30891724,t,tg,1
NC_037345.1,NC_032667.1,31864723,30900041,30900044,T,TAGG,3
NC_037345.1,NC_032667.1,31866625,30901947,30901948,A,AC,1
NC_037345.1,NC_032667.1,31866991,30902314,30902316,A,AAC,2
NC_037345.1,NC_032667.1,31877915,30910896,30910897,G,GY,1
NC_037345.1,NC_032667.1,32168532,31184751,31184752,t,tN,1
NC_037345.1,NC_032667.1,32171394,31114205,31114206,c,ct,1
NC_037345.1,NC_032667.1,32171394,31187612,31187613,c,ct,1
NC_037345.1,NC_032667.1,32177208,31193834,31193835,G,GY,1
NC_037345.1,NC_032667.1,32190075,31206713,31206737,c,ctACTTNNNNNNNNNNNNNNNNNta,24
NC_037345.1,NC_032667.1,32191371,31208031,31208032,T,TY,1
NC_037345.1,NC_032667.1,32209119,31225828,31225829,T,TA,1
NC_037345.1,NC_032667.1,32217710,31234429,31234430,a,at,1
NC_037345.1,NC_032667.1,32231978,31248319,31248320,g,gt,1
NC_037345.1,NC_032667.1,32233120,31249462,31249463,g,gt,1
NC_037345.1,NC_032667.1,32237649,31253940,31253946,t,tgttttg,6
NC_037345.1,NC_032667.1,32242760,31259062,31259063,a,ag,1
NC_037345.1,NC_032667.1,32263468,31279633,31279634,C,CY,1
NC_037345.1,NC_032667.1,32266695,31282864,31282866,t,taa,2
NC_037345.1,NC_032667.1,32271219,31288272,31288273,C,CA,1
NC_037345.1,NC_032667.1,32297906,31315023,31315027,A,ATTTC,4
NC_037345.1,NC_032667.1,32301621,31318737,31318738,T,TG,1
NC_037345.1,NC_032667.1,32304837,31321952,31321953,T,TW,1
NC_037345.1,NC_032667.1,32339925,31357042,31357044,c,cag,2
NC_037345.1,NC_032667.1,32436975,31458808,31458809,T,TC,1
NC_037345.1,NC_032667.1,32440329,31462163,31462170,a,accctcct,7
NC_037345.1,NC_032667.1,32445385,31467228,31467229,g,ga,1
NC_037345.1,NC_032667.1,32452827,31474666,31474667,t,ta,1
NC_037345.1,NC_032667.1,32454987,31476827,31476828,t,tg,1
NC_037345.1,NC_032667.1,32480056,31503622,31503623,a,at,1
NC_037345.1,NC_032667.1,32483221,31506788,31506790,g,gca,2
NC_037345.1,NC_032667.1,32484677,31508247,31508251,t,tttta,4
NC_037345.1,NC_032667.1,32514910,31538489,31538490,A,AC,1
NC_037345.1,NC_032667.1,32751104,31760383,31760389,a,aacacac,6
NC_037345.1,NC_032667.1,32785691,31796032,31796033,A,AT,1
NC_037345.1,NC_032667.1,33019830,32030130,32030133,t,ttaa,3
NC_037345.1,NC_032667.1,33142677,32152560,32152564,a,aNNNN,4
NC_037345.1,NC_032667.1,33163456,32173345,32173357,a,aNNNNNNNNNNNN,12
NC_037345.1,NC_032667.1,33172132,32182034,32182043,A,AACATCTAGC,9
NC_037345.1,NC_032667.1,33195210,32205126,32205128,A,AAC,2
NC_037345.1,NC_032667.1,33211867,32221794,32221795,A,AG,1
NC_037345.1,NC_032667.1,33337095,32346938,32346939,t,tc,1
NC_037345.1,NC_032667.1,33437382,32449151,32449152,C,CY,1
NC_037345.1,NC_032667.1,33447775,32459556,32459557,A,AR,1
NC_037345.1,NC_032667.1,33533190,32572726,32572727,G,GR,1
NC_037345.1,NC_032667.1,33560739,32600277,32600278,C,CN,1
NC_037345.1,NC_032667.1,33567564,32606838,32606839,G,GR,1
NC_037345.1,NC_032667.1,33580841,32620148,32620149,A,AC,1
NC_037345.1,NC_032667.1,33602212,32641523,32641524,C,CY,1
NC_037345.1,NC_032667.1,33610711,32650017,32650018,G,GA,1
NC_037345.1,NC_032667.1,33631516,32670760,32670761,T,TY,1
NC_037345.1,NC_032667.1,33632789,32672034,32672038,T,TGTAY,4
NC_037345.1,NC_032667.1,33638074,32677327,32677328,C,CA,1
NC_037345.1,NC_032667.1,33658237,32697355,32697358,g,gggt,3
NC_037345.1,NC_032667.1,33662635,32701758,32701759,T,TY,1
NC_037345.1,NC_032667.1,33668079,32707217,32707218,A,AR,1
NC_037345.1,NC_032667.1,33845969,32916925,32916926,g,ga,1
NC_037345.1,NC_032667.1,33847807,32918757,32918758,g,ga,1
NC_037345.1,NC_032667.1,33852319,32923271,32923280,G,GACATAAGTA,9
NC_037345.1,NC_032667.1,33891810,32955273,32955274,G,GA,1
NC_037345.1,NC_032667.1,33929830,32993335,32993359,C,CAANNNNNNNNNNNNNNNNNNNNNN,24
NC_037345.1,NC_032667.1,33965845,33029385,33029387,C,CTG,2
NC_037345.1,NC_032667.1,33988100,33051651,33051652,t,tc,1
NC_037345.1,NC_032667.1,34013613,33077169,33077170,A,AC,1
NC_037345.1,NC_032667.1,34031056,33094612,33094620,t,tatatataa,8
NC_037345.1,NC_032667.1,34115381,33179977,33179979,A,AAT,2
NC_037345.1,NC_032667.1,34117947,33182545,33182546,A,AR,1
NC_037345.1,NC_032667.1,34123285,33187769,33187770,G,GA,1
NC_037345.1,NC_032667.1,34134459,33198956,33198957,G,GK,1
NC_037345.1,NC_032667.1,34136740,33201234,33201250,g,gaaataaaagcaaaaat,16
NC_037345.1,NC_032667.1,34198619,33221028,33221029,G,GR,1
NC_037345.1,NC_032667.1,34225793,33248209,33248210,C,CA,1
NC_037345.1,NC_032667.1,34225805,33248222,33248223,G,GA,1
NC_037345.1,NC_032667.1,34231469,33253889,33253891,C,CAM,2
NC_037345.1,NC_032667.1,34237270,33259691,33259692,T,TC,1
NC_037345.1,NC_032667.1,34309914,33332337,33332338,G,GR,1
NC_037345.1,NC_032667.1,34315812,33338231,33338234,g,gaaa,3
NC_037345.1,NC_032667.1,34321728,33344143,33344145,g,ggK,2
NC_037345.1,NC_032667.1,34381622,33404409,33404411,A,ATT,2
NC_037345.1,NC_032667.1,34441358,33464214,33464215,C,CR,1
NC_037345.1,NC_032667.1,34583551,33606514,33606515,C,CT,1
NC_037345.1,NC_032667.1,34583555,33606519,33606521,G,GGA,2
NC_037345.1,NC_032667.1,34924494,33946900,33946902,c,ctg,2
NC_037345.1,NC_032667.1,35007121,34030907,34030908,G,GC,1
NC_037345.1,NC_032667.1,35026661,34050448,34050449,G,GN,1
NC_037345.1,NC_032667.1,35082080,34106109,34106110,a,aN,1
NC_037345.1,NC_032667.1,35214555,34239290,34239291,A,AM,1
NC_037345.1,NC_032667.1,35229724,34254463,34254464,T,TC,1
NC_037345.1,NC_032667.1,35291521,34316117,34316118,t,tg,1
NC_037345.1,NC_032667.1,35314383,34339436,34339437,c,cg,1
NC_037345.1,NC_032667.1,35484877,34510516,34510517,G,GC,1
NC_037345.1,NC_032667.1,35514904,34539770,34539772,G,GCT,2
NC_037345.1,NC_032667.1,35534450,34559322,34559323,T,TK,1
NC_037345.1,NC_032667.1,35598631,34623546,34623547,C,CA,1
NC_037345.1,NC_032667.1,35726338,34751073,34751076,T,TSTG,3
NC_037345.1,NC_032667.1,35744361,34769100,34769101,G,GS,1
NC_037345.1,NC_032667.1,35821234,34845447,34845448,C,CY,1
NC_037345.1,NC_032667.1,35893581,34917152,34917153,G,GK,1
NC_037345.1,NC_032667.1,35894534,34918106,34918107,C,CY,1
NC_037345.1,NC_032667.1,35916299,34940093,34940094,T,TA,1
NC_037345.1,NC_032667.1,36020226,35044258,35044259,T,TW,1
NC_037345.1,NC_032667.1,36055750,35079821,35079822,T,TY,1
NC_037345.1,NC_032667.1,36070054,35094144,35094145,T,TG,1
NC_037345.1,NC_032667.1,36101086,35125194,35125195,G,GY,1
NC_037345.1,NC_032667.1,36122211,35146356,35146377,T,TACCTCAATGAAATAGGGCCCW,21
NC_037345.1,NC_032667.1,36504529,35528925,35528926,a,at,1
NC_037345.1,NC_032667.1,36589737,35619253,35619254,g,ga,1
NC_037345.1,NC_032667.1,36590099,35619625,35619627,g,gtt,2
NC_037345.1,NC_032667.1,36633159,35662687,35662693,a,aaNNNNN,6
NC_037345.1,NC_032667.1,36722834,35754050,35754054,c,cgtAN,4
NC_037345.1,NC_032667.1,36740401,35771628,35771629,C,CY,1
NC_037345.1,NC_032667.1,36798013,35828935,35828936,A,AR,1
NC_037345.1,NC_032667.1,36906297,35937931,35937932,T,TG,1
NC_037345.1,NC_032667.1,36928467,35957115,35957120,t,tatata,5
NC_037345.1,NC_032667.1,37039016,36067665,36067666,c,cg,1
NC_037345.1,NC_032667.1,37129981,36159846,36159847,c,ct,1
NC_037345.1,NC_032667.1,37231009,36260235,36260236,A,AR,1
NC_037345.1,NC_032667.1,37250470,36279698,36279700,t,tta,2
NC_037345.1,NC_032667.1,37282056,36311286,36311287,t,tN,1
NC_037345.1,NC_032667.1,37403362,36430823,36430824,a,ag,1
NC_037345.1,NC_032667.1,37462169,36489635,36489636,g,ga,1
NC_037345.1,NC_032667.1,37462407,36489874,36489875,c,ct,1
NC_037345.1,NC_032667.1,37462528,36489996,36489998,a,atc,2
NC_037345.1,NC_032667.1,37492748,36520254,36520255,A,AC,1
NC_037345.1,NC_032667.1,37507638,36535144,36535166,A,AACAGCAAGTCAAGGCAGAGAGW,22
NC_037345.1,NC_032667.1,37516693,36544222,36544223,t,ta,1
NC_037345.1,NC_032667.1,37530285,36557799,36557800,a,at,1
NC_037345.1,NC_032667.1,37549377,36576903,36576912,g,gggaaacagt,9
NC_037345.1,NC_032667.1,37559508,36587049,36587051,C,CTG,2
NC_037345.1,NC_032667.1,37566639,36594185,36594208,G,GAGGAACTTTCATGTCATATTGCA,23
NC_037345.1,NC_032667.1,37580032,36607601,36607602,A,AG,1
NC_037345.1,NC_032667.1,37601752,36631422,36631423,A,AG,1
NC_037345.1,NC_032667.1,37602999,36632671,36632678,T,TCtttata,7
NC_037345.1,NC_032667.1,37625278,36654972,36654974,A,AAG,2
NC_037345.1,NC_032667.1,37644682,36675106,36675107,a,ag,1
NC_037345.1,NC_032667.1,37644695,36675121,36675122,c,ca,1
NC_037345.1,NC_032667.1,37677734,36710759,36710761,a,aat,2
NC_037345.1,NC_032667.1,37681525,36714552,36714553,A,AR,1
NC_037345.1,NC_032667.1,37712982,36745584,36745585,c,ct,1
NC_037345.1,NC_032667.1,37718572,36751177,36751179,A,AGT,2
NC_037345.1,NC_032667.1,37787818,36820433,36820435,C,CTA,2
NC_037345.1,NC_032667.1,37832927,36865556,36865557,t,tW,1
NC_037345.1,NC_032667.1,37836543,36869174,36869175,g,gc,1
NC_037345.1,NC_032667.1,37847648,36902850,36902851,T,TG,1
NC_037345.1,NC_032667.1,37861965,36917168,36917183,G,GTCTTCTAAGTCTCCA,15
NC_037345.1,NC_032667.1,37899742,36953862,36953865,t,tctc,3
NC_037345.1,NC_032667.1,37932179,36991398,36991399,A,AM,1
NC_037345.1,NC_032667.1,37957198,37015725,37015726,C,CA,1
NC_037345.1,NC_032667.1,38017820,37076363,37076364,A,AC,1
NC_037345.1,NC_032667.1,38041303,37099867,37099870,c,ccca,3
NC_037345.1,NC_032667.1,38067080,37125648,37125649,T,TG,1
NC_037345.1,NC_032667.1,38114669,37172788,37172789,c,cg,1
NC_037345.1,NC_032667.1,38115441,37173561,37173564,C,CTCT,3
NC_037345.1,NC_032667.1,38187343,37245513,37245514,c,ct,1
NC_037345.1,NC_032667.1,38217384,37275559,37275567,T,TTGGAACTG,8
NC_037345.1,NC_032667.1,38223642,37281834,37281835,g,gt,1
NC_037345.1,NC_032667.1,38233437,37291622,37291623,g,ga,1
NC_037345.1,NC_032667.1,38407900,37476001,37476002,c,ca,1
NC_037345.1,NC_032667.1,38459544,37527516,37527517,A,AR,1
NC_037345.1,NC_032667.1,38460652,37528626,37528627,t,tg,1
NC_037345.1,NC_032667.1,38477327,37567713,37567715,t,tac,2
NC_037345.1,NC_032667.1,38477351,37567739,37567740,a,aN,1
NC_037345.1,NC_032667.1,38481011,37571217,37571221,a,agagg,4
NC_037345.1,NC_032667.1,38489757,37579969,37579970,c,ct,1
NC_037345.1,NC_032667.1,38489794,37580007,37580011,t,ttttc,4
NC_037345.1,NC_032667.1,38496321,37586538,37586539,G,GT,1
NC_037345.1,NC_032667.1,38517620,37615476,37615481,a,agaatt,5
NC_037345.1,NC_032667.1,38517633,37615494,37615496,c,ctg,2
NC_037345.1,NC_032667.1,38525727,37623591,37623592,a,at,1
NC_037345.1,NC_032667.1,38594721,37692595,37692596,t,ta,1
NC_037345.1,NC_032667.1,38617551,37715317,37715319,g,gta,2
NC_037345.1,NC_032667.1,38617584,37715352,37715356,g,gagta,4
NC_037345.1,NC_032667.1,38625279,37723047,37723048,T,TC,1
NC_037345.1,NC_032667.1,38636306,37734089,37734090,g,gt,1
NC_037345.1,NC_032667.1,38636375,37734159,37734160,g,gc,1
NC_037345.1,NC_032667.1,38636437,37734222,37734234,a,attttgatttctt,12
NC_037345.1,NC_032667.1,38642159,37739955,37739957,t,tgg,2
NC_037345.1,NC_032667.1,38645685,37743483,37743495,a,acacgctcagtcg,12
NC_037345.1,NC_032667.1,38651728,37749538,37749539,C,CA,1
NC_037345.1,NC_032667.1,38660071,37757883,37757884,T,TC,1
NC_037345.1,NC_032667.1,38874016,37973881,37973882,T,TA,1
NC_037345.1,NC_032667.1,38876710,37976281,37976282,C,CA,1
NC_037345.1,NC_032667.1,38944306,38043513,38043514,G,GC,1
NC_037345.1,NC_032667.1,39000447,38099774,38099777,a,aGCC,3
NC_037345.1,NC_032667.1,39015684,38115014,38115015,C,CA,1
NC_037345.1,NC_032667.1,39016323,38115711,38115713,G,GCA,2
NC_037345.1,NC_032667.1,39093846,38192153,38192154,T,TC,1
NC_037345.1,NC_032667.1,39095079,38193388,38193391,T,Taag,3
NC_037345.1,NC_032667.1,39103067,38201372,38201378,t,tagcagc,6
NC_037345.1,NC_032667.1,39126704,38224838,38224839,t,tg,1
NC_037345.1,NC_032667.1,39131838,38229971,38229972,A,AG,1
NC_037345.1,NC_032667.1,39138674,38236805,38236807,G,GAC,2
NC_037345.1,NC_032667.1,39144877,38243014,38243030,t,ttctccaggcaagaata,16
NC_037345.1,NC_032667.1,39160011,38258165,38258167,G,GTA,2
NC_037345.1,NC_032667.1,39190444,38288609,38288611,t,tgg,2
NC_037345.1,NC_032667.1,39200705,38298999,38299000,A,AR,1
NC_037345.1,NC_032667.1,39205520,38303816,38303817,a,at,1
NC_037345.1,NC_032667.1,39261822,38360132,38360133,c,ct,1
NC_037345.1,NC_032667.1,39265605,38363916,38363917,G,GT,1
NC_037345.1,NC_032667.1,39360594,38458918,38458919,c,ct,1
NC_037345.1,NC_032667.1,39370981,38469305,38469307,C,CAT,2
NC_037345.1,NC_032667.1,39395448,38493776,38493782,t,tNNNNNN,6
NC_037345.1,NC_032667.1,39449336,38547682,38547683,G,GR,1
NC_037345.1,NC_032667.1,39490300,38589069,38589070,G,GA,1
NC_037345.1,NC_032667.1,39491135,38589906,38589911,C,CTTACT,5
NC_037345.1,NC_032667.1,39524894,38623616,38623619,T,TTTA,3
NC_037345.1,NC_032667.1,39648411,38747075,38747076,C,CG,1
NC_037345.1,NC_032667.1,39770689,38876674,38876675,A,AW,1
NC_037345.1,NC_032667.1,39775985,38881971,38881972,t,ta,1
NC_037345.1,NC_032667.1,39814261,38920249,38920251,A,ATC,2
NC_037345.1,NC_032667.1,39865271,38977510,38977511,G,GA,1
NC_037345.1,NC_032667.1,40010022,39122284,39122293,T,TTTGNNNNNN,9
NC_037345.1,NC_032667.1,40019924,39132189,39132190,C,CA,1
NC_037345.1,NC_032667.1,40030676,39142946,39142950,a,agcat,4
NC_037345.1,NC_032667.1,40034968,39147242,39147244,c,ctg,2
NC_037345.1,NC_032667.1,40050693,39162971,39162973,t,tta,2
NC_037345.1,NC_032667.1,40058197,39171720,39171722,g,gta,2
NC_037345.1,NC_032667.1,40071635,39184964,39184966,a,aag,2
NC_037345.1,NC_032667.1,40105005,39218358,39218359,g,gc,1
NC_037345.1,NC_032667.1,40216595,39346988,39346989,t,tg,1
NC_037345.1,NC_032667.1,40298474,39431529,39431530,T,TG,1
NC_037345.1,NC_032667.1,40344627,39477729,39477730,A,AC,1
NC_037345.1,NC_032667.1,40348880,39481984,39481985,G,GT,1
NC_037345.1,NC_032667.1,40360265,39493369,39493370,G,GK,1
NC_037345.1,NC_032667.1,40479311,39616866,39616868,t,taa,2
NC_037345.1,NC_032667.1,40546372,39684029,39684030,A,AT,1
NC_037345.1,NC_032667.1,40551023,39688703,39688705,a,aat,2
NC_037345.1,NC_032667.1,40569458,39707163,39707193,a,aatcccatggacagaggagcctggaggaggg,30
NC_037345.1,NC_032667.1,40569626,39707361,39707362,t,ta,1
NC_037345.1,NC_032667.1,40571309,39709045,39709048,C,CTCT,3
NC_037345.1,NC_032667.1,40581039,39718783,39718784,t,tY,1
NC_037345.1,NC_032667.1,40625204,39763212,39763214,C,CAG,2
NC_037345.1,NC_032667.1,40775561,39914228,39914229,C,CG,1
NC_037345.1,NC_032667.1,40856242,39994703,39994704,G,GK,1
NC_037345.1,NC_032667.1,40927090,40065484,40065485,G,GY,1
NC_037345.1,NC_032667.1,40930003,40068398,40068399,T,TA,1
NC_037345.1,NC_032667.1,40930159,40068555,40068556,A,AG,1
NC_037345.1,NC_032667.1,40930348,40068745,40068765,C,CAGGCCAGGGTGGGCAGGTGT,20
NC_037345.1,NC_032667.1,40930831,40069250,40069251,c,cg,1
NC_037345.1,NC_032667.1,40930834,40069254,40069256,c,cca,2
NC_037345.1,NC_032667.1,40931045,40069467,40069469,A,ATG,2
NC_037345.1,NC_032667.1,40932538,40070963,40070964,T,TA,1
NC_037345.1,NC_032667.1,40935846,40074270,40074276,T,TCCCCAG,6
NC_037345.1,NC_032667.1,41033528,40172195,40172197,c,caa,2
NC_037345.1,NC_032667.1,41060880,40199470,40199472,c,cca,2
NC_037345.1,NC_032667.1,41065292,40203927,40203928,T,TK,1
NC_037345.1,NC_032667.1,41112210,40249906,40249907,C,CA,1
NC_037345.1,NC_032667.1,41166485,40304176,40304177,C,CY,1
NC_037345.1,NC_032667.1,41481145,40618355,40618356,g,ga,1
NC_037345.1,NC_032667.1,41481616,40618827,40618829,t,taa,2
NC_037345.1,NC_032667.1,41484215,40621428,40621450,g,gctttgatgtactcctttcccaa,22
NC_037345.1,NC_032667.1,41484556,40621792,40621793,t,tg,1
NC_037345.1,NC_032667.1,41542281,40679904,40679924,g,ggattgggggcaggccNNNNa,20
NC_037345.1,NC_032667.1,41545506,40683152,40683153,a,at,1
NC_037345.1,NC_032667.1,41545861,40683503,40683504,c,ct,1
NC_037345.1,NC_032667.1,41555815,40693446,40693447,G,GR,1
NC_037345.1,NC_032667.1,41586408,40724038,40724043,T,TTACTC,5
NC_037345.1,NC_032667.1,41587557,40725190,40725191,A,AG,1
NC_037345.1,NC_032667.1,41588033,40725667,40725671,g,gtatN,4
NC_037345.1,NC_032667.1,41596604,40734245,40734248,C,CAGA,3
NC_037345.1,NC_032667.1,41598514,40736147,40736149,a,aag,2
NC_037345.1,NC_032667.1,41599232,40736869,40736870,a,ac,1
NC_037345.1,NC_032667.1,41600195,40737836,40737837,C,CA,1
NC_037345.1,NC_032667.1,41604583,40742221,40742222,T,TA,1
NC_037345.1,NC_032667.1,41618836,40756477,40756478,T,TC,1
NC_037345.1,NC_032667.1,41622202,40759844,40759845,t,tg,1
NC_037345.1,NC_032667.1,41646485,40784128,40784129,t,tW,1
NC_037345.1,NC_032667.1,41647027,40784671,40784672,C,CT,1
NC_037345.1,NC_032667.1,41647184,40784828,40784830,a,agt,2
NC_037345.1,NC_032667.1,41674412,40811432,40811433,C,CA,1
NC_037345.1,NC_032667.1,41727855,40864883,40864885,a,atg,2
NC_037345.1,NC_032667.1,41769672,40906706,40906708,g,gta,2
NC_037345.1,NC_032667.1,41773967,40911003,40911004,T,TA,1
NC_037345.1,NC_032667.1,41792126,40929842,40929844,A,AAC,2
NC_037345.1,NC_032667.1,41799278,40936999,40937002,t,tctc,3
NC_037345.1,NC_032667.1,41813556,40951278,40951279,g,gc,1
NC_037345.1,NC_032667.1,41826309,40964029,40964030,g,ga,1
NC_037345.1,NC_032667.1,41883754,41021478,41021479,C,CG,1
NC_037345.1,NC_032667.1,41942344,41080176,41080177,C,CA,1
NC_037345.1,NC_032667.1,41957955,41095790,41095794,T,TAGTG,4
NC_037345.1,NC_032667.1,42026503,41164882,41164883,g,gt,1
NC_037345.1,NC_032667.1,42034501,41172881,41172882,A,AC,1
NC_037345.1,NC_032667.1,42035679,41174059,41174060,T,TY,1
NC_037345.1,NC_032667.1,42039865,41178263,41178264,C,CY,1
NC_037345.1,NC_032667.1,42093937,41232364,41232365,G,GS,1
NC_037345.1,NC_032667.1,42101960,41239709,41239710,G,GA,1
NC_037345.1,NC_032667.1,42128317,41265752,41265753,C,CM,1
NC_037345.1,NC_032667.1,42128881,41266317,41266318,G,GW,1
NC_037345.1,NC_032667.1,42135525,41272962,41272963,T,TK,1
NC_037345.1,NC_032667.1,42143209,41280652,41280653,t,ta,1
NC_037345.1,NC_032667.1,42177957,41315407,41315415,c,cacacacat,8
NC_037345.1,NC_032667.1,42198936,41337299,41337300,T,TG,1
NC_037345.1,NC_032667.1,42199864,41338229,41338230,a,at,1
NC_037345.1,NC_032667.1,42206856,41345217,41345218,A,AR,1
NC_037345.1,NC_032667.1,42211480,41349844,41349846,A,AAC,2
NC_037345.1,NC_032667.1,42224755,41363124,41363125,t,ta,1
NC_037345.1,NC_032667.1,42224755,41365362,41365363,t,ta,1
NC_037345.1,NC_032667.1,42230502,41374773,41374779,c,cgttcaa,6
NC_037345.1,NC_032667.1,42255690,41399966,41399968,t,ttg,2
NC_037345.1,NC_032667.1,42370966,41586655,41586656,t,ta,1
NC_037345.1,NC_032667.1,42412818,41628996,41629016,A,AANNNNNNNNNNNNNNNNNNN,20
NC_037345.1,NC_032667.1,42412919,41629117,41629118,T,TA,1
NC_037345.1,NC_032667.1,42447555,41663840,41663841,t,tg,1
NC_037345.1,NC_032667.1,42452997,41729155,41729156,T,TC,1
NC_037345.1,NC_032667.1,42484016,41760181,41760182,C,CT,1
NC_037345.1,NC_032667.1,42512457,41698910,41698911,C,CA,1
NC_037345.1,NC_032667.1,42523040,41709492,41709493,C,CT,1
NC_037345.1,NC_032667.1,42536824,41724273,41724274,a,ag,1
NC_037345.1,NC_032667.1,42592407,41825603,41825604,a,at,1
NC_037345.1,NC_032667.1,42615792,41848986,41848988,G,GTT,2
NC_037345.1,NC_032667.1,42626871,41860172,41860173,T,TR,1
NC_037345.1,NC_032667.1,42627465,41860767,41860768,a,ac,1
NC_037345.1,NC_032667.1,42678200,41915932,41915933,T,TC,1
NC_037345.1,NC_032667.1,42678999,41916732,41916733,A,AM,1
NC_037345.1,NC_032667.1,42679781,41917523,41917525,A,ACT,2
NC_037345.1,NC_032667.1,42686434,41924179,41924185,T,TTCTTAA,6
NC_037345.1,NC_032667.1,42736310,42002271,42002273,C,CTS,2
NC_037345.1,NC_032667.1,42771579,42037543,42037544,t,tg,1
NC_037345.1,NC_032667.1,42794817,42060845,42060847,t,taa,2
NC_037345.1,NC_032667.1,42825506,42222970,42222971,T,TC,1
NC_037345.1,NC_032667.1,42841723,42239195,42239197,C,CTA,2
NC_037345.1,NC_032667.1,42851770,42249251,42249252,C,CA,1
NC_037345.1,NC_032667.1,42933341,42395619,42395620,G,GT,1
NC_037345.1,NC_032667.1,42936209,42398475,42398476,c,cg,1
NC_037345.1,NC_032667.1,42943373,42405641,42405656,C,CGCCTTTCATTTTAGT,15
NC_037345.1,NC_032667.1,42955459,42417745,42417747,a,aat,2
NC_037345.1,NC_032667.1,42955476,42417764,42417765,a,at,1
NC_037345.1,NC_032667.1,42963615,42425840,42425841,a,at,1
NC_037345.1,NC_032667.1,42969457,42432056,42432057,a,ag,1
NC_037345.1,NC_032667.1,43103466,42565664,42565665,c,ct,1
NC_037345.1,NC_032667.1,43103537,42565735,42565736,c,ct,1
NC_037345.1,NC_032667.1,43182863,42616808,42616809,a,at,1
NC_037345.1,NC_032667.1,43182864,42197047,42197048,t,ta,1
NC_037345.1,NC_032667.1,43351803,42842507,42842509,t,tta,2
NC_037345.1,NC_032667.1,43355711,42846741,42846772,C,CCTGcaaatttattgaatttattagttCTAMM,31
NC_037345.1,NC_032667.1,43359618,42850632,42850634,T,TTA,2
NC_037345.1,NC_032667.1,43382252,42873030,42873031,A,AY,1
NC_037345.1,NC_032667.1,43414587,42902385,42902386,A,AC,1
NC_037345.1,NC_032667.1,43417413,42905212,42905213,A,AG,1
NC_037345.1,NC_032667.1,43447814,42935617,42935618,g,ga,1
NC_037345.1,NC_032667.1,43469040,42956838,42956839,C,CT,1
NC_037345.1,NC_032667.1,43511632,42999633,42999634,t,tg,1
NC_037345.1,NC_032667.1,43517570,43005576,43005578,t,tga,2
NC_037345.1,NC_032667.1,43548293,43036309,43036311,c,cat,2
NC_037345.1,NC_032667.1,43577654,43065621,43065622,G,GC,1
NC_037345.1,NC_032667.1,43728306,43158354,43158355,G,GA,1
NC_037345.1,NC_032667.1,43741771,43171674,43171675,C,CG,1
NC_037345.1,NC_032667.1,43743968,43173872,43173877,a,aaaaac,5
NC_037345.1,NC_032667.1,43743980,43173889,43173891,a,aac,2
NC_037345.1,NC_032667.1,43760467,43191073,43191074,t,tg,1
NC_037345.1,NC_032667.1,43804734,43235505,43235518,T,TCTCCGGGCAGCAA,13
NC_037345.1,NC_032667.1,43813634,43244415,43244419,C,CTCTY,4
NC_037345.1,NC_032667.1,43832881,43263667,43263668,T,TC,1
NC_037345.1,NC_032667.1,43834973,43265760,43265761,G,GA,1
NC_037345.1,NC_032667.1,43841722,43272514,43272515,a,ac,1
NC_037345.1,NC_032667.1,43873119,43303918,43303920,c,cca,2
NC_037345.1,NC_032667.1,43877050,43306448,43306449,A,AG,1
NC_037345.1,NC_032667.1,43889119,43318823,43318824,G,GA,1
NC_037345.1,NC_032667.1,43889569,43319274,43319281,g,gggggggt,7
NC_037345.1,NC_032667.1,43951247,43380883,43380889,T,TCTTATG,6
NC_037345.1,NC_032667.1,43951249,43380891,43380895,G,GCTCA,4
NC_037345.1,NC_032667.1,43953251,43382898,43382899,A,AR,1
NC_037345.1,NC_032667.1,43963651,43393300,43393301,C,CA,1
NC_037345.1,NC_032667.1,43979360,43409011,43409012,t,tg,1
NC_037345.1,NC_032667.1,44032048,43461702,43461704,c,cca,2
NC_037345.1,NC_032667.1,44083065,43512650,43512651,a,ac,1
NC_037345.1,NC_032667.1,44085913,43515478,43515479,a,ac,1
NC_037345.1,NC_032667.1,44215466,43687374,43687375,T,TG,1
NC_037345.1,NC_032667.1,44281819,43753739,43753740,a,ag,1
NC_037345.1,NC_032667.1,44282340,43754261,43754262,T,TK,1
NC_037345.1,NC_032667.1,44367999,43839920,43839921,c,ct,1
NC_037345.1,NC_032667.1,44440043,44124469,44124470,g,gt,1
NC_037345.1,NC_032667.1,44441342,44125769,44125770,a,at,1
NC_037345.1,NC_032667.1,44441576,44126004,44126005,c,ct,1
NC_037345.1,NC_032667.1,44463412,44147841,44147842,T,TY,1
NC_037345.1,NC_032667.1,44482658,44167089,44167091,a,aNN,2
NC_037345.1,NC_032667.1,44486895,44171333,44171334,a,at,1
NC_037345.1,NC_032667.1,44495883,44066026,44066027,g,gt,1
NC_037345.1,NC_032667.1,44515699,44003754,44003757,t,taaa,3
NC_037345.1,NC_032667.1,44521314,44009366,44009367,A,AT,1
NC_037345.1,NC_032667.1,44568686,44056759,44056760,G,GC,1
NC_037345.1,NC_032667.1,44671141,44406402,44406404,c,caa,2
NC_037345.1,NC_032667.1,44682362,44417547,44417548,C,CY,1
NC_037345.1,NC_032667.1,44693521,44429158,44429159,T,TK,1
NC_037345.1,NC_032667.1,44696422,44432060,44432061,C,CY,1
NC_037345.1,NC_032667.1,44737745,44478690,44478691,a,at,1
NC_037345.1,NC_032667.1,44744674,44485619,44485621,g,gtt,2
NC_037345.1,NC_032667.1,44786158,44527300,44527301,G,GT,1
NC_037345.1,NC_032667.1,44792507,44533648,44533649,G,GY,1
NC_037345.1,NC_032667.1,44801530,44542671,44542672,G,GT,1
NC_037345.1,NC_032667.1,44805977,44547162,44547163,C,CT,1
NC_037345.1,NC_032667.1,44822972,44563962,44563963,A,AK,1
NC_037345.1,NC_032667.1,44874364,44615391,44615397,C,CCTTATT,6
NC_037345.1,NC_032667.1,44879956,44620988,44620991,t,tNNN,3
NC_037345.1,NC_032667.1,44886360,44627395,44627396,G,GT,1
NC_037345.1,NC_032667.1,44893199,44634239,44634240,T,TW,1
NC_037345.1,NC_032667.1,44895083,44636124,44636125,A,AT,1
NC_037345.1,NC_032667.1,44896467,44637508,44637512,A,AATAG,4
NC_037345.1,NC_032667.1,44897055,44638099,44638100,T,TC,1
NC_037345.1,NC_032667.1,44902866,44643933,44643934,T,TC,1
NC_037345.1,NC_032667.1,44903942,44645010,44645011,A,AW,1
NC_037345.1,NC_032667.1,44941664,44684093,44684096,c,cccg,3
NC_037345.1,NC_032667.1,45072073,44814900,44814902,T,TAA,2
NC_037345.1,NC_032667.1,45079464,44822293,44822294,t,tc,1
NC_037345.1,NC_032667.1,45081175,44824006,44824015,a,aggagagagt,9
NC_037345.1,NC_032667.1,45081848,44824689,44824690,t,ta,1
NC_037345.1,NC_032667.1,45087994,44831425,44831426,t,ta,1
NC_037345.1,NC_032667.1,45115773,44882884,44882886,t,tta,2
NC_037345.1,NC_032667.1,45116665,44886663,44886664,T,TK,1
NC_037345.1,NC_032667.1,45181142,6217365,6217366,g,ga,1
NC_037345.1,NC_032667.1,45181142,6221280,6221281,g,ga,1
NC_037345.1,NC_032667.1,45189675,44924585,44924587,t,tNN,2
NC_037345.1,NC_032667.1,45205836,44940823,44940827,T,TAGAC,4
NC_037345.1,NC_032667.1,45206486,44941477,44941478,t,tK,1
NC_037345.1,NC_032667.1,45534891,44962679,44962681,t,taa,2
NC_037345.1,NC_032667.1,45584222,45012039,45012041,t,tNN,2
NC_037345.1,NC_032667.1,45660609,45088447,45088448,G,GS,1
NC_037345.1,NC_032667.1,45672400,45100246,45100247,C,CT,1
NC_037345.1,NC_032667.1,45732936,45160791,45160792,G,GT,1
NC_037345.1,NC_032667.1,45732978,45160834,45160899,C,CNNNNNNNNNNNNNNNNNNNNNNNNNNNNNNNNNNNNNNNNNNNNNNNNNNNNNNNNNNNNNNNNN,65
NC_037345.1,NC_032667.1,45735154,45163075,45163076,C,CA,1
NC_037345.1,NC_032667.1,45742095,45170027,45170031,A,ATAGT,4
NC_037345.1,NC_032667.1,45747803,45175739,45175754,c,ccaccacccccgcctt,15
NC_037345.1,NC_032667.1,45755581,45183622,45183623,A,AG,1
NC_037345.1,NC_032667.1,45808446,45236496,45236497,C,CS,1
NC_037345.1,NC_032667.1,45864260,45291878,45291880,T,TTG,2
NC_037345.1,NC_032667.1,45864315,45291936,45291937,T,TG,1
NC_037345.1,NC_032667.1,45864327,45291949,45291951,G,GGT,2
NC_037345.1,NC_032667.1,45922292,45349729,45349730,A,AC,1
NC_037345.1,NC_032667.1,45964293,45391721,45391725,C,CTATT,4
NC_037345.1,NC_032667.1,45973412,45401418,45401420,T,TTA,2
NC_037345.1,NC_032667.1,46021411,45449422,45449423,c,ct,1
NC_037345.1,NC_032667.1,46022483,45450493,45450494,G,GY,1
NC_037345.1,NC_032667.1,46045526,45473538,45473540,a,aag,2
NC_037345.1,NC_032667.1,46049927,45477941,45477942,A,AG,1
NC_037345.1,NC_032667.1,46055877,45483962,45483965,G,GAGT,3
NC_037345.1,NC_032667.1,46109777,45537883,45537904,a,agacagcaacccaccaggctcc,21
NC_037345.1,NC_032667.1,46305448,45732817,45732818,T,TC,1
NC_037345.1,NC_032667.1,46326475,45753828,45753829,G,GC,1
NC_037345.1,NC_032667.1,46328424,45755778,45755779,T,TA,1
NC_037345.1,NC_032667.1,46328436,45755791,45755792,T,TC,1
NC_037345.1,NC_032667.1,46383314,45810952,45810953,t,ta,1
NC_037345.1,NC_032667.1,46383331,45810971,45810973,G,GGA,2
NC_037345.1,NC_032667.1,46383436,45811079,45811081,a,att,2
NC_037345.1,NC_032667.1,46384519,45812164,45812180,C,CACCAGGGCCTACCGTT,16
NC_037345.1,NC_032667.1,46462211,45890441,45890442,G,GA,1
NC_037345.1,NC_032667.1,46462214,45890445,45890458,A,AGCGGACTGATCAG,13
NC_037345.1,NC_032667.1,46467719,45896185,45896186,C,CG,1
NC_037345.1,NC_032667.1,46493052,45921523,45921524,G,GR,1
NC_037345.1,NC_032667.1,46501909,45930381,45930383,T,TAC,2
NC_037345.1,NC_032667.1,46520681,45949152,45949153,c,ct,1
NC_037345.1,NC_032667.1,46617747,46046288,46046289,T,TA,1
NC_037345.1,NC_032667.1,46859843,46288433,46288434,G,GT,1
NC_037345.1,NC_032667.1,46873267,46301894,46301897,C,CAAS,3
NC_037345.1,NC_032667.1,46931007,46360703,46360704,c,ct,1
NC_037345.1,NC_032667.1,46931046,46365784,46365785,c,ct,1
NC_037345.1,NC_032667.1,46933553,46368294,46368295,C,CY,1
NC_037345.1,NC_032667.1,46936613,46371355,46371359,T,TCTTG,4
NC_037345.1,NC_032667.1,46937839,46372582,46372583,c,ct,1
NC_037345.1,NC_032667.1,46970176,46405043,46405044,c,cY,1
NC_037345.1,NC_032667.1,46970903,46405768,46405769,T,TA,1
NC_037345.1,NC_032667.1,46974012,46408883,46408884,T,TK,1
NC_037345.1,NC_032667.1,46974177,46409049,46409052,t,tttg,3
NC_037345.1,NC_032667.1,46974823,46409698,46409699,A,AR,1
NC_037345.1,NC_032667.1,46976067,46410943,46410944,A,AM,1
NC_037345.1,NC_032667.1,46978266,46413140,46413141,T,TY,1
NC_037345.1,NC_032667.1,47077467,46514533,46514535,C,CAT,2
NC_037345.1,NC_032667.1,47113063,46550129,46550130,c,cg,1
NC_037345.1,NC_032667.1,47163806,46623537,46623549,t,tagcagcagcagc,12
NC_037345.1,NC_032667.1,47165036,46624780,46624783,A,AAAG,3
NC_037345.1,NC_032667.1,47196475,46656292,46656293,T,TY,1
NC_037345.1,NC_032667.1,47245809,46705593,46705594,G,GA,1
NC_037345.1,NC_032667.1,47250487,46710272,46710273,T,TW,1
NC_037345.1,NC_032667.1,47255381,46715196,46715197,t,ta,1
NC_037345.1,NC_032667.1,47345423,46804101,46804102,A,AG,1
NC_037345.1,NC_032667.1,47348556,46807235,46807236,A,AT,1
NC_037345.1,NC_032667.1,47406237,46866248,46866249,T,TG,1
NC_037345.1,NC_032667.1,47426971,46889122,46889123,T,TG,1
NC_037345.1,NC_032667.1,47455217,46918054,46918055,g,gt,1
NC_037345.1,NC_032667.1,47495023,46957563,46957565,C,CCM,2
NC_037345.1,NC_032667.1,47539635,47002189,47002190,a,at,1
NC_037345.1,NC_032667.1,47541478,47004033,47004034,A,AY,1
NC_037345.1,NC_032667.1,47578011,47040570,47040572,t,tta,2
NC_037345.1,NC_032667.1,47583280,47045678,47045689,a,acacacacacac,11
NC_037345.1,NC_032667.1,47625107,47087554,47087568,A,AGAAAGCTTTCCCCC,14
NC_037345.1,NC_032667.1,47632751,47095218,47095219,a,at,1
NC_037345.1,NC_032667.1,47635027,47097497,47097498,g,ga,1
NC_037345.1,NC_032667.1,47647984,47110459,47110460,t,tc,1
NC_037345.1,NC_032667.1,47652634,47115110,47115112,A,AAC,2
NC_037345.1,NC_032667.1,47682732,47145210,47145211,t,tg,1
NC_037345.1,NC_032667.1,47685983,47148461,47148462,G,GT,1
NC_037345.1,NC_032667.1,47689370,47151846,47151847,g,ga,1
NC_037345.1,NC_032667.1,47825791,47290788,47290814,c,ctgcagcctgccaggctcctctgtcca,26
NC_037345.1,NC_032667.1,47849005,47314033,47314035,t,tNN,2
NC_037345.1,NC_032667.1,47857594,47322627,47322637,G,GCTGTNNNNNN,10
NC_037345.1,NC_032667.1,47875165,47340157,47340159,C,CTY,2
NC_037345.1,NC_032667.1,47906672,47371695,47371699,C,CAGAA,4
NC_037345.1,NC_032667.1,47926244,47391273,47391274,C,CA,1
NC_037345.1,NC_032667.1,47964440,47429477,47429478,A,AG,1
NC_037345.1,NC_032667.1,48073182,47538787,47538788,G,GA,1
NC_037345.1,NC_032667.1,48093458,47559079,47559083,C,CACTT,4
NC_037345.1,NC_032667.1,48157292,47626635,47626636,t,tc,1
NC_037345.1,NC_032667.1,48170230,47639484,47639487,T,TCTC,3
NC_037345.1,NC_032667.1,48181794,47650753,47650754,c,ct,1
NC_037345.1,NC_032667.1,48215125,47683856,47683857,c,cA,1
NC_037345.1,NC_032667.1,48262842,47731582,47731583,c,ct,1
NC_037345.1,NC_032667.1,48263214,47731955,47731956,C,CT,1
NC_037345.1,NC_032667.1,48263414,47732156,47732157,C,CT,1
NC_037345.1,NC_032667.1,48274924,47743680,47743682,C,CCA,2
NC_037345.1,NC_032667.1,48283902,47752368,47752369,c,ct,1
NC_037345.1,NC_032667.1,48337598,47850222,47850224,a,aNN,2
NC_037345.1,NC_032667.1,48436203,47949572,47949576,c,ctgtg,4
NC_037345.1,NC_032667.1,48473492,47986662,47986663,C,CS,1
NC_037345.1,NC_032667.1,48477948,47991356,47991357,T,TG,1
NC_037345.1,NC_032667.1,48503269,48016651,48016652,A,AG,1
NC_037345.1,NC_032667.1,48542644,48063989,48063990,t,ta,1
NC_037345.1,NC_032667.1,48550970,48072314,48072317,A,AAAT,3
NC_037345.1,NC_032667.1,48590962,48207377,48207383,a,aNNNNNN,6
NC_037345.1,NC_032667.1,48657721,48274159,48274161,A,AGC,2
NC_037345.1,NC_032667.1,48668200,48284637,48284641,C,CTCTG,4
NC_037345.1,NC_032667.1,48669187,48285624,48285626,c,cat,2
NC_037345.1,NC_032667.1,48669427,48285866,48285868,c,cta,2
NC_037345.1,NC_032667.1,48766290,48399100,48399101,t,ta,1
NC_037345.1,NC_032667.1,48809088,48441809,48441818,t,ttaaaattta,9
NC_037345.1,NC_032667.1,48809092,48441822,48441823,t,ta,1
NC_037345.1,NC_032667.1,48810779,48443514,48443519,c,cttgct,5
NC_037345.1,NC_032667.1,48823901,48457035,48457037,A,AAG,2
NC_037345.1,NC_032667.1,48830232,48463369,48463377,C,CTGGCTGAG,8
NC_037345.1,NC_032667.1,48831308,48464455,48464456,C,CA,1
NC_037345.1,NC_032667.1,48838460,48471604,48471605,C,CA,1
NC_037345.1,NC_032667.1,48839031,48472176,48472177,T,TA,1
NC_037345.1,NC_032667.1,48839350,48472496,48472500,g,gtttt,4
NC_037345.1,NC_032667.1,48846227,48487212,48487213,a,aN,1
NC_037345.1,NC_032667.1,48847320,48488306,48488307,T,TA,1
NC_037345.1,NC_032667.1,48850066,48483212,48483213,t,tN,1
NC_037345.1,NC_032667.1,48850098,48491086,48491087,t,tN,1
NC_037345.1,NC_032667.1,48868618,48509573,48509574,T,TC,1
NC_037345.1,NC_032667.1,49058846,48548181,48548182,T,TC,1
NC_037345.1,NC_032667.1,49099423,48604434,48604436,c,cca,2
NC_037345.1,NC_032667.1,49131381,48636278,48636279,C,CA,1
NC_037345.1,NC_032667.1,49132709,48637607,48637608,T,TA,1
NC_037345.1,NC_032667.1,49186758,48691212,48691213,G,GT,1
NC_037345.1,NC_032667.1,49196347,48700804,48700805,C,CT,1
NC_037345.1,NC_032667.1,49235092,48739594,48739596,a,act,2
NC_037345.1,NC_032667.1,49252579,48757080,48757081,C,CT,1
NC_037345.1,NC_032667.1,49254382,48758885,48758886,C,CA,1
NC_037345.1,NC_032667.1,49312721,48840138,48840140,t,tta,2
NC_037345.1,NC_032667.1,49312742,48840161,48840163,a,att,2
NC_037345.1,NC_032667.1,49313087,48840507,48840514,a,agtatact,7
NC_037345.1,NC_032667.1,49317217,48844644,48844645,T,TA,1
NC_037345.1,NC_032667.1,49317421,48844850,48844851,A,AC,1
NC_037345.1,NC_032667.1,49324639,48852122,48852123,a,at,1
NC_037345.1,NC_032667.1,49324649,48852133,48852134,a,at,1
NC_037345.1,NC_032667.1,49325807,48853291,48853292,G,GA,1
NC_037345.1,NC_032667.1,49388853,48916344,48916345,C,CS,1
NC_037345.1,NC_032667.1,49507666,49148571,49148573,t,tNN,2
NC_037345.1,NC_032667.1,49659244,49305969,49305970,t,ta,1
NC_037345.1,NC_032667.1,49730263,49379940,49379941,T,TY,1
NC_037345.1,NC_032667.1,49733004,49382682,49382684,c,cca,2
NC_037345.1,NC_032667.1,49788207,49440318,49440320,a,aNN,2
NC_037345.1,NC_032667.1,49795900,49448014,49448015,T,TA,1
NC_037345.1,NC_032667.1,49853160,49505164,49505165,t,tc,1
NC_037345.1,NC_032667.1,49887895,49540006,49540007,a,at,1
NC_037345.1,NC_032667.1,49904494,49556700,49556701,A,AG,1
NC_037345.1,NC_032667.1,49913097,49565303,49565304,C,CG,1
NC_037345.1,NC_032667.1,49957576,49609342,49609349,G,GCACATGA,7
NC_037345.1,NC_032667.1,49974902,49626677,49626678,C,CM,1
NC_037345.1,NC_032667.1,50002216,49653982,49653983,C,CS,1
NC_037345.1,NC_032667.1,50043029,49694584,49694585,A,AT,1
NC_037345.1,NC_032667.1,50122995,49774893,49774904,a,atggactcccat,11
NC_037345.1,NC_032667.1,50223291,49877620,49877621,T,TA,1
NC_037345.1,NC_032667.1,50223530,49877863,49877864,t,tg,1
NC_037345.1,NC_032667.1,50245455,49899786,49899787,a,ac,1
NC_037345.1,NC_032667.1,50360041,50013944,50013946,C,CAA,2
NC_037345.1,NC_032667.1,50440264,50125796,50125798,g,ggt,2
NC_037345.1,NC_032667.1,50488318,50174525,50174526,T,TA,1
NC_037345.1,NC_032667.1,50513650,50199824,50199825,G,GA,1
NC_037345.1,NC_032667.1,50528604,50214211,50214219,a,aaatNNNNN,8
NC_037345.1,NC_032667.1,50540416,50227330,50227331,G,GT,1
NC_037345.1,NC_032667.1,50540423,50227338,50227339,A,AT,1
NC_037345.1,NC_032667.1,50567865,50254931,50254932,A,AM,1
NC_037345.1,NC_032667.1,50612516,50299632,50299633,G,GA,1
NC_037345.1,NC_032667.1,50612880,50299997,50299998,A,AG,1
NC_037345.1,NC_032667.1,50612899,50300017,50300043,G,GAGTTTGAGAGTAGGTGAAATGGAGTT,26
NC_037345.1,NC_032667.1,50613580,50300723,50300725,c,cag,2
NC_037345.1,NC_032667.1,50619628,50307788,50307789,t,ta,1
NC_037345.1,NC_032667.1,50623099,50311261,50311262,t,ta,1
NC_037345.1,NC_032667.1,50625499,50313672,50313673,t,tg,1
NC_037345.1,NC_032667.1,50626168,50314348,50314349,C,CG,1
NC_037345.1,NC_032667.1,50627133,50315314,50315316,t,tac,2
NC_037345.1,NC_032667.1,50627295,50315478,50315479,T,TY,1
NC_037345.1,NC_032667.1,50630837,50319019,50319020,G,GT,1
NC_037345.1,NC_032667.1,50640050,50328269,50328275,G,GATCATA,6
NC_037345.1,NC_032667.1,50696285,50460714,50460719,g,gttttt,5
NC_037345.1,NC_032667.1,50697531,50461942,50461945,G,Gtct,3
NC_037345.1,NC_032667.1,50698759,50463170,50463172,c,ctt,2
NC_037345.1,NC_032667.1,50698801,50463214,50463220,g,gtctgtt,6
NC_037345.1,NC_032667.1,50699401,50463816,50463817,T,TC,1
NC_037345.1,NC_032667.1,50699449,50463865,50463867,t,tNN,2
NC_037345.1,NC_032667.1,50699541,50463959,50463983,t,tttccccattttgagggtttttttc,24
NC_037345.1,NC_032667.1,50700657,50465109,50465118,a,aaacaaaaac,9
NC_037345.1,NC_032667.1,50700703,50465164,50465165,C,CT,1
NC_037345.1,NC_032667.1,50701596,50466077,50466079,G,GAT,2
NC_037345.1,NC_032667.1,50701805,50466288,50466295,t,tacagtcc,7
NC_037345.1,NC_032667.1,50703021,50467511,50467518,t,ttttcttc,7
NC_037345.1,NC_032667.1,50705783,50470283,50470284,G,GA,1
NC_037345.1,NC_032667.1,50712259,50476767,50476768,T,TG,1
NC_037345.1,NC_032667.1,50720753,50485263,50485266,g,gatc,3
NC_037345.1,NC_032667.1,50723159,50487706,50487707,G,GT,1
NC_037345.1,NC_032667.1,50725396,50489946,50489956,t,tcacacacaca,10
NC_037345.1,NC_032667.1,50732752,50497318,50497319,A,AG,1
NC_037345.1,NC_032667.1,50734900,50499476,50499477,a,at,1
NC_037345.1,NC_032667.1,50735974,50500551,50500552,t,ta,1
NC_037345.1,NC_032667.1,50736218,50500796,50500806,t,tctgatctgaa,10
NC_037345.1,NC_032667.1,50737206,50501798,50501807,g,gcagcagcaa,9
NC_037345.1,NC_032667.1,50737662,50502263,50502264,T,TG,1
NC_037345.1,NC_032667.1,50739435,50504039,50504047,a,agGTGAGAG,8
NC_037345.1,NC_032667.1,50739506,50504118,50504119,t,ta,1
NC_037345.1,NC_032667.1,50739976,50504588,50504590,T,TAA,2
NC_037345.1,NC_032667.1,50751589,50516215,50516227,A,AGTGAACGATGCT,12
NC_037345.1,NC_032667.1,50751777,50516412,50516418,a,attttat,6
NC_037345.1,NC_032667.1,50753182,50517831,50517835,C,CTTGT,4
NC_037345.1,NC_032667.1,50753500,50518152,50518153,T,TC,1
NC_037345.1,NC_032667.1,50753735,50518388,50518392,C,CTTTT,4
NC_037345.1,NC_032667.1,50761658,50526323,50526324,a,at,1
NC_037345.1,NC_032667.1,50772742,50367213,50367215,C,CTT,2
NC_037345.1,NC_032667.1,50775231,50369699,50369700,t,ta,1
NC_037345.1,NC_032667.1,50779708,50374176,50374177,T,TA,1
NC_037345.1,NC_032667.1,50779711,50374180,50374181,T,TK,1
NC_037345.1,NC_032667.1,50799897,50553501,50553502,C,CA,1
NC_037345.1,NC_032667.1,50799904,50553509,50553510,T,TC,1
NC_037345.1,NC_032667.1,50815434,50571404,50571405,t,tc,1
NC_037345.1,NC_032667.1,50820888,50576843,50576845,c,cct,2
NC_037345.1,NC_032667.1,50821167,50577124,50577125,G,GA,1
NC_037345.1,NC_032667.1,50828912,50583041,50583042,a,ag,1
NC_037345.1,NC_032667.1,50852477,50606597,50606598,C,CM,1
NC_037345.1,NC_032667.1,50905509,50659638,50659639,C,CA,1
NC_037345.1,NC_032667.1,50944186,50698763,50698764,C,CT,1
NC_037345.1,NC_032667.1,50944221,50698799,50698800,G,GA,1
NC_037345.1,NC_032667.1,50994177,50748792,50748798,C,CCGNNNN,6
NC_037345.1,NC_032667.1,51017869,50772316,50772317,T,TA,1
NC_037345.1,NC_032667.1,51022622,50777045,50777046,G,GA,1
NC_037345.1,NC_032667.1,51024105,50778529,50778530,A,AT,1
NC_037345.1,NC_032667.1,51081247,50835565,50835566,A,AM,1
NC_037345.1,NC_032667.1,51114236,50868398,50868399,C,CA,1
NC_037345.1,NC_032667.1,51323334,51058105,51058106,G,GS,1
NC_037345.1,NC_032667.1,51329075,51063847,51063848,T,TC,1
NC_037345.1,NC_032667.1,51390669,51125730,51125731,C,CG,1
NC_037345.1,NC_032667.1,51390736,51125798,51125799,t,ta,1
NC_037345.1,NC_032667.1,51397182,51140836,51140837,G,GC,1
NC_037345.1,NC_032667.1,51425396,51155271,51155272,c,ct,1
NC_037345.1,NC_032667.1,51426159,51156035,51156036,T,TG,1
NC_037345.1,NC_032667.1,51427812,51157686,51157690,T,TGTCC,4
NC_037345.1,NC_032667.1,51487155,51217018,51217019,T,TC,1
NC_037345.1,NC_032667.1,51491929,51221791,51221803,c,ccaccagggtcct,12
NC_037345.1,NC_032667.1,51497316,51226986,51226988,t,taa,2
NC_037345.1,NC_032667.1,51505317,51235039,51235040,T,TC,1
NC_037345.1,NC_032667.1,51510723,51240447,51240448,a,at,1
NC_037345.1,NC_032667.1,51510723,51244393,51244394,a,at,1
NC_037345.1,NC_032667.1,51520586,51261036,51261037,g,ga,1
NC_037345.1,NC_032667.1,51520785,51261236,51261237,a,at,1
NC_037345.1,NC_032667.1,51524522,51264972,51264973,t,ta,1
NC_037345.1,NC_032667.1,51524700,51265151,51265152,t,tc,1
NC_037345.1,NC_032667.1,51527996,51268438,51268442,C,CTGAS,4
NC_037345.1,NC_032667.1,51608050,51348420,51348423,t,tctc,3
NC_037345.1,NC_032667.1,51647267,51387156,51387160,C,CAGGG,4
NC_037345.1,NC_032667.1,51648525,51388411,51388413,A,AAC,2
NC_037345.1,NC_032667.1,51650811,51390702,51390707,G,GTGAGT,5
NC_037345.1,NC_032667.1,51650964,51390842,51390843,A,AG,1
NC_037345.1,NC_032667.1,51651208,51391096,51391097,G,GC,1
NC_037345.1,NC_032667.1,51658253,51398247,51398259,c,cactgctgctgct,12
NC_037345.1,NC_032667.1,51689150,51429240,51429241,G,GC,1
NC_037345.1,NC_032667.1,51690670,51430762,51430763,A,AW,1
NC_037345.1,NC_032667.1,51694371,51434555,51434557,a,aat,2
NC_037345.1,NC_032667.1,51702862,51443042,51443043,C,CS,1
NC_037345.1,NC_032667.1,51707308,51447556,51447557,a,at,1
NC_037345.1,NC_032667.1,51708291,51448541,51448542,C,CR,1
NC_037345.1,NC_032667.1,51710135,51450386,51450396,c,cccccccccct,10
NC_037345.1,NC_032667.1,51714303,51454562,51454563,T,TC,1
NC_037345.1,NC_032667.1,51716578,51456841,51456843,g,gga,2
NC_037345.1,NC_032667.1,51728709,51469244,51469245,G,GR,1
NC_037345.1,NC_032667.1,51739059,51479593,51479595,c,ctg,2
NC_037345.1,NC_032667.1,51739718,51480256,51480257,t,ta,1
NC_037345.1,NC_032667.1,51743078,51483611,51483612,A,AC,1
NC_037345.1,NC_032667.1,51744589,51485119,51485123,C,CTGAG,4
NC_037345.1,NC_032667.1,51745011,51485545,51485546,A,AG,1
NC_037345.1,NC_032667.1,51745044,51485579,51485580,C,CG,1
NC_037345.1,NC_032667.1,51782400,51522870,51522872,A,AGT,2
NC_037345.1,NC_032667.1,51784699,51525166,51525167,C,CT,1
NC_037345.1,NC_032667.1,51794511,51534979,51534980,T,TC,1
NC_037345.1,NC_032667.1,51806104,51546592,51546598,G,GGAGTGA,6
NC_037345.1,NC_032667.1,51821294,51561810,51561811,G,GT,1
NC_037345.1,NC_032667.1,51823797,51564308,51564309,A,AW,1
NC_037345.1,NC_032667.1,51854778,51596164,51596178,t,tcacacacacacaca,14
NC_037345.1,NC_032667.1,51858472,51600032,51600033,T,TK,1
NC_037345.1,NC_032667.1,51887247,51628812,51628813,A,AR,1
NC_037345.1,NC_032667.1,51906818,51648390,51648391,A,AT,1
NC_037345.1,NC_032667.1,51941489,51683047,51683049,C,CCA,2
NC_037345.1,NC_032667.1,51995295,51736908,51736909,A,AW,1
NC_037345.1,NC_032667.1,51997685,51739450,51739451,a,ag,1
NC_037345.1,NC_032667.1,52003277,51745005,51745006,g,ga,1
NC_037345.1,NC_032667.1,52007672,51749394,51749395,A,AG,1
NC_037345.1,NC_032667.1,52010411,51752138,51752139,C,CY,1
NC_037345.1,NC_032667.1,52010530,51752258,51752260,A,ACT,2
NC_037345.1,NC_032667.1,52021902,51763640,51763641,a,ag,1
NC_037345.1,NC_032667.1,52030021,51771797,51771798,A,AR,1
NC_037345.1,NC_032667.1,52046255,51788030,51788055,C,CCAGATATAGCAGCATTATTGGAGCA,25
NC_037345.1,NC_032667.1,52051132,51792931,51792941,G,GCGAGAAGNNN,10
NC_037345.1,NC_032667.1,52057488,51799778,51799781,G,GTGC,3
NC_037345.1,NC_032667.1,52101323,51843658,51843659,C,CY,1
NC_037345.1,NC_032667.1,52116525,51858865,51858868,c,cacg,3
NC_037345.1,NC_032667.1,52122326,51864805,51864864,T,TATTCAATGACANNNNNNNNNNNNNNNNNNNNNNNNNNNNNNNNNNNNNNNNNNNNNNNN,59
NC_037345.1,NC_032667.1,52168351,51910797,51910798,G,GC,1
NC_037345.1,NC_032667.1,52264441,52008787,52008788,g,ga,1
NC_037345.1,NC_032667.1,52279016,52023357,52023359,C,CCT,2
NC_037345.1,NC_032667.1,52283166,52026612,52026613,A,AC,1
NC_037345.1,NC_032667.1,52314651,52099795,52099796,t,tg,1
NC_037345.1,NC_032667.1,52347130,52132275,52132282,C,CAAAAAAY,7
NC_037345.1,NC_032667.1,52357809,52142963,52142964,g,ga,1
NC_037345.1,NC_032667.1,52361175,52146330,52146344,C,CTTGTTATGCCGGAA,14
NC_037345.1,NC_032667.1,52374410,52163426,52163452,t,ttttatatatagtggtgtgtatatatc,26
NC_037345.1,NC_032667.1,52383569,52172603,52172604,A,AT,1
NC_037345.1,NC_032667.1,52385648,52174684,52174685,C,CY,1
NC_037345.1,NC_032667.1,52426535,52215574,52215575,T,TA,1
NC_037345.1,NC_032667.1,52501356,52290389,52290391,c,cca,2
NC_037345.1,NC_032667.1,52577866,52366902,52366904,c,ctg,2
NC_037345.1,NC_032667.1,52631362,52420285,52420287,C,CCT,2
NC_037345.1,NC_032667.1,52654620,52443546,52443547,G,GT,1
NC_037345.1,NC_032667.1,52666282,52455213,52455214,G,GA,1
NC_037345.1,NC_032667.1,52724107,52510385,52510386,G,GC,1
NC_037345.1,NC_032667.1,52753269,52539607,52539608,T,TA,1
NC_037345.1,NC_032667.1,52755382,52541721,52541722,T,TA,1
NC_037345.1,NC_032667.1,52971310,52756804,52756805,c,ca,1
NC_037345.1,NC_032667.1,53005436,52791641,52791642,G,GK,1
NC_037345.1,NC_032667.1,53015676,52801881,52801882,c,cg,1
NC_037345.1,NC_032667.1,53071405,52856538,52856539,G,GC,1
NC_037345.1,NC_032667.1,53125598,52911436,52911437,t,tg,1
NC_037345.1,NC_032667.1,53125618,52911457,52911458,t,tg,1
NC_037345.1,NC_032667.1,53268026,53056587,53056588,G,GC,1
NC_037345.1,NC_032667.1,53272121,53060683,53060684,C,CT,1
NC_037345.1,NC_032667.1,53279434,53067997,53067999,c,caa,2
NC_037345.1,NC_032667.1,53279476,53068043,53068045,t,tag,2
NC_037345.1,NC_032667.1,53348577,53137892,53137893,A,AR,1
NC_037345.1,NC_032667.1,53352492,53141803,53141804,G,GK,1
NC_037345.1,NC_032667.1,53361471,53150773,53150774,C,CY,1
NC_037345.1,NC_032667.1,53365664,53154968,53154969,G,GA,1
NC_037345.1,NC_032667.1,53398246,53186638,53186639,C,CY,1
NC_037345.1,NC_032667.1,53412303,53200483,53200484,G,GC,1
NC_037345.1,NC_032667.1,53470662,53269499,53269500,T,TY,1
NC_037345.1,NC_032667.1,53476302,53275148,53275149,a,aN,1
NC_037345.1,NC_032667.1,53513059,53311935,53311936,G,GM,1
NC_037345.1,NC_032667.1,53518297,53317174,53317175,T,TC,1
NC_037345.1,NC_032667.1,53561891,53360774,53360789,t,ttgggaagatcccctg,15
NC_037345.1,NC_032667.1,53592378,53391277,53391278,G,GT,1
NC_037345.1,NC_032667.1,53592954,53391854,53391855,C,CM,1
NC_037345.1,NC_032667.1,53611097,53410002,53410003,t,ta,1
NC_037345.1,NC_032667.1,53635036,53433955,53433956,c,ct,1
NC_037345.1,NC_032667.1,53636557,53435478,53435479,g,ga,1
NC_037345.1,NC_032667.1,53636620,53435542,53435544,C,CCY,2
NC_037345.1,NC_032667.1,53646144,53444992,53444995,C,CKTG,3
NC_037345.1,NC_032667.1,53649743,53448626,53448627,T,TY,1
NC_037345.1,NC_032667.1,53650670,53449555,53449560,T,TAGGAA,5
NC_037345.1,NC_032667.1,53651421,53450311,53450313,c,cag,2
NC_037345.1,NC_032667.1,53659628,53458536,53458543,G,GAACCTTA,7
NC_037345.1,NC_032667.1,53660866,53459781,53459782,T,TA,1
NC_037345.1,NC_032667.1,53688112,53486390,53486392,t,ttg,2
NC_037345.1,NC_032667.1,53696669,53494580,53494581,C,CT,1
NC_037345.1,NC_032667.1,53749084,53547114,53547115,A,AG,1
NC_037345.1,NC_032667.1,53792075,53589950,53589951,c,ca,1
NC_037345.1,NC_032667.1,53794839,53592715,53592716,t,tc,1
NC_037345.1,NC_032667.1,53797243,53595148,53595161,a,atcaaagtgaaaag,13
NC_037345.1,NC_032667.1,53812261,53610183,53610186,A,AGAT,3
NC_037345.1,NC_032667.1,53841207,53638402,53638404,C,CTG,2
NC_037345.1,NC_032667.1,53857594,53654567,53654570,c,cctt,3
NC_037345.1,NC_032667.1,53863167,53660143,53660149,T,TGCCCTA,6
NC_037345.1,NC_032667.1,53898374,53700759,53700760,C,CA,1
NC_037345.1,NC_032667.1,54025258,53827093,53827095,t,ttc,2
NC_037345.1,NC_032667.1,54034929,53836778,53836781,G,GCGT,3
NC_037345.1,NC_032667.1,54036980,53838832,53838833,a,at,1
NC_037345.1,NC_032667.1,54148956,53950761,53950762,C,CM,1
NC_037345.1,NC_032667.1,54234858,54036593,54036595,c,cct,2
NC_037345.1,NC_032667.1,54276933,54076622,54076624,G,GCM,2
NC_037345.1,NC_032667.1,54361521,54161135,54161136,G,GT,1
NC_037345.1,NC_032667.1,54397859,54198394,54198395,C,CT,1
NC_037345.1,NC_032667.1,54418790,54219332,54219333,T,TA,1
NC_037345.1,NC_032667.1,54463645,54264312,54264313,G,GA,1
NC_037345.1,NC_032667.1,54488934,54289603,54289604,a,ac,1
NC_037345.1,NC_032667.1,54543096,54405641,54405643,c,ctt,2
NC_037345.1,NC_032667.1,54615303,54477512,54477514,T,TCC,2
NC_037345.1,NC_032667.1,54629871,54491011,54491012,G,GC,1
NC_037345.1,NC_032667.1,54637786,54498676,54498681,C,CACCTA,5
NC_037345.1,NC_032667.1,54739589,54591810,54591811,A,AC,1
NC_037345.1,NC_032667.1,54739672,54591896,54591897,a,ag,1
NC_037345.1,NC_032667.1,54817395,54669847,54669848,C,CT,1
NC_037345.1,NC_032667.1,54837507,54690247,54690248,T,TC,1
NC_037345.1,NC_032667.1,54963584,54816818,54816820,G,GGA,2
NC_037345.1,NC_032667.1,54963626,54816862,54816863,T,TW,1
NC_037345.1,NC_032667.1,54965645,54818413,54818414,A,AW,1
NC_037345.1,NC_032667.1,54984177,54836946,54836947,C,CA,1
NC_037345.1,NC_032667.1,54992040,54844814,54844815,G,GN,1
NC_037345.1,NC_032667.1,54998070,54850845,54850854,g,gcctgctgct,9
NC_037345.1,NC_032667.1,55016938,54869729,54869730,t,ta,1
NC_037345.1,NC_032667.1,55035268,54888426,54888427,G,GC,1
NC_037345.1,NC_032667.1,55086225,54939574,54939575,G,GS,1
NC_037345.1,NC_032667.1,55180363,55035190,55035191,G,GS,1
NC_037345.1,NC_032667.1,55197661,55052488,55052489,C,CT,1
NC_037345.1,NC_032667.1,55369452,55194777,55194778,G,GA,1
NC_037345.1,NC_032667.1,55386814,55212139,55212140,a,ac,1
NC_037345.1,NC_032667.1,55387177,55212503,55212527,a,actcaTCATTGGGGTGCACGAGCTT,24
NC_037345.1,NC_032667.1,55387512,55212862,55212865,G,GTGK,3
NC_037345.1,NC_032667.1,55398671,55224018,55224019,g,ga,1
NC_037345.1,NC_032667.1,55440639,55265985,55265998,a,aaaaaaaaaaaacc,13
NC_037345.1,NC_032667.1,55448824,55274186,55274188,T,TAC,2
NC_037345.1,NC_032667.1,55452799,55278166,55278167,g,gt,1
NC_037345.1,NC_032667.1,55506855,55331995,55331996,c,ca,1
NC_037345.1,NC_032667.1,55534242,55359391,55359392,C,CN,1
NC_037345.1,NC_032667.1,55659920,55484158,55484159,C,CN,1
NC_037345.1,NC_032667.1,55662483,55486723,55486724,G,GA,1
NC_037345.1,NC_032667.1,55712210,55616060,55616061,g,gt,1
NC_037345.1,NC_032667.1,55720888,55624740,55624741,A,AG,1
NC_037345.1,NC_032667.1,55720935,55624788,55624790,T,TTC,2
NC_037345.1,NC_032667.1,55738020,55641876,55641878,C,CCT,2
NC_037345.1,NC_032667.1,55815862,55770645,55770657,A,ATGATGTTCNNNN,12
NC_037345.1,NC_032667.1,55856684,55811485,55811486,C,CA,1
NC_037345.1,NC_032667.1,55873895,55828697,55828698,C,CA,1
NC_037345.1,NC_032667.1,55883353,55838154,55838155,C,CS,1
NC_037345.1,NC_032667.1,55925772,55880712,55880713,T,TG,1
NC_037345.1,NC_032667.1,55931648,55886589,55886605,T,TCTCTCTCTGGGTCTCC,16
NC_037345.1,NC_032667.1,55931781,55886738,55886741,C,CTCT,3
NC_037345.1,NC_032667.1,55931785,55886745,55886753,T,TGGGTCCCC,8
NC_037345.1,NC_032667.1,55952745,55907569,55907570,T,TG,1
NC_037345.1,NC_032667.1,56107936,56063254,56063255,C,CA,1
NC_037345.1,NC_032667.1,56113361,56068684,56068685,a,at,1
NC_037345.1,NC_032667.1,56137096,56092423,56092426,C,CCTT,3
NC_037345.1,NC_032667.1,56146617,56101946,56101947,C,CY,1
NC_037345.1,NC_032667.1,56157985,56113742,56113743,G,GS,1
NC_037345.1,NC_032667.1,56192145,56147846,56147847,C,CA,1
NC_037345.1,NC_032667.1,56232324,56187886,56187889,C,CCAA,3
NC_037345.1,NC_032667.1,56235720,56191448,56191449,G,GS,1
NC_037345.1,NC_032667.1,56310891,56266632,56266638,g,ggggggt,6
NC_037345.1,NC_032667.1,56341691,56296471,56296474,t,taaa,3
NC_037345.1,NC_032667.1,56411179,56366166,56366167,A,AT,1
NC_037345.1,NC_032667.1,56411195,56366183,56366184,G,GC,1
NC_037345.1,NC_032667.1,56498660,56456262,56456263,T,TC,1
NC_037345.1,NC_032667.1,56509760,56467509,56467510,C,CG,1
NC_037345.1,NC_032667.1,56509766,56467516,56467517,T,TG,1
NC_037345.1,NC_032667.1,56551512,56509285,56509286,T,TG,1
NC_037345.1,NC_032667.1,56564911,56522463,56522467,T,TNNNN,4
NC_037345.1,NC_032667.1,56573296,56530356,56530357,G,GA,1
NC_037345.1,NC_032667.1,56602704,56556543,56556544,A,AC,1
NC_037345.1,NC_032667.1,56615109,56568948,56568949,C,CY,1
NC_037345.1,NC_032667.1,56618154,56571994,56571995,c,cg,1
NC_037345.1,NC_032667.1,56628258,56581769,56581773,C,CACAS,4
NC_037345.1,NC_032667.1,56628700,56582218,56582219,T,TG,1
NC_037345.1,NC_032667.1,56633443,56586963,56586965,c,ctt,2
NC_037345.1,NC_032667.1,56707020,56659863,56659864,A,AT,1
NC_037345.1,NC_032667.1,56811860,56749568,56749569,T,TR,1
NC_037345.1,NC_032667.1,56814025,56751734,56751735,A,AG,1
NC_037345.1,NC_032667.1,56821659,56759373,56759374,T,TG,1
NC_037345.1,NC_032667.1,56828415,56765962,56765963,G,GR,1
NC_037345.1,NC_032667.1,56836288,56773843,56773846,g,gggt,3
NC_037345.1,NC_032667.1,56849025,56786796,56786798,c,caa,2
NC_037345.1,NC_032667.1,56880398,56863612,56863613,C,CG,1
NC_037345.1,NC_032667.1,56902387,56885598,56885599,A,AG,1
NC_037345.1,NC_032667.1,56964599,56947553,56947554,A,AG,1
NC_037345.1,NC_032667.1,56964612,56947567,56947570,C,CCAG,3
NC_037345.1,NC_032667.1,57029829,57020996,57020997,T,TA,1
NC_037345.1,NC_032667.1,57043080,57034251,57034252,C,CS,1
NC_037345.1,NC_032667.1,57046900,57038073,57038074,T,TG,1
NC_037345.1,NC_032667.1,57053141,57044330,57044332,g,ggt,2
NC_037345.1,NC_032667.1,57059845,57051900,57051901,C,CG,1
NC_037345.1,NC_032667.1,57093423,57085491,57085502,t,tgggacccttga,11
NC_037345.1,NC_032667.1,57093490,57085569,57085571,c,ctt,2
NC_037345.1,NC_032667.1,57106141,57098241,57098242,C,CT,1
NC_037345.1,NC_032667.1,57107434,57099535,57099540,T,TNNNNN,5
NC_037345.1,NC_032667.1,57110433,57102537,57102538,A,AG,1
NC_037345.1,NC_032667.1,57113873,57105976,57105977,a,at,1
NC_037345.1,NC_032667.1,57135898,57128095,57128096,G,GR,1
NC_037345.1,NC_032667.1,57331372,57245403,57245404,a,ag,1
NC_037345.1,NC_032667.1,57336486,57250534,57250535,A,AT,1
NC_037345.1,NC_032667.1,57340780,57254828,57254829,t,ta,1
NC_037345.1,NC_032667.1,57343909,57257958,57257959,C,CA,1
NC_037345.1,NC_032667.1,57349590,57263640,57263644,A,ACAGT,4
NC_037345.1,NC_032667.1,57352133,57266187,57266190,c,cttg,3
NC_037345.1,NC_032667.1,57399462,57313650,57313651,C,CG,1
NC_037345.1,NC_032667.1,57408616,57322645,57322653,t,tatatatac,8
NC_037345.1,NC_032667.1,57433971,57347903,57347925,G,GGGMAAGCAGCGCCAACACTTCC,22
NC_037345.1,NC_032667.1,57446652,57360660,57360661,c,ca,1
NC_037345.1,NC_032667.1,57514986,57428506,57428508,C,CCG,2
NC_037345.1,NC_032667.1,57528681,57442202,57442203,C,CY,1
NC_037345.1,NC_032667.1,57532791,57446305,57446306,A,AR,1
NC_037345.1,NC_032667.1,57533620,57447135,57447150,a,agcagctgcagcagcW,15
NC_037345.1,NC_032667.1,57538032,57451560,57451561,A,AR,1
NC_037345.1,NC_032667.1,57542231,57455762,57455764,C,CMM,2
NC_037345.1,NC_032667.1,57568940,57482673,57482674,G,GR,1
NC_037345.1,NC_032667.1,57568948,57482682,57482683,A,AC,1
NC_037345.1,NC_032667.1,57568960,57482695,57482696,A,AG,1
NC_037345.1,NC_032667.1,57568964,57482700,57482701,T,TG,1
NC_037345.1,NC_032667.1,57645603,57547786,57547787,T,TG,1
NC_037345.1,NC_032667.1,57648114,57550298,57550307,c,ctctctcttt,9
NC_037345.1,NC_032667.1,57677271,57579473,57579474,T,TA,1
NC_037345.1,NC_032667.1,57757511,57659113,57659115,c,cta,2
NC_037345.1,NC_032667.1,57836492,57738093,57738094,t,tW,1
NC_037345.1,NC_032667.1,57842732,57744333,57744335,c,cag,2
NC_037345.1,NC_032667.1,57842943,57744545,57744546,t,tc,1
NC_037345.1,NC_032667.1,57843144,57744747,57744756,a,acactgtttc,9
NC_037345.1,NC_032667.1,57866124,57770474,57770476,c,cta,2
NC_037345.1,NC_032667.1,57875218,57779573,57779575,c,cct,2
NC_037345.1,NC_032667.1,57876898,57781253,57781254,C,CS,1
NC_037345.1,NC_032667.1,57909337,57837405,57837406,a,ag,1
NC_037345.1,NC_032667.1,57909529,57837588,57837589,t,ta,1
NC_037345.1,NC_032667.1,57918760,57846821,57846823,c,cct,2
NC_037345.1,NC_032667.1,57925675,57853741,57853742,a,at,1
NC_037345.1,NC_032667.1,57939967,57868052,57868053,A,AC,1
NC_037345.1,NC_032667.1,57946041,57874128,57874131,A,ATTC,3
NC_037345.1,NC_032667.1,57992791,57921332,57921336,T,TCATA,4
NC_037345.1,NC_032667.1,58012437,57940997,57941001,g,gaatt,4
NC_037345.1,NC_032667.1,58132582,58060576,58060599,A,ATTTTTCTGAGAGTRTTTACCATG,23
NC_037345.1,NC_032667.1,58132637,58060654,58060668,g,gtttatcttcctttt,14
NC_037345.1,NC_032667.1,58162351,58156007,58156009,G,GTC,2
NC_037345.1,NC_032667.1,58222060,58216747,58216748,t,tg,1
NC_037345.1,NC_032667.1,58259862,58255413,58255414,g,gt,1
NC_037345.1,NC_032667.1,58295660,58292063,58292064,g,ga,1
NC_037345.1,NC_032667.1,58301234,58301068,58301079,a,aagccaggcttc,11
NC_037345.1,NC_032667.1,58301948,58301794,58301795,a,ac,1
NC_037345.1,NC_032667.1,58308652,58308499,58308500,t,ta,1
NC_037345.1,NC_032667.1,58313274,58313127,58313129,C,CAS,2
NC_037345.1,NC_032667.1,58322304,58322170,58322171,g,gc,1
NC_037345.1,NC_032667.1,58322519,58322386,58322398,C,CAAAGCTGCTCTA,12
NC_037345.1,NC_032667.1,58327659,58327520,58327522,g,gga,2
NC_037345.1,NC_032667.1,58342073,58341084,58341085,t,tg,1
NC_037345.1,NC_032667.1,58346016,58345031,58345032,G,GA,1
NC_037345.1,NC_032667.1,58352184,58351200,58351201,G,GK,1
NC_037345.1,NC_032667.1,58406396,58401925,58401926,g,gc,1
NC_037345.1,NC_032667.1,58409773,58405304,58405305,G,GA,1
NC_037345.1,NC_032667.1,58419273,58414800,58414804,A,ATACC,4
NC_037345.1,NC_032667.1,58419950,58415743,58415748,G,GGAGGC,5
NC_037345.1,NC_032667.1,58424293,58420093,58420094,A,AR,1
NC_037345.1,NC_032667.1,58428258,58424058,58424060,T,TTC,2
NC_037345.1,NC_032667.1,58430259,58426064,58426065,a,ag,1
NC_037345.1,NC_032667.1,58434129,58429947,58429950,C,CCTT,3
NC_037345.1,NC_032667.1,58447904,58443723,58443726,C,CATA,3
NC_037345.1,NC_032667.1,58448404,58444230,58444231,c,ca,1
NC_037345.1,NC_032667.1,58460787,58456608,58456609,C,CA,1
NC_037345.1,NC_032667.1,58464183,58460091,58460092,c,cM,1
NC_037345.1,NC_032667.1,58467673,58463581,58463583,t,ttc,2
NC_037345.1,NC_032667.1,58469003,58464922,58464923,c,ct,1
NC_037345.1,NC_032667.1,58471223,58467141,58467144,T,TCTC,3
NC_037345.1,NC_032667.1,58472032,58467953,58467958,a,aaagag,5
NC_037345.1,NC_032667.1,58475965,58471892,58471893,c,ct,1
NC_037345.1,NC_032667.1,58476594,58472521,58472522,G,GT,1
NC_037345.1,NC_032667.1,58525198,58582514,58582515,T,TG,1
NC_037345.1,NC_032667.1,58526405,58583723,58583724,A,AT,1
NC_037345.1,NC_032667.1,58558495,58486497,58486498,a,at,1
NC_037345.1,NC_032667.1,58558603,58486607,58486608,G,GT,1
NC_037345.1,NC_032667.1,58558807,58486812,58486814,A,ACC,2
NC_037345.1,NC_032667.1,58569800,58497807,58497808,g,ga,1
NC_037345.1,NC_032667.1,58603311,58531669,58531673,c,cagaa,4
NC_037345.1,NC_032667.1,58603580,58531942,58531952,t,tagaacaaata,10
NC_037345.1,NC_032667.1,58603710,58532081,58532082,a,ag,1
NC_037345.1,NC_032667.1,58606631,58535003,58535004,a,ag,1
NC_037345.1,NC_032667.1,58607109,58535471,58535472,a,ag,1
NC_037345.1,NC_032667.1,58629711,58688261,58688262,c,ca,1
NC_037345.1,NC_032667.1,58629790,58688341,58688344,g,gcta,3
NC_037345.1,NC_032667.1,58662290,58720805,58720806,C,CT,1
NC_037345.1,NC_032667.1,58671223,58729725,58729726,G,GA,1
NC_037345.1,NC_032667.1,59108191,58968956,58968961,a,atgatg,5
NC_037345.1,NC_032667.1,59137183,58997752,58997756,C,CTTGG,4
NC_037345.1,NC_032667.1,59160231,59020807,59020814,a,aNNNNNNN,7
NC_037345.1,NC_032667.1,59184191,59044775,59044776,C,CK,1
NC_037345.1,NC_032667.1,59227778,59932744,59932746,G,GAC,2
NC_037345.1,NC_032667.1,59227975,59932946,59932947,T,TG,1
NC_037345.1,NC_032667.1,59298617,59159305,59159306,T,TC,1
NC_037345.1,NC_032667.1,59365703,59227583,59227584,C,CA,1
NC_037345.1,NC_032667.1,59372114,59233973,59233976,C,CAAG,3
NC_037345.1,NC_032667.1,59380248,59241985,59241989,A,AGCAG,4
NC_037345.1,NC_032667.1,59381185,59242926,59242930,g,gcgtc,4
NC_037345.1,NC_032667.1,59385659,59247767,59247769,a,aag,2
NC_037345.1,NC_032667.1,59387557,59249667,59249668,c,ca,1
NC_037345.1,NC_032667.1,59389699,59251807,59251808,G,GC,1
NC_037345.1,NC_032667.1,59392662,59254770,59254771,C,CA,1
NC_037345.1,NC_032667.1,59394429,59256170,59256171,t,tK,1
NC_037345.1,NC_032667.1,59396385,59258125,59258127,A,AGT,2
NC_037345.1,NC_032667.1,59397374,59259115,59259116,T,TG,1
NC_037345.1,NC_032667.1,59397467,59259209,59259210,C,CA,1
NC_037345.1,NC_032667.1,59398265,59260008,59260009,T,TG,1
NC_037345.1,NC_032667.1,59399113,59260857,59260859,c,cct,2
NC_037345.1,NC_032667.1,59401345,59263090,59263091,g,ga,1
NC_037345.1,NC_032667.1,59402704,59264449,59264450,T,TC,1
NC_037345.1,NC_032667.1,59408666,59270466,59270467,C,CA,1
NC_037345.1,NC_032667.1,59416189,59277772,59277775,c,caaa,3
NC_037345.1,NC_032667.1,59416338,59277924,59277925,g,gc,1
NC_037345.1,NC_032667.1,59417199,59278787,59278790,a,acag,3
NC_037345.1,NC_032667.1,59417599,59279189,59279216,C,CAACTGTCATATTTCTAATGTTTCTCAT,27
NC_037345.1,NC_032667.1,59421439,59283057,59283058,G,GC,1
NC_037345.1,NC_032667.1,59423724,59285345,59285346,A,AR,1
NC_037345.1,NC_032667.1,59424505,59286127,59286128,c,ca,1
NC_037345.1,NC_032667.1,59424979,59286602,59286603,T,TC,1
NC_037345.1,NC_032667.1,59425100,59286724,59286746,t,ttcagtacttgtcccatgtgggc,22
NC_037345.1,NC_032667.1,59493880,59363432,59363433,A,AC,1
NC_037345.1,NC_032667.1,59500896,59370460,59370462,T,TAC,2
NC_037345.1,NC_032667.1,59531572,59410173,59410174,t,ta,1
NC_037345.1,NC_032667.1,59531802,59410404,59410405,t,ta,1
NC_037345.1,NC_032667.1,59543889,59422891,59422894,G,GACC,3
NC_037345.1,NC_032667.1,59545242,59424246,59424247,A,AC,1
NC_037345.1,NC_032667.1,59545464,59424468,59424469,A,AG,1
NC_037345.1,NC_032667.1,59552636,59431645,59431647,C,CTA,2
NC_037345.1,NC_032667.1,59679588,59641732,59641733,t,ta,1
NC_037345.1,NC_032667.1,59775966,59737059,59737060,G,GC,1
NC_037345.1,NC_032667.1,59777327,59738420,59738437,A,ATCACACTGTGGATACTT,17
NC_037345.1,NC_032667.1,59798440,59758116,59758117,a,ac,1
NC_037345.1,NC_032667.1,59812887,59772562,59772563,g,ga,1
NC_037345.1,NC_032667.1,59817740,59777416,59777426,t,tatataNNtaa,10
NC_037345.1,NC_032667.1,59817769,59777455,59777456,g,gt,1
NC_037345.1,NC_032667.1,59818830,59778524,59778525,C,CA,1
NC_037345.1,NC_032667.1,59818857,59778552,59778554,C,CTT,2
NC_037345.1,NC_032667.1,59819829,59779524,59779526,C,CAT,2
NC_037345.1,NC_032667.1,59820055,59779752,59779753,C,CA,1
NC_037345.1,NC_032667.1,59820337,59780035,59780038,t,tagc,3
NC_037345.1,NC_032667.1,59849981,59868221,59868222,A,AC,1
NC_037345.1,NC_032667.1,59849999,59868240,59868242,A,AAG,2
NC_037345.1,NC_032667.1,59891033,59908808,59908809,c,ca,1
NC_037345.1,NC_032667.1,59892370,59910147,59910149,c,cag,2
NC_037345.1,NC_032667.1,59939983,60017225,60017226,G,GT,1
NC_037345.1,NC_032667.1,59956779,60034020,60034022,T,TAC,2
NC_037345.1,NC_032667.1,59962762,60040006,60040007,G,GA,1
NC_037345.1,NC_032667.1,59970822,60048165,60048166,A,AC,1
NC_037345.1,NC_032667.1,59978013,60055351,60055358,c,ccacccca,7
NC_037345.1,NC_032667.1,59979091,60056438,60056439,G,GA,1
NC_037345.1,NC_032667.1,60003076,60080165,60080166,A,AG,1
NC_037345.1,NC_032667.1,60005855,60082946,60082947,a,aR,1
NC_037345.1,NC_032667.1,60015347,60092424,60092425,G,GC,1
NC_037345.1,NC_032667.1,60037817,60114894,60114895,A,AG,1
NC_037345.1,NC_032667.1,60067434,60144513,60144514,c,ct,1
NC_037345.1,NC_032667.1,60098241,60175319,60175322,a,aaat,3
NC_037345.1,NC_032667.1,60159429,60262978,60262979,t,ta,1
NC_037345.1,NC_032667.1,60169775,60273730,60273733,a,aaac,3
NC_037345.1,NC_032667.1,60174891,60278879,60278881,T,TGC,2
NC_037345.1,NC_032667.1,60175081,60279067,60279082,C,CGGGGTCTGCTGTTCT,15
NC_037345.1,NC_032667.1,60178710,60282707,60282708,t,tc,1
NC_037345.1,NC_032667.1,60181556,60285555,60285556,C,CM,1
NC_037345.1,NC_032667.1,60222209,60294587,60294597,t,tactgaactga,10
NC_037345.1,NC_032667.1,60223406,60295776,60295777,a,at,1
NC_037345.1,NC_032667.1,60223453,60295824,60295825,t,tc,1
NC_037345.1,NC_032667.1,60223862,60296231,60296232,c,ct,1
NC_037345.1,NC_032667.1,60224471,60296833,60296834,C,CA,1
NC_037345.1,NC_032667.1,60224605,60296967,60296968,a,at,1
NC_037345.1,NC_032667.1,60224811,60297173,60297174,G,GC,1
NC_037345.1,NC_032667.1,60224832,60297195,60297196,t,ta,1
NC_037345.1,NC_032667.1,60224872,60297236,60297237,a,ac,1
NC_037345.1,NC_032667.1,60225588,60297933,60297934,A,AT,1
NC_037345.1,NC_032667.1,60225661,60298005,60298006,A,AT,1
NC_037345.1,NC_032667.1,60225834,60298179,60298180,T,TG,1
NC_037345.1,NC_032667.1,60225840,60298186,60298187,A,AT,1
NC_037345.1,NC_032667.1,60226260,60298605,60298606,G,GA,1
NC_037345.1,NC_032667.1,60226268,60298614,60298615,C,CT,1
NC_037345.1,NC_032667.1,60226371,60298717,60298718,A,AG,1
NC_037345.1,NC_032667.1,60226378,60298725,60298726,A,AT,1
NC_037345.1,NC_032667.1,60227184,60299532,60299533,A,AT,1
NC_037345.1,NC_032667.1,60227995,60300342,60300343,a,ac,1
NC_037345.1,NC_032667.1,60227998,60300346,60300348,t,taa,2
NC_037345.1,NC_032667.1,60234433,60306780,60306781,G,GA,1
NC_037345.1,NC_032667.1,60236798,60309147,60309148,g,gt,1
NC_037345.1,NC_032667.1,60261466,60333979,60333980,g,ga,1
NC_037345.1,NC_032667.1,60276190,60358493,60358497,t,taaaa,4
NC_037345.1,NC_032667.1,60298057,60424572,60424573,A,AC,1
NC_037345.1,NC_032667.1,60397007,60435557,60435558,A,AC,1
NC_037345.1,NC_032667.1,60397139,60435690,60435691,C,CT,1
NC_037345.1,NC_032667.1,60397201,60435754,60435755,T,TC,1
NC_037345.1,NC_032667.1,60405936,60394197,60394201,c,cacca,4
NC_037345.1,NC_032667.1,60430391,60415912,60415913,T,TC,1
NC_037345.1,NC_032667.1,60430698,60416214,60416240,g,gaaaatgaaaaaaaaaaaaagaaaaga,26
NC_037345.1,NC_032667.1,60431324,60416866,60416868,A,ATG,2
NC_037345.1,NC_032667.1,60432616,60418160,60418161,A,AT,1
NC_037345.1,NC_032667.1,60433008,60418553,60418554,A,AG,1
NC_037345.1,NC_032667.1,60433012,60418558,60418560,T,TGA,2
NC_037345.1,NC_032667.1,60437114,60422660,60422661,c,ca,1
NC_037345.1,NC_032667.1,60442952,60437007,60437009,t,tNN,2
NC_037345.1,NC_032667.1,60444269,60438326,60438329,T,TACA,3
NC_037345.1,NC_032667.1,60445753,60439815,60439820,a,attcag,5
NC_037345.1,NC_032667.1,60459968,60454030,60454031,T,TG,1
NC_037345.1,NC_032667.1,60462526,60475347,60475348,t,ta,1
NC_037345.1,NC_032667.1,60463038,60475860,60475861,g,gc,1
NC_037345.1,NC_032667.1,60470465,60483334,60483335,t,tc,1
NC_037345.1,NC_032667.1,60470620,60483486,60483487,A,AT,1
NC_037345.1,NC_032667.1,60471432,60484299,60484300,C,CT,1
NC_037345.1,NC_032667.1,60471625,60484493,60484494,t,tc,1
NC_037345.1,NC_032667.1,60472204,60485052,60485054,a,agt,2
NC_037345.1,NC_032667.1,60472580,60485432,60485433,G,GA,1
NC_037345.1,NC_032667.1,60474928,60487810,60487816,T,TTAAATA,6
NC_037345.1,NC_032667.1,60476974,60489862,60489863,C,CA,1
NC_037345.1,NC_032667.1,60483206,60496095,60496096,C,CA,1
NC_037345.1,NC_032667.1,60484245,60497138,60497139,C,CG,1
NC_037345.1,NC_032667.1,60543101,60719851,60719854,A,ATTC,3
NC_037345.1,NC_032667.1,60548705,60725451,60725452,c,ca,1
NC_037345.1,NC_032667.1,60558188,60734938,60734940,C,CTA,2
NC_037345.1,NC_032667.1,60561009,60737761,60737764,T,TTTG,3
NC_037345.1,NC_032667.1,60579953,60756702,60756706,T,TAGTC,4
NC_037345.1,NC_032667.1,60584189,60760956,60760957,G,GR,1
NC_037345.1,NC_032667.1,60592037,60768876,60768877,C,CA,1
NC_037345.1,NC_032667.1,60592108,60768948,60768951,C,CCTT,3
NC_037345.1,NC_032667.1,60593710,60770553,60770554,g,gt,1
NC_037345.1,NC_032667.1,60608924,60785771,60785772,A,AN,1
NC_037345.1,NC_032667.1,60609739,60786587,60786588,A,AG,1
NC_037345.1,NC_032667.1,60609739,60814893,60814894,A,AG,1
NC_037345.1,NC_032667.1,60609831,60814986,60814987,C,CT,1
NC_037345.1,NC_032667.1,60610753,60815901,60815902,c,ca,1
NC_037345.1,NC_032667.1,60611387,60788235,60788237,T,TGA,2
NC_037345.1,NC_032667.1,60613225,60818372,60818373,G,GC,1
NC_037345.1,NC_032667.1,60615814,60820962,60820963,C,CA,1
NC_037345.1,NC_032667.1,60616764,60821922,60821927,T,TACTCA,5
NC_037345.1,NC_032667.1,60622386,60827543,60827544,T,TC,1
NC_037345.1,NC_032667.1,60623025,60828181,60828182,T,TG,1
NC_037345.1,NC_032667.1,60626106,60831261,60831262,C,CT,1
NC_037345.1,NC_032667.1,60654746,60836733,60836734,T,TA,1
NC_037345.1,NC_032667.1,60654766,60836754,60836755,G,GA,1
NC_037345.1,NC_032667.1,60655710,60837698,60837701,t,ttta,3
NC_037345.1,NC_032667.1,60668444,60850436,60850445,C,CCAANNNNNN,9
NC_037345.1,NC_032667.1,60676599,60858597,60858598,T,TY,1
NC_037345.1,NC_032667.1,60678631,60861049,60861050,C,CG,1
NC_037345.1,NC_032667.1,60716521,60898949,60898956,c,ctgctaag,7
NC_037345.1,NC_032667.1,60759038,60945050,60945051,t,ta,1
NC_037345.1,NC_032667.1,60841361,61059700,61059701,A,AW,1
NC_037345.1,NC_032667.1,60856082,61074449,61074451,a,aat,2
NC_037345.1,NC_032667.1,60863195,61081568,61081570,a,acc,2
NC_037345.1,NC_032667.1,60872259,61095259,61095260,T,TG,1
NC_037345.1,NC_032667.1,60872430,61095431,61095432,c,ct,1
NC_037345.1,NC_032667.1,60873816,61096816,61096817,A,AT,1
NC_037345.1,NC_032667.1,60881222,61104524,61104525,c,ca,1
NC_037345.1,NC_032667.1,60890261,61113560,61113562,T,TTC,2
NC_037345.1,NC_032667.1,60900706,61127767,61127768,G,GC,1
NC_037345.1,NC_032667.1,60901205,61128262,61128264,a,aag,2
NC_037345.1,NC_032667.1,60909389,61136443,61136469,a,acacagcCTCCTCTCATTCTAAGTCTW,26
NC_037345.1,NC_032667.1,60909596,61136677,61136678,a,ag,1
NC_037345.1,NC_032667.1,60914420,61141504,61141506,g,gaa,2
NC_037345.1,NC_032667.1,60914902,61141988,61141989,c,ca,1
NC_037345.1,NC_032667.1,60915617,61142704,61142705,t,tg,1
NC_037345.1,NC_032667.1,60916164,61143252,61143253,t,ta,1
NC_037345.1,NC_032667.1,60916188,61143277,61143279,a,aat,2
NC_037345.1,NC_032667.1,60930152,61157192,61157194,g,ggt,2
NC_037345.1,NC_032667.1,60945426,61172474,61172475,t,tc,1
NC_037345.1,NC_032667.1,60945708,61172757,61172759,A,AAG,2
NC_037345.1,NC_032667.1,60946441,61173491,61173493,c,ctg,2
NC_037345.1,NC_032667.1,60948514,61177318,61177319,A,AG,1
NC_037345.1,NC_032667.1,60949130,61177937,61177938,T,TG,1
NC_037345.1,NC_032667.1,60952729,61181534,61181535,g,gt,1
NC_037345.1,NC_032667.1,60966270,61196777,61196778,T,TG,1
NC_037345.1,NC_032667.1,60974088,61205843,61205885,t,tttaccatctgagctaccagggaagccttggagaTATTACTGA,42
NC_037345.1,NC_032667.1,60974135,61205932,61205934,t,ttc,2
NC_037345.1,NC_032667.1,60978224,61210019,61210020,t,ta,1
NC_037345.1,NC_032667.1,60983546,61215338,61215339,A,AR,1
NC_037345.1,NC_032667.1,60998914,61230711,61230715,t,tgttg,4
NC_037345.1,NC_032667.1,60999048,61230848,61230849,C,CY,1
NC_037345.1,NC_032667.1,61002343,61234142,61234143,a,at,1
NC_037345.1,NC_032667.1,61014154,61248948,61248950,c,cag,2
NC_037345.1,NC_032667.1,61020837,61257022,61257030,c,ccttttttt,8
NC_037345.1,NC_032667.1,61023222,61259415,61259416,A,AG,1
NC_037345.1,NC_032667.1,61023327,61259521,61259522,C,CT,1
NC_037345.1,NC_032667.1,61024822,61261015,61261016,t,ta,1
NC_037345.1,NC_032667.1,61025268,61261462,61261463,t,tc,1
NC_037345.1,NC_032667.1,61025288,61261483,61261484,t,tg,1
NC_037345.1,NC_032667.1,61123208,61353262,61353263,G,GT,1
NC_037345.1,NC_032667.1,61123353,61353408,61353409,G,GT,1
NC_037345.1,NC_032667.1,61123497,61353553,61353555,T,TAC,2
NC_037345.1,NC_032667.1,61123725,61353782,61353783,C,CA,1
NC_037345.1,NC_032667.1,61123923,61353980,61353981,g,ga,1
NC_037345.1,NC_032667.1,61124139,61354197,61354198,g,gc,1
NC_037345.1,NC_032667.1,61124176,61354235,61354236,g,ga,1
NC_037345.1,NC_032667.1,61124346,61354403,61354404,g,ga,1
NC_037345.1,NC_032667.1,61124452,61354510,61354511,a,at,1
NC_037345.1,NC_032667.1,61125031,61355086,61355087,a,at,1
NC_037345.1,NC_032667.1,61125121,61355177,61355178,t,tg,1
NC_037345.1,NC_032667.1,61125169,61355226,61355227,a,at,1
NC_037345.1,NC_032667.1,61125939,61355994,61355995,t,ta,1
NC_037345.1,NC_032667.1,61127391,61357445,61357447,a,aat,2
NC_037345.1,NC_032667.1,61127953,61358014,61358017,t,taaa,3
NC_037345.1,NC_032667.1,61129278,61359342,61359343,C,CA,1
NC_037345.1,NC_032667.1,61134562,61364632,61364633,T,TG,1
NC_037345.1,NC_032667.1,61134758,61364829,61364830,C,CM,1
NC_037345.1,NC_032667.1,61143736,61374428,61374430,g,gtc,2
NC_037345.1,NC_032667.1,61144417,61375111,61375112,c,ct,1
NC_037345.1,NC_032667.1,61145304,61375999,61376000,t,tg,1
NC_037345.1,NC_032667.1,61176196,61406685,61406686,C,CT,1
NC_037345.1,NC_032667.1,61177297,61407787,61407788,T,TC,1
NC_037345.1,NC_032667.1,61177997,61408779,61408781,A,AAC,2
NC_037345.1,NC_032667.1,61178023,61408807,61408808,A,AG,1
NC_037345.1,NC_032667.1,61193549,61424356,61424357,g,ga,1
NC_037345.1,NC_032667.1,61196269,61427081,61427092,c,cacacacacaca,11
NC_037345.1,NC_032667.1,61197324,61428144,61428146,t,tta,2
NC_037345.1,NC_032667.1,61201334,61432416,61432417,C,CA,1
NC_037345.1,NC_032667.1,61210153,61441233,61441234,a,at,1
NC_037345.1,NC_032667.1,61216649,61453333,61453334,t,tg,1
NC_037345.1,NC_032667.1,61219700,61456389,61456391,c,caa,2
NC_037345.1,NC_032667.1,61224902,61461591,61461592,A,AM,1
NC_037345.1,NC_032667.1,61231959,61468650,61468651,G,GT,1
NC_037345.1,NC_032667.1,61236436,61473126,61473127,t,tc,1
NC_037345.1,NC_032667.1,61244031,61478866,61478867,T,TA,1
NC_037345.1,NC_032667.1,61247024,61481860,61481861,a,at,1
NC_037345.1,NC_032667.1,61263899,61498746,61498747,c,ca,1
NC_037345.1,NC_032667.1,61291617,61526464,61526465,a,aN,1
NC_037345.1,NC_032667.1,61310613,61545321,61545324,t,tgaa,3
NC_037345.1,NC_032667.1,61310921,61545632,61545637,t,ttaaaa,5
NC_037345.1,NC_032667.1,61322368,61556202,61556203,A,AM,1
NC_037345.1,NC_032667.1,61346539,61580359,61580360,C,CG,1
NC_037345.1,NC_032667.1,61353287,61587132,61587133,C,CM,1
NC_037345.1,NC_032667.1,61353890,61587735,61587736,a,ag,1
NC_037345.1,NC_032667.1,61357174,61591020,61591021,C,CT,1
NC_037345.1,NC_032667.1,61368289,61602137,61602138,A,AG,1
NC_037345.1,NC_032667.1,61382474,61616322,61616323,T,TC,1
NC_037345.1,NC_032667.1,61402834,61636684,61636685,a,ac,1
NC_037345.1,NC_032667.1,61476227,61855987,61855990,T,TCTG,3
NC_037345.1,NC_032667.1,61482944,61862489,61862490,a,ac,1
NC_037345.1,NC_032667.1,61485229,61864819,61864822,G,GGCT,3
NC_037345.1,NC_032667.1,61486179,61865774,61865775,T,TA,1
NC_037345.1,NC_032667.1,61499391,61877877,61877878,a,at,1
NC_037345.1,NC_032667.1,61533956,61913987,61913988,A,AT,1
NC_037345.1,NC_032667.1,61558062,61938098,61938099,a,ac,1
NC_037345.1,NC_032667.1,61564668,61944711,61944713,a,aat,2
NC_037345.1,NC_032667.1,61599697,61979394,61979396,a,att,2
NC_037345.1,NC_032667.1,61637350,62015198,62015618,G,GCAGAAACTATCTGTTNNNNNNNNNNNNNNNNNNNNNNNNNNNNNNNNNNNNNNNNNNNNNNNNNNNNNNNNNNNNNNNNNNNNNNNNNNNNNNNNNNNNNNNNNNNNNNNNNNNNNNNNNNNNNNNNNNNNNNNNNNNNNNNNNNNNNNNNNNNNNNNNNNNNNNNNNNNNNNNNNNNNNNNNNNNNNNNNNNNNNNNNNNNNNNNNNNNNNNNNNNNNNNNNNNNNNNNNNNNNNNNNNNNNNNNNNNNNNNNNNNNNNNNNNNNNNNNNNNNNNNNNNNNNNNNNNNNNNNNNNNNNNNNNNNNNNNNNNNNNNNNNNNNNNNNNNNNNNNNNNNNNNNNNNNNNNNNNNNNNNNNNNNNNNNNNNNNNNNNNNNNNNNNNNNNNNNNNNNNNNNNNNNNNNNNNNNNNNNNNNNNNN,420
NC_037345.1,NC_032667.1,61680650,62058370,62058404,A,ACGAAACGAANNNNNNNNNNNNNNNNNNNNNNNNN,34
NC_037345.1,NC_032667.1,61707238,62085010,62085012,T,TTG,2
NC_037345.1,NC_032667.1,61822664,62200537,62200538,t,tY,1
NC_037345.1,NC_032667.1,61831589,62209216,62209217,T,TC,1
NC_037345.1,NC_032667.1,61853087,62230717,62230718,T,TC,1
NC_037345.1,NC_032667.1,61911894,62310919,62310921,g,gga,2
NC_037345.1,NC_032667.1,61919344,62318371,62318373,a,atg,2
NC_037345.1,NC_032667.1,61929925,62328954,62328955,C,CN,1
NC_037345.1,NC_032667.1,61964706,62363602,62363603,c,ct,1
NC_037345.1,NC_032667.1,61999010,62398098,62398099,G,GR,1
NC_037345.1,NC_032667.1,62028550,62427563,62427583,C,CCTTTCCCTCTGGACAAGCCT,20
NC_037345.1,NC_032667.1,62049945,62446192,62446193,A,AT,1
NC_037345.1,NC_032667.1,62106922,62502140,62502141,C,CA,1
NC_037345.1,NC_032667.1,62143059,62537978,62537979,T,TG,1
NC_037345.1,NC_032667.1,62181417,62607270,62607272,C,CCT,2
NC_037345.1,NC_032667.1,62181423,62607278,62607279,A,AG,1
NC_037345.1,NC_032667.1,62207168,62632996,62632999,G,GCYC,3
NC_037345.1,NC_032667.1,62228137,62653933,62653935,a,aNN,2
NC_037345.1,NC_032667.1,62294341,62719219,62719220,C,CA,1
NC_037345.1,NC_032667.1,62327172,62752059,62752061,A,ACT,2
NC_037345.1,NC_032667.1,62335397,62760361,62760364,c,ccga,3
NC_037345.1,NC_032667.1,62341456,62766418,62766419,G,GT,1
NC_037345.1,NC_032667.1,62756096,62796374,62796375,T,TC,1
NC_037345.1,NC_032667.1,62761737,62802016,62802060,T,TTTCCCTAACTRTAAACCTAAGAGGATTCAGACAGATCTTGCTGC,44
NC_037345.1,NC_032667.1,62761911,62802234,62802235,T,TY,1
NC_037345.1,NC_032667.1,62763064,62803388,62803389,A,AT,1
NC_037345.1,NC_032667.1,62766081,62806404,62806405,T,TC,1
NC_037345.1,NC_032667.1,62769107,62809425,62809426,C,CT,1
NC_037345.1,NC_032667.1,62769570,62809889,62809893,c,cttga,4
NC_037345.1,NC_032667.1,62770652,62810975,62810981,g,ggctcta,6
NC_037345.1,NC_032667.1,62774657,62814989,62814990,g,ga,1
NC_037345.1,NC_032667.1,62786117,62826406,62826407,G,GC,1
NC_037345.1,NC_032667.1,62787366,62827656,62827657,C,CT,1
NC_037345.1,NC_032667.1,62788044,62828335,62828336,c,ca,1
NC_037345.1,NC_032667.1,62789231,62829522,62829523,c,ct,1
NC_037345.1,NC_032667.1,62792377,62832667,62832712,t,ttttgtatttctgtggtatcaatTGTTATTTCTCTTCTCTCATTTC,45
NC_037345.1,NC_032667.1,62801853,62842201,62842202,G,GA,1
NC_037345.1,NC_032667.1,62805916,62846275,62846277,G,GAA,2
NC_037345.1,NC_032667.1,62812266,62852607,62852608,C,CA,1
NC_037345.1,NC_032667.1,62815670,62856012,62856022,C,CACCCTCACAA,10
NC_037345.1,NC_032667.1,62818267,62858616,62858617,T,TG,1
NC_037345.1,NC_032667.1,62819351,62859699,62859700,C,CT,1
NC_037345.1,NC_032667.1,62819536,62859885,62859886,G,GA,1
NC_037345.1,NC_032667.1,62819605,62859955,62859956,A,AG,1
NC_037345.1,NC_032667.1,62822418,62862768,62862769,G,GA,1
NC_037345.1,NC_032667.1,62833510,62874189,62874191,T,TTG,2
NC_037345.1,NC_032667.1,62844686,62885363,62885364,C,CT,1
NC_037345.1,NC_032667.1,62845514,62886192,62886195,a,atat,3
NC_037345.1,NC_032667.1,62847780,62888469,62888470,A,AC,1
NC_037345.1,NC_032667.1,62854010,62895437,62895439,a,act,2
NC_037345.1,NC_032667.1,62854157,62895586,62895587,t,tg,1
NC_037345.1,NC_032667.1,62854243,62895673,62895675,c,cat,2
NC_037345.1,NC_032667.1,62892293,62933340,62933352,c,cacaaagagttgg,12
NC_037345.1,NC_032667.1,62896630,62937702,62937703,c,ca,1
NC_037345.1,NC_032667.1,62928977,62970232,62970233,T,TY,1
NC_037345.1,NC_032667.1,62930246,62971502,62971503,g,gt,1
NC_037345.1,NC_032667.1,62948369,62989622,62989623,g,gt,1
NC_037345.1,NC_032667.1,62954507,62995765,62995785,G,GCACCGCCCCGCCCCGCACAR,20
NC_037345.1,NC_032667.1,62978701,63076462,63076463,A,AC,1
NC_037345.1,NC_032667.1,62980060,63077816,63077817,C,CA,1
NC_037345.1,NC_032667.1,62981182,63078946,63078947,T,TA,1
NC_037345.1,NC_032667.1,62981182,63022489,63022490,T,TA,1
NC_037345.1,NC_032667.1,62981297,63079060,63079061,A,AG,1
NC_037345.1,NC_032667.1,62981297,63022603,63022604,A,AG,1
NC_037345.1,NC_032667.1,62981350,63079114,63079115,t,tc,1
NC_037345.1,NC_032667.1,63158899,63045883,63045884,G,GC,1
NC_037345.1,NC_032667.1,63158953,63045940,63045941,G,GK,1
NC_037345.1,NC_032667.1,63158983,63045971,63045973,A,ACC,2
NC_037345.1,NC_032667.1,63159281,63046270,63046271,C,CA,1
NC_037345.1,NC_032667.1,63159290,63046280,63046281,G,GA,1
NC_037345.1,NC_032667.1,63159911,63046900,63046901,A,AC,1
NC_037345.1,NC_032667.1,63163270,63050259,63050260,A,AT,1
NC_037345.1,NC_032667.1,63166810,63053800,63053802,c,cag,2
NC_037345.1,NC_032667.1,63417898,63545828,63545829,A,AM,1
NC_037345.1,NC_032667.1,63437413,63565010,63565011,a,ac,1
NC_037345.1,NC_032667.1,63443187,63570612,63570618,a,aaaaaac,6
NC_037345.1,NC_032667.1,63448408,63575848,63575849,a,at,1
NC_037345.1,NC_032667.1,63448802,63576254,63576258,a,aaaac,4
NC_037345.1,NC_032667.1,63450271,63577727,63577728,t,tg,1
NC_037345.1,NC_032667.1,63473198,63600599,63600600,a,at,1
NC_037345.1,NC_032667.1,63590161,63660157,63660159,T,TCC,2
NC_037345.1,NC_032667.1,63590364,63660362,63660365,T,TGAA,3
NC_037345.1,NC_032667.1,63591032,63661033,63661034,T,TA,1
NC_037345.1,NC_032667.1,63591419,63661422,63661423,A,AC,1
NC_037345.1,NC_032667.1,63594320,63664326,63664328,c,cct,2
NC_037345.1,NC_032667.1,63595281,63665288,63665290,A,AAC,2
NC_037345.1,NC_032667.1,63595347,63665356,63665357,A,AT,1
NC_037345.1,NC_032667.1,63597102,63667113,63667114,C,CT,1
NC_037345.1,NC_032667.1,63597411,63667419,63667423,g,gtttt,4
NC_037345.1,NC_032667.1,63597446,63667458,63667459,A,AG,1
NC_037345.1,NC_032667.1,63597839,63667852,63667853,G,GA,1
NC_037345.1,NC_032667.1,63601154,63671168,63671169,C,CA,1
NC_037345.1,NC_032667.1,63680759,63647185,63647186,G,GA,1
NC_037345.1,NC_032667.1,63680759,63678685,63678686,G,GA,1
NC_037345.1,NC_032667.1,63681156,63679081,63679082,c,cg,1
NC_037345.1,NC_032667.1,63707338,63705271,63705273,A,AAG,2
NC_037345.1,NC_032667.1,63788736,63785395,63785397,g,gcc,2
NC_037345.1,NC_032667.1,63788765,63785426,63785435,c,ccactgtttt,9
NC_037345.1,NC_032667.1,63791401,63788078,63788079,A,AT,1
NC_037345.1,NC_032667.1,64023763,64056380,64056381,T,TC,1
NC_037345.1,NC_032667.1,64058181,64101494,64101495,a,ag,1
NC_037345.1,NC_032667.1,64058385,64101703,64101704,G,GT,1
NC_037345.1,NC_032667.1,64105385,64164993,64164994,T,TA,1
NC_037345.1,NC_032667.1,64200286,64259878,64259894,c,ctgaatattcattggaa,16
NC_037345.1,NC_032667.1,64230987,64290634,64290635,G,GC,1
NC_037345.1,NC_032667.1,64287383,64344516,64344517,g,gt,1
NC_037345.1,NC_032667.1,64585390,64653501,64653502,A,AR,1
NC_037345.1,NC_032667.1,64587053,64655221,64655223,T,TTC,2
NC_037345.1,NC_032667.1,64600947,64669109,64669110,G,GR,1
NC_037345.1,NC_032667.1,64603409,64671570,64671571,T,TC,1
NC_037345.1,NC_032667.1,64625562,64693726,64693728,a,act,2
NC_037345.1,NC_032667.1,64635547,64703715,64703716,t,tc,1
NC_037345.1,NC_032667.1,64636492,64704660,64704661,G,GC,1
NC_037345.1,NC_032667.1,64644949,64713118,64713119,C,CA,1
NC_037345.1,NC_032667.1,64652513,64720681,64720682,C,CA,1
NC_037345.1,NC_032667.1,64654019,64722189,64722190,C,CM,1
NC_037345.1,NC_032667.1,64692171,64805971,64805974,t,tctc,3
NC_037345.1,NC_032667.1,64692203,64806006,64806007,t,tc,1
NC_037345.1,NC_032667.1,64712120,64825923,64825924,a,at,1
NC_037345.1,NC_032667.1,64715937,64829741,64829742,c,ca,1
NC_037345.1,NC_032667.1,64723068,64836871,64836872,T,TA,1
NC_037345.1,NC_032667.1,64751656,64865712,64865713,a,at,1
NC_037345.1,NC_032667.1,64755979,64871740,64871741,a,aM,1
NC_037345.1,NC_032667.1,64757241,64873001,64873002,A,AG,1
NC_037345.1,NC_032667.1,64760766,64878371,64878372,a,at,1
NC_037345.1,NC_032667.1,64762057,64879663,64879666,c,cagg,3
NC_037345.1,NC_032667.1,64779744,64897349,64897352,t,tata,3
NC_037345.1,NC_032667.1,64784532,64902140,64902141,C,CY,1
NC_037345.1,NC_032667.1,64790452,64908061,64908063,a,aag,2
NC_037345.1,NC_032667.1,64808728,64931457,64931458,G,GT,1
NC_037345.1,NC_032667.1,64809751,64932481,64932483,G,GAA,2
NC_037345.1,NC_032667.1,64810044,64932776,64932778,C,CAT,2
NC_037345.1,NC_032667.1,64812188,64934929,64934930,A,AG,1
NC_037345.1,NC_032667.1,64835084,64957826,64957827,a,ac,1
NC_037345.1,NC_032667.1,64836286,64959028,64959030,t,tgg,2
NC_037345.1,NC_032667.1,64912366,65039002,65039006,a,agagt,4
NC_037345.1,NC_032667.1,64913375,65040015,65040018,C,CTTS,3
NC_037345.1,NC_032667.1,64931458,65058130,65058134,C,CCAGA,4
NC_037345.1,NC_032667.1,64946371,65073055,65073056,G,GT,1
NC_037345.1,NC_032667.1,64969114,65095802,65095803,A,AG,1
NC_037345.1,NC_032667.1,64972593,65099294,65099295,g,gR,1
NC_037345.1,NC_032667.1,64973481,65100183,65100184,C,CM,1
NC_037345.1,NC_032667.1,64977681,65104381,65104441,T,TCAGCCANNNNNNNNNNNNNNNNNNNNNNNNNNNNNNNNNNNNNNNNNNNNNNNNNNNNNN,60
NC_037345.1,NC_032667.1,65003285,65127883,65127884,G,GA,1
NC_037345.1,NC_032667.1,65056095,65180832,65180833,t,tc,1
NC_037345.1,NC_032667.1,65060382,65185119,65185120,a,ag,1
NC_037345.1,NC_032667.1,65067790,65192523,65192542,C,CCTCGGAGCGGGCGGAGGGG,19
NC_037345.1,NC_032667.1,65078421,65201528,65201554,A,ATCCGGTAGGCCTCCTCTATCTTGATG,26
NC_037345.1,NC_032667.1,65079027,65202159,65202160,T,TA,1
NC_037345.1,NC_032667.1,65080107,65203240,65203241,A,AG,1
NC_037345.1,NC_032667.1,65115229,65238360,65238361,g,ga,1
NC_037345.1,NC_032667.1,65124542,65247673,65247674,a,at,1
NC_037345.1,NC_032667.1,65128505,65251647,65251648,g,ga,1
NC_037345.1,NC_032667.1,65129915,65253061,65253062,G,GN,1
NC_037345.1,NC_032667.1,65134986,65258132,65258133,T,TC,1
NC_037345.1,NC_032667.1,65136217,65259364,65259365,c,ca,1
NC_037345.1,NC_032667.1,65159323,65282860,65282861,A,AT,1
NC_037345.1,NC_032667.1,65173862,65297396,65297397,g,ga,1
NC_037345.1,NC_032667.1,65216848,65340355,65340358,T,TTGC,3
NC_037345.1,NC_032667.1,65218228,65341690,65341691,A,AC,1
NC_037345.1,NC_032667.1,65236087,65359196,65359197,g,gt,1
NC_037345.1,NC_032667.1,65256407,65379526,65379527,C,CT,1
NC_037345.1,NC_032667.1,65257082,65380202,65380203,C,CA,1
NC_037345.1,NC_032667.1,65287726,65416761,65416762,g,gc,1
NC_037345.1,NC_032667.1,65296098,65425133,65425134,g,ga,1
NC_037345.1,NC_032667.1,65419974,65548818,65548821,C,CCCA,3
NC_037345.1,NC_032667.1,65439108,65568138,65568142,G,GNNNN,4
NC_037345.1,NC_032667.1,65484915,65613947,65613949,g,gga,2
NC_037345.1,NC_032667.1,65485688,65614720,65614722,G,GAA,2
NC_037345.1,NC_032667.1,65485852,65614886,65614887,G,GA,1
NC_037345.1,NC_032667.1,65496639,65625685,65625686,G,GY,1
NC_037345.1,NC_032667.1,65497857,65626915,65626916,g,gt,1
NC_037345.1,NC_032667.1,65500396,65629453,65629454,T,TK,1
NC_037345.1,NC_032667.1,65512233,65641295,65641299,c,ccttt,4
NC_037345.1,NC_032667.1,65523507,65652578,65652591,c,ctcttcactttcat,13
NC_037345.1,NC_032667.1,65523579,65652663,65652664,t,tg,1
NC_037345.1,NC_032667.1,65525152,65654769,65654770,T,TA,1
NC_037345.1,NC_032667.1,65530196,65659811,65659812,a,at,1
NC_037345.1,NC_032667.1,65565513,65695144,65695145,C,CY,1
NC_037345.1,NC_032667.1,65567195,65696827,65696836,C,CGNNNNNNNN,9
NC_037345.1,NC_032667.1,65601262,65730901,65730925,G,GCCGAtatcctgcccccctcccccK,24
NC_037345.1,NC_032667.1,65604999,65734662,65734663,c,ct,1
NC_037345.1,NC_032667.1,65632700,65762819,65762820,t,ta,1
NC_037345.1,NC_032667.1,65634428,65764747,65764748,g,gc,1
NC_037345.1,NC_032667.1,65637733,65769533,65769534,T,TG,1
NC_037345.1,NC_032667.1,65724440,65855245,65855267,G,GCCACACTTATTACAAAATCNNN,22
NC_037345.1,NC_032667.1,65724479,65855306,65855307,T,TG,1
