Reference ID,Query ID,Reference POS,Query POS,Query END,REF,ALT,SVLEN
NC_037339.1,NC_032661.1,1613658,69801356,69801357,a,ac,1
NC_037339.1,NC_032661.1,2104294,214114,214133,A,AACGTCTTTTTCTGTCCTGT,19
NC_037339.1,NC_032661.1,2104904,214743,214744,g,ga,1
NC_037339.1,NC_032661.1,2121413,231254,231262,g,gcacacaca,8
NC_037339.1,NC_032661.1,2143484,253331,253336,G,GNNNNN,5
NC_037339.1,NC_032661.1,2164790,275490,275491,T,TG,1
NC_037339.1,NC_032661.1,2165717,276418,276427,a,acactgtttc,9
NC_037339.1,NC_032661.1,2167920,278637,278638,t,tc,1
NC_037339.1,NC_032661.1,2193620,304335,304337,A,ACT,2
NC_037339.1,NC_032661.1,2230169,340895,340896,T,TG,1
NC_037339.1,NC_032661.1,2231718,342445,342446,a,at,1
NC_037339.1,NC_032661.1,2233875,344603,344604,t,tc,1
NC_037339.1,NC_032661.1,2238587,349723,349724,G,GT,1
NC_037339.1,NC_032661.1,2239054,350190,350191,C,CY,1
NC_037339.1,NC_032661.1,2240172,351309,351310,A,AC,1
NC_037339.1,NC_032661.1,2241515,352652,352656,a,atttt,4
NC_037339.1,NC_032661.1,2258226,369370,369376,C,CATGTTT,6
NC_037339.1,NC_032661.1,2261454,372608,372610,C,CTG,2
NC_037339.1,NC_032661.1,2262318,373478,373481,T,TTAA,3
NC_037339.1,NC_032661.1,2272205,383365,383366,t,tc,1
NC_037339.1,NC_032661.1,2331183,442348,442354,G,GGTGCCA,6
NC_037339.1,NC_032661.1,2401397,512571,512572,t,tg,1
NC_037339.1,NC_032661.1,2452919,564266,564267,T,TK,1
NC_037339.1,NC_032661.1,2454058,565406,565407,C,CY,1
NC_037339.1,NC_032661.1,2455704,567028,567030,T,TTG,2
NC_037339.1,NC_032661.1,2457148,568474,568475,g,ga,1
NC_037339.1,NC_032661.1,2468445,579770,579771,G,GK,1
NC_037339.1,NC_032661.1,2471802,583127,583135,G,GACTCTCGA,8
NC_037339.1,NC_032661.1,2490117,608043,608044,A,AM,1
NC_037339.1,NC_032661.1,2493216,611142,611143,G,GA,1
NC_037339.1,NC_032661.1,2499551,617478,617479,C,CY,1
NC_037339.1,NC_032661.1,2500167,618095,618096,A,AR,1
NC_037339.1,NC_032661.1,2502074,620003,620005,t,taa,2
NC_037339.1,NC_032661.1,2508344,626274,626276,C,CAT,2
NC_037339.1,NC_032661.1,2527596,645529,645534,a,agtttt,5
NC_037339.1,NC_032661.1,2530659,648597,648599,A,AAC,2
NC_037339.1,NC_032661.1,2596384,714326,714327,A,AW,1
NC_037339.1,NC_032661.1,2630757,749126,749136,a,acaaaagagtc,10
NC_037339.1,NC_032661.1,2633501,751873,751874,A,AT,1
NC_037339.1,NC_032661.1,2636531,754909,754911,g,ggt,2
NC_037339.1,NC_032661.1,2642168,760551,760553,a,aag,2
NC_037339.1,NC_032661.1,2643836,762217,762221,T,TTGAC,4
NC_037339.1,NC_032661.1,2651866,770298,770302,A,AATTG,4
NC_037339.1,NC_032661.1,2661695,780161,780174,A,ATAATAGACCAGAC,13
NC_037339.1,NC_032661.1,2668730,787212,787213,t,ta,1
NC_037339.1,NC_032661.1,2718042,836529,836531,G,GCT,2
NC_037339.1,NC_032661.1,2719686,838177,838191,g,gtgatctggcattcc,14
NC_037339.1,NC_032661.1,2719752,838257,838262,t,taaaac,5
NC_037339.1,NC_032661.1,2727654,846162,846164,C,CCT,2
NC_037339.1,NC_032661.1,2732118,850629,850630,a,at,1
NC_037339.1,NC_032661.1,2805820,924695,924700,C,CTGAGK,5
NC_037339.1,NC_032661.1,2806701,925581,925582,T,TA,1
NC_037339.1,NC_032661.1,2811476,930360,930361,T,TG,1
NC_037339.1,NC_032661.1,2876816,995701,995705,A,ACAGT,4
NC_037339.1,NC_032661.1,2891792,1010682,1010683,t,tc,1
NC_037339.1,NC_032661.1,2892426,1011317,1011327,g,gactgaactga,10
NC_037339.1,NC_032661.1,2915845,1034747,1034748,T,TC,1
NC_037339.1,NC_032661.1,2925902,1044809,1044810,t,tg,1
NC_037339.1,NC_032661.1,2943706,1062614,1062615,c,ct,1
NC_037339.1,NC_032661.1,2996693,1096107,1096110,g,gact,3
NC_037339.1,NC_032661.1,3022417,1121834,1121835,a,ag,1
NC_037339.1,NC_032661.1,3028588,1128005,1128012,T,TTAACCAG,7
NC_037339.1,NC_032661.1,3028820,1128244,1128245,A,AT,1
NC_037339.1,NC_032661.1,3029820,1129245,1129248,A,AATT,3
NC_037339.1,NC_032661.1,3030117,1129545,1129546,T,TA,1
NC_037339.1,NC_032661.1,3030696,1130125,1130131,g,gtctgac,6
NC_037339.1,NC_032661.1,3139868,1238748,1238749,g,ga,1
NC_037339.1,NC_032661.1,3186067,1285270,1285271,a,ag,1
NC_037339.1,NC_032661.1,3233196,1332110,1332111,g,gt,1
NC_037339.1,NC_032661.1,3251885,1350805,1350806,t,tg,1
NC_037339.1,NC_032661.1,3264834,1363798,1363799,a,at,1
NC_037339.1,NC_032661.1,3279122,1378093,1378098,A,ACTCAT,5
NC_037339.1,NC_032661.1,3279613,1378589,1378590,t,ta,1
NC_037339.1,NC_032661.1,3282632,1381609,1381610,G,GA,1
NC_037339.1,NC_032661.1,3282648,1381626,1381627,G,GA,1
NC_037339.1,NC_032661.1,3282767,1381744,1381745,G,GA,1
NC_037339.1,NC_032661.1,3282881,1381859,1381860,C,CT,1
NC_037339.1,NC_032661.1,3282969,1381948,1381949,c,ca,1
NC_037339.1,NC_032661.1,3298842,1447030,1447031,a,aW,1
NC_037339.1,NC_032661.1,3304315,1454737,1454738,C,CA,1
NC_037339.1,NC_032661.1,3304885,1455303,1455316,c,cttcactttcactt,13
NC_037339.1,NC_032661.1,3307192,1457624,1457627,c,cact,3
NC_037339.1,NC_032661.1,3309492,1459991,1459992,C,CT,1
NC_037339.1,NC_032661.1,3309998,1460498,1460504,G,GACGCCA,6
NC_037339.1,NC_032661.1,3340457,1488979,1488980,G,GA,1
NC_037339.1,NC_032661.1,3426912,1575507,1575508,t,tg,1
NC_037339.1,NC_032661.1,3428542,1576563,1576564,c,ct,1
NC_037339.1,NC_032661.1,3428595,1576617,1576619,t,tNN,2
NC_037339.1,NC_032661.1,3451330,1600863,1600864,t,tg,1
NC_037339.1,NC_032661.1,3459824,1609346,1609347,a,at,1
NC_037339.1,NC_032661.1,3505078,1654605,1654606,a,ac,1
NC_037339.1,NC_032661.1,3589089,1737871,1737872,T,TC,1
NC_037339.1,NC_032661.1,3592098,1740888,1740890,C,CAT,2
NC_037339.1,NC_032661.1,3600730,1749525,1749541,c,cagccctgggatttctt,16
NC_037339.1,NC_032661.1,3617768,1766580,1766582,a,aMc,2
NC_037339.1,NC_032661.1,3674541,1823147,1823148,A,AR,1
NC_037339.1,NC_032661.1,3675839,1824452,1824454,A,AGT,2
NC_037339.1,NC_032661.1,3693681,1842301,1842302,A,AT,1
NC_037339.1,NC_032661.1,3721042,1869677,1869679,a,aNN,2
NC_037339.1,NC_032661.1,3746953,1895607,1895613,a,aNNNNNN,6
NC_037339.1,NC_032661.1,3759416,1908078,1908079,A,AG,1
NC_037339.1,NC_032661.1,3761952,1910611,1910612,G,GA,1
NC_037339.1,NC_032661.1,3785263,1933925,1933926,a,ac,1
NC_037339.1,NC_032661.1,3787684,1936333,1936334,T,TG,1
NC_037339.1,NC_032661.1,3835023,1984182,1984183,c,ca,1
NC_037339.1,NC_032661.1,3841462,1990602,1990605,T,TCTA,3
NC_037339.1,NC_032661.1,3843559,1992700,1992702,t,ttc,2
NC_037339.1,NC_032661.1,3844039,1993184,1993185,a,ac,1
NC_037339.1,NC_032661.1,3857592,2006745,2006746,T,TA,1
NC_037339.1,NC_032661.1,3886336,2049878,2049887,a,acactgtttc,9
NC_037339.1,NC_032661.1,3889323,2052874,2052877,a,acat,3
NC_037339.1,NC_032661.1,3904878,2068454,2068455,g,gK,1
NC_037339.1,NC_032661.1,3915610,2079157,2079158,T,TC,1
NC_037339.1,NC_032661.1,3919509,2083065,2083066,a,ag,1
NC_037339.1,NC_032661.1,3921784,2085320,2085321,c,ct,1
NC_037339.1,NC_032661.1,3924813,2088351,2088375,T,TAAATANNNNNNNNNNNNNNNNNNN,24
NC_037339.1,NC_032661.1,3947862,2111420,2111421,g,ga,1
NC_037339.1,NC_032661.1,3950305,2113863,2113881,a,aNNNNNNNNNNNNNNNNNN,18
NC_037339.1,NC_032661.1,3967778,2131368,2131370,T,TTC,2
NC_037339.1,NC_032661.1,3978405,2141995,2141996,a,ag,1
NC_037339.1,NC_032661.1,3987654,2151249,2151250,g,gt,1
NC_037339.1,NC_032661.1,3998478,2162074,2162075,t,tc,1
NC_037339.1,NC_032661.1,4008866,2172466,2172474,g,gtgtgtgta,8
NC_037339.1,NC_032661.1,4028272,2194775,2194777,t,taa,2
NC_037339.1,NC_032661.1,4037992,2204496,2204497,A,AG,1
NC_037339.1,NC_032661.1,4039942,2206449,2206453,a,aNNNN,4
NC_037339.1,NC_032661.1,4051488,2217980,2217981,c,ca,1
NC_037339.1,NC_032661.1,4059248,2225742,2225743,A,AG,1
NC_037339.1,NC_032661.1,4096038,2262547,2262549,c,cgt,2
NC_037339.1,NC_032661.1,4096092,2262603,2262605,a,atg,2
NC_037339.1,NC_032661.1,4143864,2310388,2310389,t,tc,1
NC_037339.1,NC_032661.1,4153250,2319778,2319779,a,ac,1
NC_037339.1,NC_032661.1,4200051,2366587,2366588,a,at,1
NC_037339.1,NC_032661.1,4200115,2366653,2366654,g,gt,1
NC_037339.1,NC_032661.1,4200123,2366662,2366663,c,ct,1
NC_037339.1,NC_032661.1,4331836,2499923,2499924,t,ta,1
NC_037339.1,NC_032661.1,4347480,2515571,2515572,a,ag,1
NC_037339.1,NC_032661.1,4406257,2574709,2574710,T,TW,1
NC_037339.1,NC_032661.1,4433820,2602283,2602287,t,ttttN,4
NC_037339.1,NC_032661.1,4434531,2602998,2603001,c,catt,3
NC_037339.1,NC_032661.1,4434971,2603440,2603454,T,TAATCATTAATCATA,14
NC_037339.1,NC_032661.1,4436801,2605284,2605285,C,CM,1
NC_037339.1,NC_032661.1,4453524,2622010,2622012,a,aac,2
NC_037339.1,NC_032661.1,4454530,2623067,2623071,G,GACTT,4
NC_037339.1,NC_032661.1,4454889,2623427,2623428,G,GT,1
NC_037339.1,NC_032661.1,4455710,2624248,2624249,A,AG,1
NC_037339.1,NC_032661.1,4456386,2624925,2624926,g,gt,1
NC_037339.1,NC_032661.1,4457358,2625898,2625899,C,CA,1
NC_037339.1,NC_032661.1,4460329,2628794,2628795,g,gt,1
NC_037339.1,NC_032661.1,4467508,2635974,2635975,a,at,1
NC_037339.1,NC_032661.1,4480865,2649332,2649333,T,TK,1
NC_037339.1,NC_032661.1,4481790,2650259,2650263,T,TTAAC,4
NC_037339.1,NC_032661.1,4481817,2650290,2650291,t,ta,1
NC_037339.1,NC_032661.1,4481949,2650423,2650424,A,AG,1
NC_037339.1,NC_032661.1,4493434,2661921,2661922,A,AT,1
NC_037339.1,NC_032661.1,4510552,2681387,2681388,g,gt,1
NC_037339.1,NC_032661.1,4511081,2681916,2681917,A,AT,1
NC_037339.1,NC_032661.1,4519469,2690306,2690308,g,gga,2
NC_037339.1,NC_032661.1,4522617,2693456,2693457,A,AG,1
NC_037339.1,NC_032661.1,4524146,2694991,2694992,t,ta,1
NC_037339.1,NC_032661.1,4526125,2696973,2696974,g,gt,1
NC_037339.1,NC_032661.1,4538985,2709841,2709842,T,TA,1
NC_037339.1,NC_032661.1,4551489,2722385,2722389,T,TAGAG,4
NC_037339.1,NC_032661.1,4551888,2722788,2722790,c,cca,2
NC_037339.1,NC_032661.1,4556466,2727368,2727369,t,tc,1
NC_037339.1,NC_032661.1,4557781,2728683,2728684,g,ga,1
NC_037339.1,NC_032661.1,4594332,2765261,2765262,t,ta,1
NC_037339.1,NC_032661.1,4711802,2891229,2891231,A,AGG,2
NC_037339.1,NC_032661.1,4717830,2897267,2897268,t,ta,1
NC_037339.1,NC_032661.1,4717921,2897359,2897360,a,at,1
NC_037339.1,NC_032661.1,4718134,2897573,2897574,t,tg,1
NC_037339.1,NC_032661.1,4736002,3093128,3093131,T,TAAG,3
NC_037339.1,NC_032661.1,4745391,3102495,3102496,C,CG,1
NC_037339.1,NC_032661.1,4749054,3106138,3106139,t,tc,1
NC_037339.1,NC_032661.1,4753512,3110601,3110602,a,ag,1
NC_037339.1,NC_032661.1,4755062,3111693,3111694,c,ct,1
NC_037339.1,NC_032661.1,4755813,3112439,3112440,c,cg,1
NC_037339.1,NC_032661.1,4756056,3112675,3112676,a,ac,1
NC_037339.1,NC_032661.1,4775493,3132473,3132477,a,aNNNN,4
NC_037339.1,NC_032661.1,4796102,3153093,3153100,g,gaaagtga,7
NC_037339.1,NC_032661.1,4802882,3159882,3159886,A,ACAGT,4
NC_037339.1,NC_032661.1,4808338,3165342,3165347,t,ttaaaa,5
NC_037339.1,NC_032661.1,4810699,3167714,3167715,C,CT,1
NC_037339.1,NC_032661.1,4822093,3179109,3179115,c,cttccag,6
NC_037339.1,NC_032661.1,4826105,3183122,3183123,T,TA,1
NC_037339.1,NC_032661.1,4844276,3201067,3201068,g,gt,1
NC_037339.1,NC_032661.1,4852185,3208967,3208968,a,aN,1
NC_037339.1,NC_032661.1,4882323,3239272,3239273,C,CG,1
NC_037339.1,NC_032661.1,5032253,3483634,3483635,t,tc,1
NC_037339.1,NC_032661.1,5032306,3483688,3483690,t,ttg,2
NC_037339.1,NC_032661.1,5054776,3510737,3510738,A,AW,1
NC_037339.1,NC_032661.1,5056040,3512002,3512005,t,taaa,3
NC_037339.1,NC_032661.1,5057757,3513727,3513728,A,AT,1
NC_037339.1,NC_032661.1,5096973,3556216,3556223,t,ttatggtg,7
NC_037339.1,NC_032661.1,5171197,3630410,3630411,g,ga,1
NC_037339.1,NC_032661.1,5171231,3630445,3630494,a,aaagNNNNNNNNNNNNNNNNNNNNNNNNNNNNNNNNNNNNNNNNCGGaat,49
NC_037339.1,NC_032661.1,5207990,3667316,3667319,a,aNNN,3
NC_037339.1,NC_032661.1,5305301,3764741,3764742,a,at,1
NC_037339.1,NC_032661.1,5326211,3785654,3785655,t,tc,1
NC_037339.1,NC_032661.1,5554183,4013732,4013733,A,AC,1
NC_037339.1,NC_032661.1,5590075,4069776,4069777,t,ta,1
NC_037339.1,NC_032661.1,5590077,4069779,4069780,c,cg,1
NC_037339.1,NC_032661.1,5590409,4070110,4070122,a,attttgatttctt,12
NC_037339.1,NC_032661.1,5797439,4293697,4293698,c,ca,1
NC_037339.1,NC_032661.1,6038955,4609410,4609411,t,ta,1
NC_037339.1,NC_032661.1,6042626,4613088,4613098,a,aaactggaagt,10
NC_037339.1,NC_032661.1,6108076,4726395,4726397,t,tNN,2
NC_037339.1,NC_032661.1,6276514,4919218,4919219,T,TA,1
NC_037339.1,NC_032661.1,6276664,4919369,4919370,G,GA,1
NC_037339.1,NC_032661.1,6277514,4920222,4920227,t,tgaaca,5
NC_037339.1,NC_032661.1,6303869,4946584,4946585,c,ca,1
NC_037339.1,NC_032661.1,6306462,4949179,4949181,C,CCA,2
NC_037339.1,NC_032661.1,6381188,5023753,5023754,a,at,1
NC_037339.1,NC_032661.1,6446935,5089393,5089394,g,gt,1
NC_037339.1,NC_032661.1,6447604,5090063,5090064,a,at,1
NC_037339.1,NC_032661.1,6447666,5090126,5090127,c,ct,1
NC_037339.1,NC_032661.1,6616157,5276932,5276934,t,taa,2
NC_037339.1,NC_032661.1,6678541,5342423,5342424,t,tc,1
NC_037339.1,NC_032661.1,6814176,5477939,5477940,c,ct,1
NC_037339.1,NC_032661.1,6997553,5661533,5661534,t,tc,1
NC_037339.1,NC_032661.1,7131470,5795449,5795451,c,caa,2
NC_037339.1,NC_032661.1,7143110,5807090,5807091,a,ag,1
NC_037339.1,NC_032661.1,7201966,5865947,5865954,t,ttaaaaag,7
NC_037339.1,NC_032661.1,7225195,5888793,5888794,a,at,1
NC_037339.1,NC_032661.1,7228654,5892250,5892251,g,ga,1
NC_037339.1,NC_032661.1,7324414,5984338,5984340,t,ttc,2
NC_037339.1,NC_032661.1,7422009,6156916,6156918,t,tNN,2
NC_037339.1,NC_032661.1,7663222,6272688,6272690,c,ctg,2
NC_037339.1,NC_032661.1,7663671,6273139,6273141,t,ttc,2
NC_037339.1,NC_032661.1,7671460,6280928,6280929,a,at,1
NC_037339.1,NC_032661.1,7688827,6298296,6298300,t,tNNNN,4
NC_037339.1,NC_032661.1,7780936,6391153,6391155,t,tga,2
NC_037339.1,NC_032661.1,7783224,6393480,6393481,g,ga,1
NC_037339.1,NC_032661.1,7831168,6441424,6441425,A,AR,1
NC_037339.1,NC_032661.1,7839064,6449320,6449323,a,aaat,3
NC_037339.1,NC_032661.1,7871275,6481535,6481536,a,ac,1
NC_037339.1,NC_032661.1,7871307,6481568,6481569,a,at,1
NC_037339.1,NC_032661.1,7871324,6481586,6481594,a,aaagagtgg,8
NC_037339.1,NC_032661.1,7913214,6523504,6523505,g,gc,1
NC_037339.1,NC_032661.1,8029839,6640482,6640484,t,tNN,2
NC_037339.1,NC_032661.1,8126326,6736688,6736689,t,tg,1
NC_037339.1,NC_032661.1,8126769,6737132,6737133,t,ta,1
NC_037339.1,NC_032661.1,8127690,6738054,6738055,g,gc,1
NC_037339.1,NC_032661.1,8378012,6965297,6965298,a,at,1
NC_037339.1,NC_032661.1,8439710,7026998,7027004,t,taaccga,6
NC_037339.1,NC_032661.1,8470167,7057459,7057460,g,ga,1
NC_037339.1,NC_032661.1,8470270,7057563,7057564,A,AC,1
NC_037339.1,NC_032661.1,8490585,7077884,7077885,A,AN,1
NC_037339.1,NC_032661.1,8490643,7077943,7077944,c,ct,1
NC_037339.1,NC_032661.1,8656315,7245550,7245552,a,aNN,2
NC_037339.1,NC_032661.1,8742070,7331313,7331314,g,ga,1
NC_037339.1,NC_032661.1,8807329,7443401,7443402,a,ag,1
NC_037339.1,NC_032661.1,8819517,7455790,7455791,a,aN,1
NC_037339.1,NC_032661.1,8822908,7459184,7459185,a,ag,1
NC_037339.1,NC_032661.1,8823355,7459632,7459633,a,ac,1
NC_037339.1,NC_032661.1,8877624,7513904,7513905,g,ga,1
NC_037339.1,NC_032661.1,9095797,7750632,7750633,a,ag,1
NC_037339.1,NC_032661.1,9102838,7757674,7757675,A,AT,1
NC_037339.1,NC_032661.1,9306100,8032531,8032534,C,CCTT,3
NC_037339.1,NC_032661.1,9309074,8035503,8035511,a,aatatatat,8
NC_037339.1,NC_032661.1,9310569,8037008,8037009,T,TY,1
NC_037339.1,NC_032661.1,9315307,8041752,8041753,c,ca,1
NC_037339.1,NC_032661.1,9317334,8047139,8047140,C,CG,1
NC_037339.1,NC_032661.1,9319096,8048902,8048905,g,gaaa,3
NC_037339.1,NC_032661.1,9322029,8051835,8051836,A,AT,1
NC_037339.1,NC_032661.1,9491235,8161641,8161642,a,at,1
NC_037339.1,NC_032661.1,9508849,8179149,8179150,g,gc,1
NC_037339.1,NC_032661.1,9545126,8190380,8190381,C,CY,1
NC_037339.1,NC_032661.1,9567438,8212712,8212713,C,CS,1
NC_037339.1,NC_032661.1,9620298,8265578,8265584,a,aNNNNNN,6
NC_037339.1,NC_032661.1,9626436,8271720,8271721,t,tg,1
NC_037339.1,NC_032661.1,9679695,8324239,8324240,C,CR,1
NC_037339.1,NC_032661.1,9759980,8404523,8404524,c,ca,1
NC_037339.1,NC_032661.1,9844742,8489055,8489056,G,GK,1
NC_037339.1,NC_032661.1,9845133,8489447,8489448,A,AT,1
NC_037339.1,NC_032661.1,9847656,8491970,8491971,G,GT,1
NC_037339.1,NC_032661.1,9849867,8494197,8494203,c,cctgttg,6
NC_037339.1,NC_032661.1,9885481,8530634,8530635,c,ca,1
NC_037339.1,NC_032661.1,9905083,8550236,8550246,G,GTGGGTCARGT,10
NC_037339.1,NC_032661.1,9909700,8554630,8554637,C,CTTAAAGT,7
NC_037339.1,NC_032661.1,9919304,8565440,8565441,A,AR,1
NC_037339.1,NC_032661.1,9927828,8573964,8573970,a,aNNNNNN,6
NC_037339.1,NC_032661.1,10031691,8677052,8677089,C,CTGCTGTACATCAGAAGAYGGTGAGGTTTGCTTCCCTY,37
NC_037339.1,NC_032661.1,10039684,8685086,8685087,t,ta,1
NC_037339.1,NC_032661.1,10122398,8767735,8767736,T,TG,1
NC_037339.1,NC_032661.1,10125584,8770922,8770923,A,AW,1
NC_037339.1,NC_032661.1,10132472,8777809,8777810,G,GC,1
NC_037339.1,NC_032661.1,10145675,8791018,8791024,T,TTATTAA,6
NC_037339.1,NC_032661.1,10219071,8864649,8864650,T,TY,1
NC_037339.1,NC_032661.1,10231486,8877070,8877071,g,ga,1
NC_037339.1,NC_032661.1,10270106,8915796,8915797,a,at,1
NC_037339.1,NC_032661.1,10270574,8916267,8916268,a,ac,1
NC_037339.1,NC_032661.1,10272051,8917745,8917747,T,TTG,2
NC_037339.1,NC_032661.1,10273224,8918920,8918924,C,CACTG,4
NC_037339.1,NC_032661.1,10292272,8938628,8938629,A,AG,1
NC_037339.1,NC_032661.1,10307369,8953721,8953722,C,CY,1
NC_037339.1,NC_032661.1,10310454,8956807,8956808,C,CY,1
NC_037339.1,NC_032661.1,10310798,8957150,8957151,G,GK,1
NC_037339.1,NC_032661.1,10317805,8964158,8964160,G,GCA,2
NC_037339.1,NC_032661.1,10318794,8965029,8965030,c,ca,1
NC_037339.1,NC_032661.1,10320508,8966744,8966746,c,cct,2
NC_037339.1,NC_032661.1,10332584,8978820,8978821,T,TY,1
NC_037339.1,NC_032661.1,10375132,9021379,9021380,a,at,1
NC_037339.1,NC_032661.1,10432464,9078714,9078715,C,CT,1
NC_037339.1,NC_032661.1,10546642,9192854,9192855,A,AM,1
NC_037339.1,NC_032661.1,10580033,9226250,9226251,T,TC,1
NC_037339.1,NC_032661.1,10607023,9253242,9253243,G,GA,1
NC_037339.1,NC_032661.1,10625657,9271869,9271870,G,GA,1
NC_037339.1,NC_032661.1,10657845,9303616,9303623,A,ACAGGAGG,7
NC_037339.1,NC_032661.1,10660557,9306335,9306337,t,tga,2
NC_037339.1,NC_032661.1,10703285,9349068,9349069,G,GR,1
NC_037339.1,NC_032661.1,10704806,9350590,9350591,C,CT,1
NC_037339.1,NC_032661.1,10704937,9350723,9350724,C,CT,1
NC_037339.1,NC_032661.1,10731178,9376954,9376957,C,CATT,3
NC_037339.1,NC_032661.1,10771162,9416259,9416279,A,AGATGGTTGTAGCAGTCGTTT,20
NC_037339.1,NC_032661.1,10778922,9424039,9424040,g,ga,1
NC_037339.1,NC_032661.1,10786428,9431488,9431489,C,CS,1
NC_037339.1,NC_032661.1,10792425,9437501,9437503,a,att,2
NC_037339.1,NC_032661.1,10918091,9563153,9563154,C,CG,1
NC_037339.1,NC_032661.1,10981819,9626040,9626041,A,AN,1
NC_037339.1,NC_032661.1,11479301,10116341,10116356,G,GGGGCCAGGCCGCCCC,15
NC_037339.1,NC_032661.1,11546816,10183914,10183915,A,AW,1
NC_037339.1,NC_032661.1,11546936,10184035,10184036,T,TG,1
NC_037339.1,NC_032661.1,11570763,10212735,10212755,A,ATCCGAGTCGTTCANNNNNNN,20
NC_037339.1,NC_032661.1,11584030,10226021,10226022,c,cg,1
NC_037339.1,NC_032661.1,11874901,10517293,10517309,a,atcaYcaactgagtcag,16
NC_037339.1,NC_032661.1,11889180,10531533,10531534,A,AC,1
NC_037339.1,NC_032661.1,11893014,10535368,10535369,c,ca,1
NC_037339.1,NC_032661.1,11893791,10536144,10536146,C,CTA,2
NC_037339.1,NC_032661.1,12175702,10843073,10843075,t,tNN,2
NC_037339.1,NC_032661.1,12223563,10891252,10891256,a,atatg,4
NC_037339.1,NC_032661.1,12225363,10893056,10893057,c,ca,1
NC_037339.1,NC_032661.1,12228916,10896593,10896595,C,CCT,2
NC_037339.1,NC_032661.1,12230764,10898443,10898447,T,TTGAC,4
NC_037339.1,NC_032661.1,12235200,10902884,10902896,T,TGTCACAGGTTTA,12
NC_037339.1,NC_032661.1,12293777,11037656,11037657,t,tN,1
NC_037339.1,NC_032661.1,12350767,11094643,11094662,g,gcattggcaggcggattcgt,19
NC_037339.1,NC_032661.1,12390803,11134699,11134700,C,CA,1
NC_037339.1,NC_032661.1,12452870,11196833,11196836,A,ATAT,3
NC_037339.1,NC_032661.1,12475169,11220714,11220715,T,TG,1
NC_037339.1,NC_032661.1,12490751,11236317,11236320,T,TGAA,3
NC_037339.1,NC_032661.1,12559821,11305396,11305397,C,CA,1
NC_037339.1,NC_032661.1,12605076,11350655,11350656,g,gc,1
NC_037339.1,NC_032661.1,12613020,11358612,11358613,a,at,1
NC_037339.1,NC_032661.1,12701534,11447138,11447139,G,GA,1
NC_037339.1,NC_032661.1,12739201,11485293,11485294,G,GA,1
NC_037339.1,NC_032661.1,12749272,11495366,11495372,t,taaaaaa,6
NC_037339.1,NC_032661.1,12835227,11581334,11581335,c,ca,1
NC_037339.1,NC_032661.1,12906984,11631850,11631851,a,ag,1
NC_037339.1,NC_032661.1,13056089,11829551,11829552,A,AC,1
NC_037339.1,NC_032661.1,13129274,11902740,11902743,t,tagc,3
NC_037339.1,NC_032661.1,13139068,11912546,11912551,c,cccctt,5
NC_037339.1,NC_032661.1,13156699,11931274,11931276,t,tNN,2
NC_037339.1,NC_032661.1,13250570,12027004,12027005,t,ta,1
NC_037339.1,NC_032661.1,13388186,12165185,12165186,G,GC,1
NC_037339.1,NC_032661.1,13418283,12195276,12195277,t,tg,1
NC_037339.1,NC_032661.1,13424055,12201049,12201050,t,tc,1
NC_037339.1,NC_032661.1,13452690,12229685,12229686,A,AM,1
NC_037339.1,NC_032661.1,13538777,12334638,12334639,T,TA,1
NC_037339.1,NC_032661.1,13538876,12334739,12334740,G,GA,1
NC_037339.1,NC_032661.1,13538882,12334746,12334747,T,TC,1
NC_037339.1,NC_032661.1,13594103,12389966,12389973,g,gggaggga,7
NC_037339.1,NC_032661.1,13618387,12414260,12414265,c,cccccg,5
NC_037339.1,NC_032661.1,13680477,12549359,12549361,A,AAG,2
NC_037339.1,NC_032661.1,13680881,12549765,12549767,a,aat,2
NC_037339.1,NC_032661.1,13696349,12565238,12565239,c,ct,1
NC_037339.1,NC_032661.1,13729780,12598566,12598578,g,gaagaaatcaaaa,12
NC_037339.1,NC_032661.1,13830156,12738824,12738825,T,TK,1
NC_037339.1,NC_032661.1,13862126,12771263,12771265,T,TAA,2
NC_037339.1,NC_032661.1,13883793,12792934,12792935,G,GT,1
NC_037339.1,NC_032661.1,13910861,12820122,12820124,C,CAT,2
NC_037339.1,NC_032661.1,13919678,12828930,12828931,A,AR,1
NC_037339.1,NC_032661.1,13937228,12846475,12846480,c,caactg,5
NC_037339.1,NC_032661.1,13939183,12848436,12848437,A,AG,1
NC_037339.1,NC_032661.1,14002016,12911263,12911265,C,CTM,2
NC_037339.1,NC_032661.1,14002587,12911836,12911838,t,ttg,2
NC_037339.1,NC_032661.1,14004542,12913793,12913794,T,TC,1
NC_037339.1,NC_032661.1,14030352,12939632,12939650,t,ttttgcattatgTGGATTA,18
NC_037339.1,NC_032661.1,14034783,12944083,12944089,t,tagcagc,6
NC_037339.1,NC_032661.1,14096505,13005820,13005824,a,aaagc,4
NC_037339.1,NC_032661.1,14144490,13051560,13051561,a,aM,1
NC_037339.1,NC_032661.1,14158388,13065445,13065468,G,GCCTGAAGTAATGCTGTGCAATGC,23
NC_037339.1,NC_032661.1,14160652,13067736,13067738,c,caa,2
NC_037339.1,NC_032661.1,14161588,13068675,13068677,C,CAT,2
NC_037339.1,NC_032661.1,14165124,13072214,13072215,c,ct,1
NC_037339.1,NC_032661.1,14171294,13078387,13078396,g,gggaaacagt,9
NC_037339.1,NC_032661.1,14184665,13092012,13092013,c,ct,1
NC_037339.1,NC_032661.1,14198638,13105988,13105990,T,TGY,2
NC_037339.1,NC_032661.1,14371429,13281248,13281249,G,GC,1
NC_037339.1,NC_032661.1,14411263,13432978,13432979,A,AR,1
NC_037339.1,NC_032661.1,14418867,13440301,13440302,t,tc,1
NC_037339.1,NC_032661.1,14480972,13390660,13390678,A,AGTCTTTGAGTCTTCAATC,18
NC_037339.1,NC_032661.1,14484886,13394592,13394593,a,at,1
NC_037339.1,NC_032661.1,14525897,13504004,13504032,t,tcccatggaccggggagcctggtaggcta,28
NC_037339.1,NC_032661.1,14528219,13506355,13506356,T,TW,1
NC_037339.1,NC_032661.1,14533343,13511475,13511476,A,AG,1
NC_037339.1,NC_032661.1,14534309,13512443,13512444,c,ct,1
NC_037339.1,NC_032661.1,14548023,13526159,13526177,c,ctgactcaatggacatggg,18
NC_037339.1,NC_032661.1,14558692,13536848,13536849,g,gt,1
NC_037339.1,NC_032661.1,14746328,13729361,13729362,C,CA,1
NC_037339.1,NC_032661.1,15468283,14456781,14456809,A,ANNNNNNNNNNNNNNNNNNNNNNNNNNNN,28
NC_037339.1,NC_032661.1,15500531,14488185,14488186,g,ga,1
NC_037339.1,NC_032661.1,15739250,14720590,14720591,G,GK,1
NC_037339.1,NC_032661.1,15798240,14779581,14779583,G,GTA,2
NC_037339.1,NC_032661.1,15900551,14918780,14918781,a,ac,1
NC_037339.1,NC_032661.1,15951617,14971969,14971970,G,GT,1
NC_037339.1,NC_032661.1,16037041,15055635,15055638,c,caaa,3
NC_037339.1,NC_032661.1,16043780,15062379,15062390,G,GCGCTGTCTGAC,11
NC_037339.1,NC_032661.1,16104161,15122544,15122545,g,ga,1
NC_037339.1,NC_032661.1,16178577,15196961,15196962,a,ac,1
NC_037339.1,NC_032661.1,16230802,15249202,15249204,c,cag,2
NC_037339.1,NC_032661.1,16328067,15352498,15352500,C,CTM,2
NC_037339.1,NC_032661.1,16379551,15404009,15404010,a,aM,1
NC_037339.1,NC_032661.1,16523310,15546084,15546085,A,AT,1
NC_037339.1,NC_032661.1,16581077,15603863,15603870,c,ctttcact,7
NC_037339.1,NC_032661.1,16594307,15617092,15617093,G,GA,1
NC_037339.1,NC_032661.1,16595412,15618199,15618200,g,ga,1
NC_037339.1,NC_032661.1,16618056,15640862,15640863,t,ta,1
NC_037339.1,NC_032661.1,16665805,15688910,15688911,T,TC,1
NC_037339.1,NC_032661.1,16668868,15691973,15691996,A,ATATCTATTGGTTAATTAACCAGT,23
NC_037339.1,NC_032661.1,16734153,15757292,15757293,G,GC,1
NC_037339.1,NC_032661.1,16740635,15763830,15763834,A,ATTTT,4
NC_037339.1,NC_032661.1,16752819,15776016,15776017,c,ct,1
NC_037339.1,NC_032661.1,16788499,15811700,15811702,g,ggt,2
NC_037339.1,NC_032661.1,16788578,15811781,15811784,a,agag,3
NC_037339.1,NC_032661.1,16822715,15845929,15845930,C,CA,1
NC_037339.1,NC_032661.1,16893534,15916999,15917000,T,TW,1
NC_037339.1,NC_032661.1,16957882,16008809,16008827,T,TTTTACTTTGCAATACTAG,18
NC_037339.1,NC_032661.1,16961403,16012282,16012283,g,gt,1
NC_037339.1,NC_032661.1,16966167,16017058,16017060,t,ttc,2
NC_037339.1,NC_032661.1,16966459,16017352,16017353,G,GA,1
NC_037339.1,NC_032661.1,16968107,16019010,16019020,c,ctttctttctt,10
NC_037339.1,NC_032661.1,16972350,16023322,16023325,C,CTAY,3
NC_037339.1,NC_032661.1,16989257,16040211,16040213,g,gga,2
NC_037339.1,NC_032661.1,17034043,16085470,16085471,C,CT,1
NC_037339.1,NC_032661.1,17043930,16095358,16095359,T,TA,1
NC_037339.1,NC_032661.1,17057218,16108650,16108651,t,ta,1
NC_037339.1,NC_032661.1,17066900,16118333,16118334,t,tc,1
NC_037339.1,NC_032661.1,17069465,16120895,16120898,t,tgtg,3
NC_037339.1,NC_032661.1,17070448,16121881,16121882,t,ta,1
NC_037339.1,NC_032661.1,17102590,16154054,16154057,t,tgaa,3
NC_037339.1,NC_032661.1,17103728,16155204,16155207,A,ATTG,3
NC_037339.1,NC_032661.1,17106704,16158183,16158184,t,tc,1
NC_037339.1,NC_032661.1,17118963,16170612,16170618,T,TACAGCC,6
NC_037339.1,NC_032661.1,17138655,16192794,16192795,t,ta,1
NC_037339.1,NC_032661.1,17143700,16197843,16197844,c,ca,1
NC_037339.1,NC_032661.1,17210305,16271152,16271153,a,aN,1
NC_037339.1,NC_032661.1,17232002,16292869,16292870,A,AT,1
NC_037339.1,NC_032661.1,17236387,16297255,16297256,T,TA,1
NC_037339.1,NC_032661.1,17312313,16372177,16372179,a,agt,2
NC_037339.1,NC_032661.1,17331360,16391432,16391464,G,GGTCAAAGGCCCCCTAAAAAANNNNNNNNNNNN,32
NC_037339.1,NC_032661.1,17331469,16391575,16391577,t,tta,2
NC_037339.1,NC_032661.1,17436545,16522017,16522018,A,AT,1
NC_037339.1,NC_032661.1,17443697,16529170,16529171,g,ga,1
NC_037339.1,NC_032661.1,17492078,16577909,16577910,g,ga,1
NC_037339.1,NC_032661.1,17498846,16584678,16584701,c,ctgctgctgctgctgctgctgctg,23
NC_037339.1,NC_032661.1,17525220,16611082,16611083,T,TG,1
NC_037339.1,NC_032661.1,17527862,16613726,16613727,c,ct,1
NC_037339.1,NC_032661.1,17530080,16686989,16686990,G,GA,1
NC_037339.1,NC_032661.1,17555798,16712707,16712709,C,CTM,2
NC_037339.1,NC_032661.1,17559353,16716265,16716266,a,at,1
NC_037339.1,NC_032661.1,17587101,16744190,16744191,C,CA,1
NC_037339.1,NC_032661.1,17605953,16763046,16763047,A,AT,1
NC_037339.1,NC_032661.1,17674351,16831432,16831433,c,ca,1
NC_037339.1,NC_032661.1,17723443,16884677,16884679,G,GAR,2
NC_037339.1,NC_032661.1,17768453,16929691,16929692,A,AC,1
NC_037339.1,NC_032661.1,18191132,17581621,17581622,t,ta,1
NC_037339.1,NC_032661.1,18251866,17641105,17641106,A,AM,1
NC_037339.1,NC_032661.1,18262853,17652057,17652058,a,ac,1
NC_037339.1,NC_032661.1,18283213,17672419,17672421,a,aag,2
NC_037339.1,NC_032661.1,18293772,17682926,17682928,g,gtt,2
NC_037339.1,NC_032661.1,18294074,17683230,17683232,g,gac,2
NC_037339.1,NC_032661.1,18317398,17706558,17706559,T,TC,1
NC_037339.1,NC_032661.1,18328043,17717198,17717199,C,CY,1
NC_037339.1,NC_032661.1,18337732,17726890,17726891,c,ct,1
NC_037339.1,NC_032661.1,18403067,17791891,17791892,t,tg,1
NC_037339.1,NC_032661.1,18403211,17792037,17792038,g,ga,1
NC_037339.1,NC_032661.1,18403219,17792046,17792047,t,tc,1
NC_037339.1,NC_032661.1,18404368,17793196,17793198,c,ctg,2
NC_037339.1,NC_032661.1,18423168,17811998,17811999,c,ca,1
NC_037339.1,NC_032661.1,18427425,17816258,17816259,g,ga,1
NC_037339.1,NC_032661.1,18427459,17816295,17816296,t,tg,1
NC_037339.1,NC_032661.1,18722326,18102112,18102113,C,CS,1
NC_037339.1,NC_032661.1,18734144,18113681,18113682,g,gt,1
NC_037339.1,NC_032661.1,18736060,18115596,18115597,t,tc,1
NC_037339.1,NC_032661.1,18738795,18118129,18118130,G,GS,1
NC_037339.1,NC_032661.1,18738803,18118138,18118139,T,TA,1
NC_037339.1,NC_032661.1,18808030,18187243,18187244,A,AR,1
NC_037339.1,NC_032661.1,18969132,18355507,18355510,g,gcca,3
NC_037339.1,NC_032661.1,18972599,18358980,18358982,G,GGT,2
NC_037339.1,NC_032661.1,19170866,18557552,18557554,t,ttc,2
NC_037339.1,NC_032661.1,19184328,18571015,18571016,T,TG,1
NC_037339.1,NC_032661.1,19324590,18711160,18711162,A,ATW,2
NC_037339.1,NC_032661.1,19479872,18866549,18866550,G,GT,1
NC_037339.1,NC_032661.1,19509242,18895920,18895951,C,CCAAAGTGAAATATTCAGGATACTAATGGTCT,31
NC_037339.1,NC_032661.1,19577805,19010747,19010748,C,CS,1
NC_037339.1,NC_032661.1,19624861,19057800,19057801,G,GS,1
NC_037339.1,NC_032661.1,19664320,19095751,19095752,A,AG,1
NC_037339.1,NC_032661.1,19878641,19310259,19310260,g,gc,1
NC_037339.1,NC_032661.1,19950657,19382851,19382852,a,at,1
NC_037339.1,NC_032661.1,20302121,19794740,19794743,a,aaat,3
NC_037339.1,NC_032661.1,20303351,19795961,19795963,c,cat,2
NC_037339.1,NC_032661.1,20305239,19797835,19797838,a,atag,3
NC_037339.1,NC_032661.1,20305401,19798000,19798001,t,tc,1
NC_037339.1,NC_032661.1,20306090,19798683,19798685,c,ctg,2
NC_037339.1,NC_032661.1,20306260,19798855,19798861,t,ttataaa,6
NC_037339.1,NC_032661.1,20306579,19799180,19799182,a,aat,2
NC_037339.1,NC_032661.1,20309962,19808738,19808745,t,tggggagg,7
NC_037339.1,NC_032661.1,20448920,19941167,19941168,A,AM,1
NC_037339.1,NC_032661.1,20477068,19968970,19968971,t,ta,1
NC_037339.1,NC_032661.1,20748957,20194514,20194515,t,tg,1
NC_037339.1,NC_032661.1,20990676,20456667,20456690,t,tctgtgctaccccagagacggcag,23
NC_037339.1,NC_032661.1,21014055,20480106,20480107,T,TK,1
NC_037339.1,NC_032661.1,21095601,20561668,20561669,c,ct,1
NC_037339.1,NC_032661.1,21116567,20582635,20582636,T,TA,1
NC_037339.1,NC_032661.1,21116609,20582678,20582681,c,ctca,3
NC_037339.1,NC_032661.1,21244848,20710626,20710627,a,ac,1
NC_037339.1,NC_032661.1,21279868,20745671,20745672,C,CG,1
NC_037339.1,NC_032661.1,21279927,20745731,20745732,G,GT,1
NC_037339.1,NC_032661.1,21280324,20746130,20746133,A,ACTW,3
NC_037339.1,NC_032661.1,21435662,20898518,20898519,t,tg,1
NC_037339.1,NC_032661.1,21439179,20902052,20902059,T,TGGCAAAA,7
NC_037339.1,NC_032661.1,21442935,20905816,20905817,g,gt,1
NC_037339.1,NC_032661.1,21442953,20905835,20905836,a,ag,1
NC_037339.1,NC_032661.1,21442982,20905865,20905867,c,cct,2
NC_037339.1,NC_032661.1,21443000,20905885,20905886,a,ag,1
NC_037339.1,NC_032661.1,21471221,20934108,20934109,T,TA,1
NC_037339.1,NC_032661.1,21519371,20929654,20929656,A,ATG,2
NC_037339.1,NC_032661.1,21519391,20929676,20929677,T,TG,1
NC_037339.1,NC_032661.1,21519409,20929695,20929696,T,TG,1
NC_037339.1,NC_032661.1,21519528,20929821,20929822,T,TG,1
NC_037339.1,NC_032661.1,21519598,20929892,20929893,C,CT,1
NC_037339.1,NC_032661.1,21519729,20930024,20930025,A,AG,1
NC_037339.1,NC_032661.1,21519813,20930108,20930110,A,AAT,2
NC_037339.1,NC_032661.1,21520033,20930328,20930329,T,TG,1
NC_037339.1,NC_032661.1,21520104,20930400,20930401,a,ag,1
NC_037339.1,NC_032661.1,21520394,20930689,20930690,t,tg,1
NC_037339.1,NC_032661.1,21520677,20930973,20930974,t,ta,1
NC_037339.1,NC_032661.1,21683731,21097852,21097856,g,gaact,4
NC_037339.1,NC_032661.1,21685224,21099353,21099356,g,gaac,3
NC_037339.1,NC_032661.1,21758418,21187536,21187537,c,ct,1
NC_037339.1,NC_032661.1,21783091,21212396,21212397,A,AG,1
NC_037339.1,NC_032661.1,21829628,21263408,21263409,C,CS,1
NC_037339.1,NC_032661.1,22065366,21587864,21587865,g,ga,1
NC_037339.1,NC_032661.1,22147064,21669582,21669584,t,tNN,2
NC_037339.1,NC_032661.1,22147829,21670349,21670350,G,GA,1
NC_037339.1,NC_032661.1,22357939,21860187,21860188,a,ag,1
NC_037339.1,NC_032661.1,22687841,22144947,22144949,g,gcc,2
NC_037339.1,NC_032661.1,22688149,22145257,22145258,c,ct,1
NC_037339.1,NC_032661.1,22694375,22157045,22157047,a,aNN,2
NC_037339.1,NC_032661.1,22845356,22307960,22307961,c,ct,1
NC_037339.1,NC_032661.1,22897978,22385228,22385229,g,gc,1
NC_037339.1,NC_032661.1,22940412,22427583,22427585,a,act,2
NC_037339.1,NC_032661.1,22942510,22429683,22429684,A,AM,1
NC_037339.1,NC_032661.1,23048498,22528657,22528659,a,aag,2
NC_037339.1,NC_032661.1,23062485,22542659,22542664,G,GAAGTA,5
NC_037339.1,NC_032661.1,23083418,22563612,22563616,T,TAGAG,4
NC_037339.1,NC_032661.1,23091357,22571555,22571557,c,cat,2
NC_037339.1,NC_032661.1,23124296,22604499,22604503,A,AAGTR,4
NC_037339.1,NC_032661.1,23198370,22679110,22679111,t,ta,1
NC_037339.1,NC_032661.1,23198386,22679127,22679128,c,ca,1
NC_037339.1,NC_032661.1,23198399,22679141,22679142,a,ac,1
NC_037339.1,NC_032661.1,23266066,22746669,22746670,T,TG,1
NC_037339.1,NC_032661.1,23276849,22757453,22757454,a,ag,1
NC_037339.1,NC_032661.1,23386093,22905247,22905251,g,gtccN,4
NC_037339.1,NC_032661.1,23726286,23299555,23299556,c,cg,1
NC_037339.1,NC_032661.1,23848168,23421346,23421347,t,ta,1
NC_037339.1,NC_032661.1,23851390,23424569,23424578,c,ctgCGTTACA,9
NC_037339.1,NC_032661.1,24127143,23764999,23765000,A,AN,1
NC_037339.1,NC_032661.1,24131692,23769548,23769549,t,tc,1
NC_037339.1,NC_032661.1,24536430,24233473,24233481,a,aaaaagggt,8
NC_037339.1,NC_032661.1,24700676,24397290,24397291,a,at,1
NC_037339.1,NC_032661.1,24812297,24508918,24508920,t,taa,2
NC_037339.1,NC_032661.1,24836246,24532871,24532872,g,gt,1
NC_037339.1,NC_032661.1,24905480,24602107,24602140,C,CACAAACNNNNNNNNNNNNNNNNNNNNNNNNNNN,33
NC_037339.1,NC_032661.1,24968195,24664864,24664865,T,TY,1
NC_037339.1,NC_032661.1,25009220,24705882,24705883,a,at,1
NC_037339.1,NC_032661.1,25030158,24726853,24726854,t,tN,1
NC_037339.1,NC_032661.1,25048168,24744865,24744866,C,CA,1
NC_037339.1,NC_032661.1,25122485,24819202,24819235,c,cgtcAANNNNNNNNNNNNNNNNNNNNNNNNNNNN,33
NC_037339.1,NC_032661.1,25147903,24844647,24844648,g,ga,1
NC_037339.1,NC_032661.1,25262271,24959025,24959026,G,GT,1
NC_037339.1,NC_032661.1,25477042,25175486,25175493,c,cacacaca,7
NC_037339.1,NC_032661.1,26097445,25815880,25815881,a,at,1
NC_037339.1,NC_032661.1,26192674,25911266,25911267,t,ta,1
NC_037339.1,NC_032661.1,26257861,25975504,25975513,C,CTTCTTAGTM,9
NC_037339.1,NC_032661.1,26265811,25983179,25983181,a,aNN,2
NC_037339.1,NC_032661.1,26340716,26058949,26058952,A,ATCT,3
NC_037339.1,NC_032661.1,26382244,26105737,26105741,t,tgttg,4
NC_037339.1,NC_032661.1,26383109,26106606,26106607,a,ac,1
NC_037339.1,NC_032661.1,26496670,26220170,26220171,a,at,1
NC_037339.1,NC_032661.1,26617736,26349667,26349668,t,tc,1
NC_037339.1,NC_032661.1,26748298,26480256,26480257,G,GS,1
NC_037339.1,NC_032661.1,26785466,26527133,26527134,A,AC,1
NC_037339.1,NC_032661.1,26831066,26572734,26572736,g,gac,2
NC_037339.1,NC_032661.1,26911817,26653496,26653497,g,gR,1
NC_037339.1,NC_032661.1,26956083,26697764,26697765,C,CA,1
NC_037339.1,NC_032661.1,26956856,26698539,26698540,c,ca,1
NC_037339.1,NC_032661.1,26971364,26713048,26713051,a,aaag,3
NC_037339.1,NC_032661.1,26971592,26713272,26713273,a,at,1
NC_037339.1,NC_032661.1,26971645,26713326,26713346,t,taaagtggagtttgggatttc,20
NC_037339.1,NC_032661.1,26971913,26713616,26713620,g,gtttt,4
NC_037339.1,NC_032661.1,27021263,26762980,26762982,A,AAC,2
NC_037339.1,NC_032661.1,27022046,26763765,26763786,A,ACATTTGTTAAGCAGCAGAAAG,21
NC_037339.1,NC_032661.1,27065216,26806984,26806987,t,tagc,3
NC_037339.1,NC_032661.1,27072298,26814072,26814073,G,GC,1
NC_037339.1,NC_032661.1,27095845,26837621,26837622,C,CG,1
NC_037339.1,NC_032661.1,27439545,27238891,27238893,a,atg,2
NC_037339.1,NC_032661.1,27476381,27275728,27275730,A,AAG,2
NC_037339.1,NC_032661.1,27476417,27275766,27275767,A,AT,1
NC_037339.1,NC_032661.1,27512928,27312279,27312288,g,gaaacagtgc,9
NC_037339.1,NC_032661.1,27513252,27312613,27312620,g,ggtgttca,7
NC_037339.1,NC_032661.1,27520203,27319571,27319572,A,AM,1
NC_037339.1,NC_032661.1,27800052,27602412,27602413,c,cg,1
NC_037339.1,NC_032661.1,27832144,27634257,27634258,c,ca,1
NC_037339.1,NC_032661.1,27902030,27704158,27704160,a,agg,2
NC_037339.1,NC_032661.1,27931190,27733344,27733348,C,CTATT,4
NC_037339.1,NC_032661.1,27941646,27743804,27743806,T,TAA,2
NC_037339.1,NC_032661.1,28041351,27843579,27843581,g,gta,2
NC_037339.1,NC_032661.1,28059482,27861720,27861721,T,TG,1
NC_037339.1,NC_032661.1,28102576,27904821,27904822,g,gc,1
NC_037339.1,NC_032661.1,28199523,28001764,28001765,a,ag,1
NC_037339.1,NC_032661.1,28369499,28168636,28168640,t,taaaa,4
NC_037339.1,NC_032661.1,28819215,28618303,28618304,c,ca,1
NC_037339.1,NC_032661.1,28908318,28707408,28707409,t,tg,1
NC_037339.1,NC_032661.1,28971183,28770145,28770147,a,aac,2
NC_037339.1,NC_032661.1,29124302,28922576,28922577,G,GA,1
NC_037339.1,NC_032661.1,29124331,28922606,28922607,C,CY,1
NC_037339.1,NC_032661.1,29124364,28922641,28922642,T,TA,1
NC_037339.1,NC_032661.1,29124369,28922647,28922648,C,CT,1
NC_037339.1,NC_032661.1,29324885,29124995,29124997,g,ggt,2
NC_037339.1,NC_032661.1,29348387,29148487,29148488,C,CM,1
NC_037339.1,NC_032661.1,29383878,29183798,29183803,A,ATTTCC,5
NC_037339.1,NC_032661.1,29385247,29185172,29185173,t,tg,1
NC_037339.1,NC_032661.1,29926117,29739934,29739935,G,GS,1
NC_037339.1,NC_032661.1,30150274,29962032,29962034,a,aag,2
NC_037339.1,NC_032661.1,30328864,30140322,30140324,T,TGA,2
NC_037339.1,NC_032661.1,30372991,30254293,30254294,t,ta,1
NC_037339.1,NC_032661.1,30378085,30259383,30259396,a,ataaaataaaattt,13
NC_037339.1,NC_032661.1,30384806,30266105,30266108,g,gcaS,3
NC_037339.1,NC_032661.1,30393876,30275186,30275191,c,cgggag,5
NC_037339.1,NC_032661.1,30413202,30294587,30294588,a,at,1
NC_037339.1,NC_032661.1,30438614,30320001,30320002,c,ct,1
NC_037339.1,NC_032661.1,30449268,30330658,30330663,A,AGCTTT,5
NC_037339.1,NC_032661.1,30485092,30366470,30366471,c,ct,1
NC_037339.1,NC_032661.1,30485092,30380653,30380654,c,ct,1
NC_037339.1,NC_032661.1,30486352,30367731,30367732,a,aN,1
NC_037339.1,NC_032661.1,30488458,30369837,30369841,A,ANNNN,4
NC_037339.1,NC_032661.1,30488460,30384023,30384027,T,TAGNN,4
NC_037339.1,NC_032661.1,30517288,30489863,30489864,a,at,1
NC_037339.1,NC_032661.1,30758376,30731570,30731575,C,CAAGKT,5
NC_037339.1,NC_032661.1,30762230,30735424,30735425,G,GA,1
NC_037339.1,NC_032661.1,30765593,30738783,30738784,a,at,1
NC_037339.1,NC_032661.1,30932974,30906310,30906311,T,TY,1
NC_037339.1,NC_032661.1,30953437,30926675,30926676,a,at,1
NC_037339.1,NC_032661.1,31065148,31038344,31038345,C,CT,1
NC_037339.1,NC_032661.1,31109631,31083779,31083780,t,ta,1
NC_037339.1,NC_032661.1,31229003,31234810,31234811,t,ta,1
NC_037339.1,NC_032661.1,31229126,31234934,31234935,c,ca,1
NC_037339.1,NC_032661.1,31229203,31235011,31235012,t,tN,1
NC_037339.1,NC_032661.1,31337137,31342747,31342748,A,AG,1
NC_037339.1,NC_032661.1,31499541,31507890,31507892,t,taa,2
NC_037339.1,NC_032661.1,31513236,31522114,31522115,A,AT,1
NC_037339.1,NC_032661.1,31592969,31602671,31602672,g,ga,1
NC_037339.1,NC_032661.1,31696723,31706840,31706847,a,aatgcaag,7
NC_037339.1,NC_032661.1,31707024,31717147,31717157,T,TAGAAACTCCC,10
NC_037339.1,NC_032661.1,32189819,32266266,32266267,G,GT,1
NC_037339.1,NC_032661.1,32189857,32266305,32266306,G,GA,1
NC_037339.1,NC_032661.1,32387649,32471219,32471220,C,CG,1
NC_037339.1,NC_032661.1,32397730,32481323,32481324,c,ct,1
NC_037339.1,NC_032661.1,32429404,32512838,32512839,a,at,1
NC_037339.1,NC_032661.1,32553293,32636720,32636721,C,CY,1
NC_037339.1,NC_032661.1,32637488,32720915,32720916,T,TW,1
NC_037339.1,NC_032661.1,32682285,32765819,32765820,T,TA,1
NC_037339.1,NC_032661.1,32707837,32791375,32791376,G,GT,1
NC_037339.1,NC_032661.1,32813999,32949047,32949048,C,CY,1
NC_037339.1,NC_032661.1,32826930,32962338,32962339,A,AT,1
NC_037339.1,NC_032661.1,32843551,32978957,32978959,t,ttc,2
NC_037339.1,NC_032661.1,32922450,33057839,33057841,T,TCA,2
NC_037339.1,NC_032661.1,32965343,33100735,33100737,A,AAM,2
NC_037339.1,NC_032661.1,33018265,33153682,33153683,g,gt,1
NC_037339.1,NC_032661.1,33063582,33199012,33199013,C,CY,1
NC_037339.1,NC_032661.1,33215560,33350402,33350403,A,AT,1
NC_037339.1,NC_032661.1,33407089,33587151,33587155,g,gaaaa,4
NC_037339.1,NC_032661.1,33417591,33597690,33597691,C,CT,1
NC_037339.1,NC_032661.1,33417594,33597694,33597696,A,AAG,2
NC_037339.1,NC_032661.1,33419068,33599172,33599173,A,AW,1
NC_037339.1,NC_032661.1,33419421,33599526,33599529,T,TAAY,3
NC_037339.1,NC_032661.1,33454028,33634138,33634140,a,aaN,2
NC_037339.1,NC_032661.1,33499690,33679807,33679808,G,GA,1
NC_037339.1,NC_032661.1,33576019,33756971,33756975,t,tacac,4
NC_037339.1,NC_032661.1,33593098,33778340,33778341,T,TG,1
NC_037339.1,NC_032661.1,33613480,33798728,33798730,C,CTT,2
NC_037339.1,NC_032661.1,33652932,33838184,33838185,t,ta,1
NC_037339.1,NC_032661.1,33664672,33849927,33849928,c,ca,1
NC_037339.1,NC_032661.1,33665642,33850898,33850902,g,ggtgt,4
NC_037339.1,NC_032661.1,33665889,33851149,33851150,t,tg,1
NC_037339.1,NC_032661.1,33669140,33854401,33854402,t,tg,1
NC_037339.1,NC_032661.1,33711521,34033432,34033450,t,ttgaaaaataaaaaccata,18
NC_037339.1,NC_032661.1,33712784,34034713,34034714,c,ct,1
NC_037339.1,NC_032661.1,33712944,34034874,34034875,c,ca,1
NC_037339.1,NC_032661.1,33713033,34034964,34034967,c,catt,3
NC_037339.1,NC_032661.1,33738512,34060298,34060299,G,GT,1
NC_037339.1,NC_032661.1,33970434,34327487,34327488,C,CA,1
NC_037339.1,NC_032661.1,33988656,34346103,34346104,T,TA,1
NC_037339.1,NC_032661.1,34052266,34409254,34409255,A,AT,1
NC_037339.1,NC_032661.1,34251700,34663079,34663080,A,AC,1
NC_037339.1,NC_032661.1,34287162,34705452,34705457,c,ctcttt,5
NC_037339.1,NC_032661.1,34287208,34705503,34705504,a,ag,1
NC_037339.1,NC_032661.1,34602871,35033761,35033762,G,GA,1
NC_037339.1,NC_032661.1,34675950,35106819,35106820,C,CN,1
NC_037339.1,NC_032661.1,34675957,35106827,35106828,G,GA,1
NC_037339.1,NC_032661.1,34675994,35106866,35106867,G,GA,1
NC_037339.1,NC_032661.1,34676004,35106877,35106879,G,GGC,2
NC_037339.1,NC_032661.1,34753452,35184330,35184331,t,ta,1
NC_037339.1,NC_032661.1,34783169,35214056,35214057,T,TK,1
NC_037339.1,NC_032661.1,34812192,35242821,35242822,a,ag,1
NC_037339.1,NC_032661.1,34899206,35330459,35330469,T,TCGCTGATGAC,10
NC_037339.1,NC_032661.1,35095156,35539438,35539439,c,cg,1
NC_037339.1,NC_032661.1,35273757,35714979,35714980,T,TC,1
NC_037339.1,NC_032661.1,35295343,35736566,35736567,A,AN,1
NC_037339.1,NC_032661.1,35349209,35790432,35790433,C,CA,1
NC_037339.1,NC_032661.1,35424044,35848243,35848244,T,TC,1
NC_037339.1,NC_032661.1,35440339,35864540,35864541,G,GS,1
NC_037339.1,NC_032661.1,35515771,35942335,35942338,t,tagc,3
NC_037339.1,NC_032661.1,35518933,35945500,35945501,t,tc,1
NC_037339.1,NC_032661.1,35836379,36262530,36262531,g,gc,1
NC_037339.1,NC_032661.1,35849600,36275753,36275754,T,TY,1
NC_037339.1,NC_032661.1,35886323,36312828,36312829,G,GR,1
NC_037339.1,NC_032661.1,36168636,36593713,36593714,A,AM,1
NC_037339.1,NC_032661.1,36609464,37054835,37054836,C,CY,1
NC_037339.1,NC_032661.1,37059986,37514898,37514899,t,ta,1
NC_037339.1,NC_032661.1,37236189,37703495,37703497,a,aag,2
NC_037339.1,NC_032661.1,37236466,37703774,37703781,a,aagcacag,7
NC_037339.1,NC_032661.1,37252088,37719403,37719404,c,ct,1
NC_037339.1,NC_032661.1,37293563,37760878,37760879,t,tN,1
NC_037339.1,NC_032661.1,37362355,37828017,37828018,t,ta,1
NC_037339.1,NC_032661.1,37395843,37861508,37861509,c,ca,1
NC_037339.1,NC_032661.1,37475805,37941352,37941358,C,CTCTAAG,6
NC_037339.1,NC_032661.1,37628823,38093041,38093042,T,TG,1
NC_037339.1,NC_032661.1,37640687,38104910,38104911,t,ta,1
NC_037339.1,NC_032661.1,37689083,38153500,38153502,t,tNN,2
NC_037339.1,NC_032661.1,37722646,38187066,38187068,t,tca,2
NC_037339.1,NC_032661.1,37776878,38241302,38241303,a,at,1
NC_037339.1,NC_032661.1,37991256,38462504,38462505,g,gc,1
NC_037339.1,NC_032661.1,38046553,38519596,38519597,A,AG,1
NC_037339.1,NC_032661.1,38047332,38520377,38520378,a,ag,1
NC_037339.1,NC_032661.1,38139103,38612150,38612151,G,GS,1
NC_037339.1,NC_032661.1,38139119,38612167,38612168,T,TK,1
NC_037339.1,NC_032661.1,38154883,38653901,38653902,g,gN,1
NC_037339.1,NC_032661.1,38212811,38713819,38713820,c,ct,1
NC_037339.1,NC_032661.1,38225813,38726920,38726922,t,tNN,2
NC_037339.1,NC_032661.1,38250643,38753710,38753711,g,gt,1
NC_037339.1,NC_032661.1,38285306,38789652,38789653,a,at,1
NC_037339.1,NC_032661.1,38320443,38824415,38824416,g,ga,1
NC_037339.1,NC_032661.1,38413417,38918549,38918550,t,ta,1
NC_037339.1,NC_032661.1,38428300,38933156,38933157,T,TK,1
NC_037339.1,NC_032661.1,38431454,38936311,38936313,t,tNN,2
NC_037339.1,NC_032661.1,38493086,38998025,38998027,a,att,2
NC_037339.1,NC_032661.1,38523800,39028773,39028774,G,GR,1
NC_037339.1,NC_032661.1,38774899,39262829,39262830,C,CN,1
NC_037339.1,NC_032661.1,38848894,39349049,39349050,a,at,1
NC_037339.1,NC_032661.1,38852621,39352777,39352778,C,CA,1
NC_037339.1,NC_032661.1,38920126,39419799,39419800,C,CT,1
NC_037339.1,NC_032661.1,39004449,39506612,39506614,g,gtt,2
NC_037339.1,NC_032661.1,39031676,39533846,39533847,c,ct,1
NC_037339.1,NC_032661.1,39059331,39562841,39562843,c,cca,2
NC_037339.1,NC_032661.1,39073752,39577275,39577276,a,ac,1
NC_037339.1,NC_032661.1,39083612,39587138,39587139,c,cG,1
NC_037339.1,NC_032661.1,39083642,39587169,39587170,C,CG,1
NC_037339.1,NC_032661.1,39091480,39595008,39595009,t,tg,1
NC_037339.1,NC_032661.1,39190524,39697764,39697767,g,gtat,3
NC_037339.1,NC_032661.1,39190738,39697981,39697987,t,tgagaga,6
NC_037339.1,NC_032661.1,39200402,39710327,39710329,a,act,2
NC_037339.1,NC_032661.1,39326569,39838387,39838388,g,gc,1
NC_037339.1,NC_032661.1,39475243,39987071,39987072,A,AW,1
NC_037339.1,NC_032661.1,39547529,40059346,40059347,g,ga,1
NC_037339.1,NC_032661.1,39604433,40116253,40116254,T,TY,1
NC_037339.1,NC_032661.1,39685043,40197550,40197551,G,GT,1
NC_037339.1,NC_032661.1,39980633,40493571,40493588,C,CGGCATATTCCATNNNNN,17
NC_037339.1,NC_032661.1,40033387,40544860,40544863,c,cctt,3
NC_037339.1,NC_032661.1,40072735,40584210,40584211,t,tW,1
NC_037339.1,NC_032661.1,40138050,40651543,40651544,g,ga,1
NC_037339.1,NC_032661.1,40138081,40651575,40651576,t,ta,1
NC_037339.1,NC_032661.1,40138653,40652149,40652150,a,ag,1
NC_037339.1,NC_032661.1,40226883,40734714,40734715,c,ct,1
NC_037339.1,NC_032661.1,40330577,40839423,40839424,g,gt,1
NC_037339.1,NC_032661.1,40434215,40944168,40944169,a,ag,1
NC_037339.1,NC_032661.1,40486453,40996444,40996445,C,CA,1
NC_037339.1,NC_032661.1,40486457,40996449,40996450,T,TA,1
NC_037339.1,NC_032661.1,40540809,41051210,41051211,A,AG,1
NC_037339.1,NC_032661.1,40650625,41186968,41186969,t,tg,1
NC_037339.1,NC_032661.1,40656020,41192360,41192364,C,CNNNN,4
NC_037339.1,NC_032661.1,40681283,41217626,41217628,a,aNN,2
NC_037339.1,NC_032661.1,40764404,41299474,41299475,T,TA,1
NC_037339.1,NC_032661.1,40783674,41318674,41318675,A,AG,1
NC_037339.1,NC_032661.1,41291451,41826878,41826879,c,ca,1
NC_037339.1,NC_032661.1,41362765,41898816,41898817,t,ta,1
NC_037339.1,NC_032661.1,41392851,41930589,41930590,t,ta,1
NC_037339.1,NC_032661.1,41465537,42028779,42028780,g,gt,1
NC_037339.1,NC_032661.1,41481346,42044592,42044593,A,AT,1
NC_037339.1,NC_032661.1,41486491,42049883,42049887,t,tacac,4
NC_037339.1,NC_032661.1,41495180,42058581,42058582,T,TA,1
NC_037339.1,NC_032661.1,41496069,42059473,42059477,a,acgtg,4
NC_037339.1,NC_032661.1,41505062,42068450,42068454,t,tccca,4
NC_037339.1,NC_032661.1,41521851,42088706,42088708,C,CCT,2
NC_037339.1,NC_032661.1,41555519,42122382,42122394,a,aNNNNNNNNNNNN,12
NC_037339.1,NC_032661.1,41650753,42217337,42217338,T,TA,1
NC_037339.1,NC_032661.1,41729261,42295483,42295485,c,cga,2
NC_037339.1,NC_032661.1,41768171,42335566,42335568,g,gga,2
NC_037339.1,NC_032661.1,41773484,42340881,42340883,c,ctt,2
NC_037339.1,NC_032661.1,41851629,42419972,42419974,a,aac,2
NC_037339.1,NC_032661.1,41872743,42441085,42441087,g,gtt,2
NC_037339.1,NC_032661.1,41935894,42504309,42504310,a,ag,1
NC_037339.1,NC_032661.1,41990774,42559438,42559439,T,TC,1
NC_037339.1,NC_032661.1,42016158,42583971,42583972,C,CS,1
NC_037339.1,NC_032661.1,42016625,42585099,42585100,G,GC,1
NC_037339.1,NC_032661.1,42020037,42588512,42588514,C,CTA,2
NC_037339.1,NC_032661.1,42068318,42636741,42636742,A,AR,1
NC_037339.1,NC_032661.1,42094334,42662754,42662755,g,gt,1
NC_037339.1,NC_032661.1,42180822,42782833,42782834,a,ag,1
NC_037339.1,NC_032661.1,42203293,42805302,42805303,g,ga,1
NC_037339.1,NC_032661.1,42395191,42996821,42996823,t,tNN,2
NC_037339.1,NC_032661.1,43237985,43384645,43384649,T,TAGAA,4
NC_037339.1,NC_032661.1,43278599,43426274,43426276,c,cgA,2
NC_037339.1,NC_032661.1,43323862,43471532,43471534,g,gat,2
NC_037339.1,NC_032661.1,43333603,43481272,43481273,a,ac,1
NC_037339.1,NC_032661.1,43333605,43481275,43481276,c,ca,1
NC_037339.1,NC_032661.1,43368430,43517817,43517818,t,tc,1
NC_037339.1,NC_032661.1,43368433,43517821,43517822,a,at,1
NC_037339.1,NC_032661.1,43388152,43537659,43537660,c,ct,1
NC_037339.1,NC_032661.1,43406093,43555605,43555606,c,ct,1
NC_037339.1,NC_032661.1,43422685,43572194,43572195,A,AC,1
NC_037339.1,NC_032661.1,43562397,43711803,43711804,c,ca,1
NC_037339.1,NC_032661.1,43625836,43781711,43781713,A,AAT,2
NC_037339.1,NC_032661.1,43838010,44001490,44001491,c,ct,1
NC_037339.1,NC_032661.1,43849359,44012841,44012842,g,gc,1
NC_037339.1,NC_032661.1,43867807,44031306,44031308,g,gaa,2
NC_037339.1,NC_032661.1,43867889,44031390,44031391,a,ag,1
NC_037339.1,NC_032661.1,43885392,44049152,44049153,c,ct,1
NC_037339.1,NC_032661.1,44094874,44262398,44262411,c,catgaaagtgagaa,13
NC_037339.1,NC_032661.1,44099830,44267367,44267368,A,AG,1
NC_037339.1,NC_032661.1,44134066,44302105,44302106,a,at,1
NC_037339.1,NC_032661.1,44138536,44306576,44306584,g,ggctTATTA,8
NC_037339.1,NC_032661.1,44143312,44311360,44311361,T,TG,1
NC_037339.1,NC_032661.1,44231784,44400129,44400130,a,at,1
NC_037339.1,NC_032661.1,44231796,44400142,44400148,t,tttaagg,6
NC_037339.1,NC_032661.1,44266721,44436059,44436062,t,ttaa,3
NC_037339.1,NC_032661.1,44266751,44436092,44436095,a,aaat,3
NC_037339.1,NC_032661.1,44288446,44457677,44457679,a,aNN,2
NC_037339.1,NC_032661.1,44338567,44507806,44507807,t,ta,1
NC_037339.1,NC_032661.1,44405649,44574790,44574791,t,tc,1
NC_037339.1,NC_032661.1,44536128,44705311,44705312,C,CA,1
NC_037339.1,NC_032661.1,44603224,44776982,44776983,T,TA,1
NC_037339.1,NC_032661.1,44603265,44777024,44777025,C,CT,1
NC_037339.1,NC_032661.1,44603306,44777066,44777068,C,CCA,2
NC_037339.1,NC_032661.1,44630698,44804461,44804462,A,AT,1
NC_037339.1,NC_032661.1,44667815,44843838,44843839,t,ta,1
NC_037339.1,NC_032661.1,44701724,44878681,44878682,g,ga,1
NC_037339.1,NC_032661.1,44725437,44902441,44902442,a,ag,1
NC_037339.1,NC_032661.1,44787806,44964764,44964765,t,tg,1
NC_037339.1,NC_032661.1,44792965,44970290,44970291,c,ca,1
NC_037339.1,NC_032661.1,44824862,45002292,45002298,a,aNNNNNN,6
NC_037339.1,NC_032661.1,44835674,45013452,45013453,c,ca,1
NC_037339.1,NC_032661.1,44892146,45070105,45070114,a,attaaaaaag,9
NC_037339.1,NC_032661.1,44893562,45071530,45071531,T,TY,1
NC_037339.1,NC_032661.1,44898590,45076557,45076558,A,AC,1
NC_037339.1,NC_032661.1,44900228,45078198,45078199,a,ag,1
NC_037339.1,NC_032661.1,44902899,45080873,45080874,C,CY,1
NC_037339.1,NC_032661.1,44910102,45088077,45088080,t,ttaa,3
NC_037339.1,NC_032661.1,44931018,45105704,45105706,a,aNN,2
NC_037339.1,NC_032661.1,44949751,45125239,45125240,c,ca,1
NC_037339.1,NC_032661.1,44963326,45138821,45138823,t,ttg,2
NC_037339.1,NC_032661.1,44965541,45141038,45141040,g,gta,2
NC_037339.1,NC_032661.1,45066467,45243001,45243002,A,AT,1
NC_037339.1,NC_032661.1,45079723,45259178,45259180,a,aat,2
NC_037339.1,NC_032661.1,45087474,45266923,45266925,t,ttg,2
NC_037339.1,NC_032661.1,45088797,45267985,45267986,A,AC,1
NC_037339.1,NC_032661.1,45102952,45282153,45282154,T,TG,1
NC_037339.1,NC_032661.1,45181269,45360496,45360497,T,TA,1
NC_037339.1,NC_032661.1,45205266,45384487,45384492,t,tttaaa,5
NC_037339.1,NC_032661.1,45216162,45395381,45395382,t,tc,1
NC_037339.1,NC_032661.1,45217362,45396582,45396583,a,ag,1
NC_037339.1,NC_032661.1,45222742,45401964,45401977,g,gctttttacttttt,13
NC_037339.1,NC_032661.1,45226026,45405258,45405259,T,TC,1
NC_037339.1,NC_032661.1,45256774,45435891,45435892,a,ac,1
NC_037339.1,NC_032661.1,45285207,45464386,45464387,t,tc,1
NC_037339.1,NC_032661.1,45295915,45475145,45475171,a,aatgcaaagATTAGGTGAAACACACAT,26
NC_037339.1,NC_032661.1,45313116,45492380,45492383,c,cttt,3
NC_037339.1,NC_032661.1,45320191,45499459,45499460,T,TC,1
NC_037339.1,NC_032661.1,45335255,45530004,45530007,t,tttg,3
NC_037339.1,NC_032661.1,45364269,45559024,45559025,G,GK,1
NC_037339.1,NC_032661.1,45422536,45619482,45619483,g,ga,1
NC_037339.1,NC_032661.1,45422964,45619912,45619913,T,TG,1
NC_037339.1,NC_032661.1,45553065,45750912,45750913,c,ct,1
NC_037339.1,NC_032661.1,45611599,45809491,45809493,t,tac,2
NC_037339.1,NC_032661.1,45643815,45841715,45841716,T,TA,1
NC_037339.1,NC_032661.1,45643825,45841726,45841727,T,TA,1
NC_037339.1,NC_032661.1,45657166,45855072,45855075,G,GCCA,3
NC_037339.1,NC_032661.1,45739980,45938241,45938245,a,aaaag,4
NC_037339.1,NC_032661.1,45741187,45939452,45939453,A,AC,1
NC_037339.1,NC_032661.1,45769893,45968157,45968159,a,aNN,2
NC_037339.1,NC_032661.1,45789593,45987858,45987861,c,catt,3
NC_037339.1,NC_032661.1,45836702,46035662,46035663,c,cg,1
NC_037339.1,NC_032661.1,45902270,46101236,46101237,T,TG,1
NC_037339.1,NC_032661.1,45907724,46106689,46106690,T,TY,1
NC_037339.1,NC_032661.1,45921563,46120535,46120537,t,tNN,2
NC_037339.1,NC_032661.1,45961237,46162807,46162809,a,aNN,2
NC_037339.1,NC_032661.1,45977893,46264483,46264484,g,ga,1
NC_037339.1,NC_032661.1,45984821,46271412,46271414,g,ggt,2
NC_037339.1,NC_032661.1,45988955,46288658,46288661,C,CCTA,3
NC_037339.1,NC_032661.1,46063554,46362686,46362688,a,agN,2
NC_037339.1,NC_032661.1,46082032,46381138,46381139,G,GS,1
NC_037339.1,NC_032661.1,46120162,46420771,46420772,C,CA,1
NC_037339.1,NC_032661.1,46135936,46436549,46436550,C,CA,1
NC_037339.1,NC_032661.1,46315885,46616889,46616890,t,ta,1
NC_037339.1,NC_032661.1,46319996,46621001,46621003,a,agg,2
NC_037339.1,NC_032661.1,46327256,46628262,46628264,t,tNN,2
NC_037339.1,NC_032661.1,46468407,46769400,46769403,a,atat,3
NC_037339.1,NC_032661.1,46469030,46770026,46770027,c,ct,1
NC_037339.1,NC_032661.1,46533737,46834727,46834729,T,TAG,2
NC_037339.1,NC_032661.1,46604471,46905166,46905167,A,AT,1
NC_037339.1,NC_032661.1,46615355,46916055,46916056,t,tW,1
NC_037339.1,NC_032661.1,46673869,46974565,46974566,c,ca,1
NC_037339.1,NC_032661.1,46694254,47077747,47077748,c,ca,1
NC_037339.1,NC_032661.1,46701675,47085114,47085115,t,ta,1
NC_037339.1,NC_032661.1,46711783,47095230,47095231,t,tc,1
NC_037339.1,NC_032661.1,46711921,47095367,47095368,g,gc,1
NC_037339.1,NC_032661.1,46713713,47097160,47097169,C,CAACGGTATT,9
NC_037339.1,NC_032661.1,46738632,47122092,47122106,T,TAACAGGTCAACAGC,14
NC_037339.1,NC_032661.1,46738712,47122186,47122188,T,TTA,2
NC_037339.1,NC_032661.1,46982375,47330442,47330443,A,AT,1
NC_037339.1,NC_032661.1,46983989,47332058,47332067,T,TGGGCATTTC,9
NC_037339.1,NC_032661.1,47036931,47384908,47384911,a,agag,3
NC_037339.1,NC_032661.1,47038002,47385983,47385985,g,gcc,2
NC_037339.1,NC_032661.1,47047561,47395679,47395680,g,ga,1
NC_037339.1,NC_032661.1,47096728,47444283,47444284,t,tc,1
NC_037339.1,NC_032661.1,47112766,47460356,47460357,a,at,1
NC_037339.1,NC_032661.1,47131024,47478616,47478628,A,AATATCAGCCAAT,12
NC_037339.1,NC_032661.1,47148045,47495650,47495654,t,tNNNN,4
NC_037339.1,NC_032661.1,47174942,47522038,47522039,a,at,1
NC_037339.1,NC_032661.1,47304060,47651159,47651160,g,ga,1
NC_037339.1,NC_032661.1,47304629,47651729,47651730,a,at,1
NC_037339.1,NC_032661.1,47317237,47664326,47664327,T,TA,1
NC_037339.1,NC_032661.1,47317951,47665038,47665039,T,TA,1
NC_037339.1,NC_032661.1,47383731,47728863,47728864,a,ag,1
NC_037339.1,NC_032661.1,47388669,47734713,47734714,G,GA,1
NC_037339.1,NC_032661.1,47407458,47753503,47753504,g,ga,1
NC_037339.1,NC_032661.1,47428241,47774294,47774295,g,gN,1
NC_037339.1,NC_032661.1,47464325,47810164,47810165,T,TC,1
NC_037339.1,NC_032661.1,47490487,47836385,47836386,t,tA,1
NC_037339.1,NC_032661.1,47490827,47836726,47836727,T,TG,1
NC_037339.1,NC_032661.1,47503933,47849836,47849837,T,TG,1
NC_037339.1,NC_032661.1,47527498,47872979,47872992,G,GTTGAACACTTGAA,13
NC_037339.1,NC_032661.1,47542410,47887911,47887912,G,GR,1
NC_037339.1,NC_032661.1,47720950,48066384,48066390,A,AAAGCCC,6
NC_037339.1,NC_032661.1,47734593,48080034,48080035,c,ca,1
NC_037339.1,NC_032661.1,47742249,48087692,48087693,g,gt,1
NC_037339.1,NC_032661.1,47756261,48101628,48101629,t,tg,1
NC_037339.1,NC_032661.1,47756961,48102329,48102331,c,ctt,2
NC_037339.1,NC_032661.1,47782366,48131215,48131216,A,AC,1
NC_037339.1,NC_032661.1,47798758,48147608,48147609,C,CG,1
NC_037339.1,NC_032661.1,47808019,48156871,48156873,G,GTT,2
NC_037339.1,NC_032661.1,47836044,48184905,48184906,T,TA,1
NC_037339.1,NC_032661.1,47898231,48247526,48247527,C,CT,1
NC_037339.1,NC_032661.1,47933064,48282394,48282395,C,CG,1
NC_037339.1,NC_032661.1,48009536,48358867,48358869,G,GGT,2
NC_037339.1,NC_032661.1,48012479,48361812,48361813,c,ca,1
NC_037339.1,NC_032661.1,48102824,48452651,48452653,g,gaa,2
NC_037339.1,NC_032661.1,48103213,48453042,48453043,t,tN,1
NC_037339.1,NC_032661.1,48109918,48459750,48459751,t,tc,1
NC_037339.1,NC_032661.1,48137281,48487119,48487121,G,GTR,2
NC_037339.1,NC_032661.1,48163239,48513108,48513111,c,cttt,3
NC_037339.1,NC_032661.1,48232053,48581866,48581876,a,aNNNNNNNNNN,10
NC_037339.1,NC_032661.1,48254293,48604108,48604109,g,ga,1
NC_037339.1,NC_032661.1,48255798,48605615,48605616,A,AW,1
NC_037339.1,NC_032661.1,48270398,48619808,48619810,t,tta,2
NC_037339.1,NC_032661.1,48274861,48624274,48624275,A,AR,1
NC_037339.1,NC_032661.1,48293737,48643152,48643181,A,ANNNNNNNNNNNNNNNNNNNNNNNNNNNNN,29
NC_037339.1,NC_032661.1,48336113,48682213,48682214,T,TA,1
NC_037339.1,NC_032661.1,48413515,48760351,48760355,g,gaaaa,4
NC_037339.1,NC_032661.1,48416053,48762888,48762889,a,at,1
NC_037339.1,NC_032661.1,48577256,48925288,48925307,g,gcattagctgctttattgac,19
NC_037339.1,NC_032661.1,48597324,48945375,48945376,g,ga,1
NC_037339.1,NC_032661.1,48623026,48971102,48971112,g,gggtgcatgta,10
NC_037339.1,NC_032661.1,48628003,48976084,48976085,t,tg,1
NC_037339.1,NC_032661.1,48630908,48978989,48978990,t,ta,1
NC_037339.1,NC_032661.1,48673614,49021738,49021739,T,TC,1
NC_037339.1,NC_032661.1,48698551,49047434,49047435,c,ct,1
NC_037339.1,NC_032661.1,48698556,49047440,49047442,c,cct,2
NC_037339.1,NC_032661.1,48780026,49144773,49144774,G,GA,1
NC_037339.1,NC_032661.1,48810122,49174882,49174883,T,TG,1
NC_037339.1,NC_032661.1,48811524,49176311,49176312,T,TA,1
NC_037339.1,NC_032661.1,48817676,49182465,49182468,C,CAAT,3
NC_037339.1,NC_032661.1,48819902,49184691,49184692,g,ga,1
NC_037339.1,NC_032661.1,48820252,49185043,49185047,T,TCTAA,4
NC_037339.1,NC_032661.1,48837223,49202016,49202017,A,AN,1
NC_037339.1,NC_032661.1,48839497,49204288,49204292,a,aNNNN,4
NC_037339.1,NC_032661.1,48841074,49205868,49205883,a,acaaagagtcggacac,15
NC_037339.1,NC_032661.1,48858442,49229707,49229708,A,AT,1
NC_037339.1,NC_032661.1,48875836,49247125,49247126,T,TG,1
NC_037339.1,NC_032661.1,48878308,49249598,49249600,G,GGT,2
NC_037339.1,NC_032661.1,48897921,49269235,49269236,T,TY,1
NC_037339.1,NC_032661.1,49222566,49595296,49595298,g,gga,2
NC_037339.1,NC_032661.1,49315639,49694295,49694296,G,GT,1
NC_037339.1,NC_032661.1,49398535,49793751,49793752,t,tc,1
NC_037339.1,NC_032661.1,49422035,49817253,49817254,t,tg,1
NC_037339.1,NC_032661.1,49450265,49844195,49844199,t,tacta,4
NC_037339.1,NC_032661.1,49468128,49862069,49862070,t,tg,1
NC_037339.1,NC_032661.1,49468725,49862663,49862664,a,ag,1
NC_037339.1,NC_032661.1,49484772,49878717,49878719,C,CTT,2
NC_037339.1,NC_032661.1,49568305,49961239,49961251,a,agtgtgtgtgtgt,12
NC_037339.1,NC_032661.1,49568721,49961665,49961671,G,GTTTAAT,6
NC_037339.1,NC_032661.1,49572610,49965561,49965565,T,TTTAA,4
NC_037339.1,NC_032661.1,49575774,49968730,49968731,C,CA,1
NC_037339.1,NC_032661.1,49620690,50013668,50013669,T,TK,1
NC_037339.1,NC_032661.1,49621071,50014050,50014054,G,GCAGA,4
NC_037339.1,NC_032661.1,49622388,50016271,50016279,c,catatatat,8
NC_037339.1,NC_032661.1,49626788,50020679,50020680,a,aM,1
NC_037339.1,NC_032661.1,49661484,50055369,50055370,t,tg,1
NC_037339.1,NC_032661.1,49669057,50062945,50062959,a,aNNNNNNNNNNNNNN,14
NC_037339.1,NC_032661.1,49670869,50064770,50064771,C,CT,1
NC_037339.1,NC_032661.1,49714572,50108488,50108489,A,AT,1
NC_037339.1,NC_032661.1,49727811,50121746,50121750,a,aNNNN,4
NC_037339.1,NC_032661.1,49728308,50122247,50122263,g,gacacacacacacacac,16
NC_037339.1,NC_032661.1,49729127,50123082,50123097,A,AGTTTATCCCTGTTAT,15
NC_037339.1,NC_032661.1,49730228,50124198,50124200,a,att,2
NC_037339.1,NC_032661.1,49732998,50126974,50126975,T,TC,1
NC_037339.1,NC_032661.1,49733133,50127110,50127111,T,TC,1
NC_037339.1,NC_032661.1,49734231,50128209,50128210,t,ta,1
NC_037339.1,NC_032661.1,49771713,50165695,50165697,c,ctg,2
NC_037339.1,NC_032661.1,49777576,50171560,50171562,T,TAA,2
NC_037339.1,NC_032661.1,49878175,50279538,50279550,C,CTCTGCACAATCY,12
NC_037339.1,NC_032661.1,49900569,50301940,50301942,T,TGA,2
NC_037339.1,NC_032661.1,49902028,50303401,50303403,c,cat,2
NC_037339.1,NC_032661.1,49911967,50313348,50313349,g,ga,1
NC_037339.1,NC_032661.1,49948041,50349438,50349439,G,GT,1
NC_037339.1,NC_032661.1,49956670,50358068,50358090,a,aaaatttaaaaaaaaataaaatt,22
NC_037339.1,NC_032661.1,49958222,50359641,50359642,G,GA,1
NC_037339.1,NC_032661.1,50057009,50990750,50990751,t,tc,1
NC_037339.1,NC_032661.1,50646524,51106114,51106116,a,aat,2
NC_037339.1,NC_032661.1,50652973,51112566,51112567,T,TA,1
NC_037339.1,NC_032661.1,50703499,51175186,51175187,a,at,1
NC_037339.1,NC_032661.1,50703538,51175226,51175228,g,gcc,2
NC_037339.1,NC_032661.1,50741563,51212922,51212949,A,ATGCTTCTAKAGACTCTTGTATGTGTTT,27
NC_037339.1,NC_032661.1,50782883,51254470,51254471,t,tW,1
NC_037339.1,NC_032661.1,50812642,51284196,51284197,C,CT,1
NC_037339.1,NC_032661.1,50812683,51284238,51284239,g,ga,1
NC_037339.1,NC_032661.1,50831180,51302742,51302743,c,ct,1
NC_037339.1,NC_032661.1,50863478,51335071,51335072,T,TA,1
NC_037339.1,NC_032661.1,50876840,51348425,51348432,T,TGTATCAA,7
NC_037339.1,NC_032661.1,50894904,51366559,51366560,t,tc,1
NC_037339.1,NC_032661.1,50895952,51367608,51367609,C,CT,1
NC_037339.1,NC_032661.1,50902486,51374143,51374144,t,tc,1
NC_037339.1,NC_032661.1,50902514,51374172,51374173,C,CY,1
NC_037339.1,NC_032661.1,50921910,51393563,51393565,t,ttc,2
NC_037339.1,NC_032661.1,50929424,51401080,51401083,c,cttt,3
NC_037339.1,NC_032661.1,50951412,51423069,51423070,a,at,1
NC_037339.1,NC_032661.1,50954072,51425730,51425731,A,AG,1
NC_037339.1,NC_032661.1,50958832,51430493,51430494,A,AC,1
NC_037339.1,NC_032661.1,51006697,51478379,51478380,a,at,1
NC_037339.1,NC_032661.1,51023519,51495203,51495204,C,CY,1
NC_037339.1,NC_032661.1,51025175,51496860,51496862,A,AAC,2
NC_037339.1,NC_032661.1,51042525,51514529,51514530,a,ag,1
NC_037339.1,NC_032661.1,51052203,51524211,51524213,a,aat,2
NC_037339.1,NC_032661.1,51057338,51529351,51529355,g,ggaaa,4
NC_037339.1,NC_032661.1,51074595,51546608,51546612,T,TAGAC,4
NC_037339.1,NC_032661.1,51075791,51547809,51547819,C,CTTCCATGCAA,10
NC_037339.1,NC_032661.1,51082044,51554071,51554072,c,ca,1
NC_037339.1,NC_032661.1,51132771,51607794,51607795,c,ca,1
NC_037339.1,NC_032661.1,51135852,51610877,51610878,a,ac,1
NC_037339.1,NC_032661.1,51306243,51821886,51821887,A,AR,1
NC_037339.1,NC_032661.1,51306286,51821930,51821931,t,tc,1
NC_037339.1,NC_032661.1,51308972,51824619,51824620,T,TA,1
NC_037339.1,NC_032661.1,51310955,51826605,51826606,A,AG,1
NC_037339.1,NC_032661.1,51324231,51860975,51860976,g,ga,1
NC_037339.1,NC_032661.1,51582319,52108586,52108595,g,gggaaacagt,9
NC_037339.1,NC_032661.1,51585460,52111736,52111738,T,TGA,2
NC_037339.1,NC_032661.1,51622630,52149126,52149131,t,taagaa,5
NC_037339.1,NC_032661.1,51625894,52152390,52152391,c,ct,1
NC_037339.1,NC_032661.1,51625947,52152444,52152445,g,ga,1
NC_037339.1,NC_032661.1,51635752,52162255,52162256,g,ga,1
NC_037339.1,NC_032661.1,51646077,52172577,52172580,a,aaac,3
NC_037339.1,NC_032661.1,51669924,52196427,52196429,A,AAG,2
NC_037339.1,NC_032661.1,51674202,52200707,52200708,A,AR,1
NC_037339.1,NC_032661.1,51677227,52203735,52203736,T,TG,1
NC_037339.1,NC_032661.1,51691685,52218194,52218195,a,ac,1
NC_037339.1,NC_032661.1,51734386,52260899,52260900,t,ta,1
NC_037339.1,NC_032661.1,51735183,52261697,52261698,T,TY,1
NC_037339.1,NC_032661.1,51752428,52278513,52278514,t,tg,1
NC_037339.1,NC_032661.1,51778085,52304378,52304380,a,aNN,2
NC_037339.1,NC_032661.1,51898839,52423078,52423079,a,at,1
NC_037339.1,NC_032661.1,51899040,52423280,52423281,G,GA,1
NC_037339.1,NC_032661.1,51923143,52447275,52447276,C,CM,1
NC_037339.1,NC_032661.1,52039413,52563875,52563879,a,atttt,4
NC_037339.1,NC_032661.1,52041877,52566344,52566347,g,gaaa,3
NC_037339.1,NC_032661.1,52041915,52566385,52566387,g,gga,2
NC_037339.1,NC_032661.1,52042545,52567017,52567018,a,ac,1
NC_037339.1,NC_032661.1,52047690,52572163,52572164,t,tg,1
NC_037339.1,NC_032661.1,52073856,52598036,52598037,T,TG,1
NC_037339.1,NC_032661.1,52073948,52598129,52598247,T,TTTTGCCTTTGGGGCAATAACtgtaacagtgaaagtgaaattgaaaagtAACATCAAGAGTTGCAAAGAAAGTTGTGTTTTAACACCNNNNNNNNNNNNNNNNNNNNNNNNNACAATAG,118
NC_037339.1,NC_032661.1,52081494,52605792,52605803,c,ccttcactttca,11
NC_037339.1,NC_032661.1,52089134,52613445,52613449,t,tNNNN,4
NC_037339.1,NC_032661.1,52104695,52629035,52629037,g,gac,2
NC_037339.1,NC_032661.1,52136469,52660734,52660735,C,CM,1
NC_037339.1,NC_032661.1,52148813,52673088,52673089,t,tg,1
NC_037339.1,NC_032661.1,52202098,52726379,52726380,T,TA,1
NC_037339.1,NC_032661.1,52226241,52750529,52750530,T,TA,1
NC_037339.1,NC_032661.1,52227315,52751604,52751605,c,ca,1
NC_037339.1,NC_032661.1,52317341,52841641,52841646,c,cataca,5
NC_037339.1,NC_032661.1,52349077,52873225,52873227,t,tNN,2
NC_037339.1,NC_032661.1,52455543,52979469,52979470,t,ta,1
NC_037339.1,NC_032661.1,52485490,53008875,53008876,a,ac,1
NC_037339.1,NC_032661.1,52551009,53074400,53074411,g,ggtctccttgca,11
NC_037339.1,NC_032661.1,52575487,53098912,53098913,g,ga,1
NC_037339.1,NC_032661.1,52591909,53115333,53115339,g,gtttttt,6
NC_037339.1,NC_032661.1,52593533,53116963,53116964,G,GT,1
NC_037339.1,NC_032661.1,52594215,53117648,53117649,A,AT,1
NC_037339.1,NC_032661.1,52657696,53181156,53181157,T,TY,1
NC_037339.1,NC_032661.1,52668049,53191638,53191639,G,GC,1
NC_037339.1,NC_032661.1,52874998,53456229,53456233,C,CCAAA,4
NC_037339.1,NC_032661.1,52882047,53463280,53463281,T,TA,1
NC_037339.1,NC_032661.1,52899708,53480942,53480944,C,CAG,2
NC_037339.1,NC_032661.1,52904413,53485654,53485655,C,CY,1
NC_037339.1,NC_032661.1,52908140,53489383,53489399,G,GTTCCTTGACATCAATC,16
NC_037339.1,NC_032661.1,53018270,53604025,53604027,a,aag,2
NC_037339.1,NC_032661.1,53023639,53609403,53609404,c,ca,1
NC_037339.1,NC_032661.1,53043760,53629399,53629400,t,ta,1
NC_037339.1,NC_032661.1,53044263,53629902,53629903,t,tg,1
NC_037339.1,NC_032661.1,53051608,53640319,53640320,a,ac,1
NC_037339.1,NC_032661.1,53122382,53710429,53710430,A,AT,1
NC_037339.1,NC_032661.1,53122424,53710472,53710473,T,TG,1
NC_037339.1,NC_032661.1,53122476,53710526,53710527,C,CT,1
NC_037339.1,NC_032661.1,53122483,53710534,53710536,G,GGA,2
NC_037339.1,NC_032661.1,53122511,53710565,53710566,T,TC,1
NC_037339.1,NC_032661.1,53122516,53710571,53710572,G,GA,1
NC_037339.1,NC_032661.1,53128468,53716602,53716603,T,TK,1
NC_037339.1,NC_032661.1,53208890,53796903,53796907,a,aRGGG,4
NC_037339.1,NC_032661.1,53208976,53796997,53796998,t,ta,1
NC_037339.1,NC_032661.1,53212468,53800501,53800502,G,GM,1
NC_037339.1,NC_032661.1,53215456,53803483,53803484,t,tg,1
NC_037339.1,NC_032661.1,53216728,53804756,53804757,g,ga,1
NC_037339.1,NC_032661.1,53226313,53814340,53814342,a,aat,2
NC_037339.1,NC_032661.1,53226330,53814359,53814360,t,ta,1
NC_037339.1,NC_032661.1,53228619,53816648,53816649,a,at,1
NC_037339.1,NC_032661.1,53241841,53829761,53829819,c,cttattttaagNNNNNNNNNNNNNNNNNNNNNNNNNNNNNNNNNNNNNNNNNNNNNNca,58
NC_037339.1,NC_032661.1,53242173,53830150,53830154,t,tacac,4
NC_037339.1,NC_032661.1,53247159,53835113,53835114,G,GK,1
NC_037339.1,NC_032661.1,53272089,53860029,53860031,a,aNN,2
NC_037339.1,NC_032661.1,53318721,53906672,53906673,A,AR,1
NC_037339.1,NC_032661.1,53338823,53926791,53926792,a,at,1
NC_037339.1,NC_032661.1,53343588,53931556,53931563,C,CTCTGGCA,7
NC_037339.1,NC_032661.1,53343706,53931681,53931682,t,tg,1
NC_037339.1,NC_032661.1,53350762,53938737,53938739,a,aat,2
NC_037339.1,NC_032661.1,53372898,53960879,53960890,a,agaaaCAATGAC,11
NC_037339.1,NC_032661.1,53393266,53980780,53980784,a,atttt,4
NC_037339.1,NC_032661.1,53404619,53992160,53992161,t,tc,1
NC_037339.1,NC_032661.1,53405135,53992677,53992678,t,tY,1
NC_037339.1,NC_032661.1,53405145,53992688,53992690,t,ttg,2
NC_037339.1,NC_032661.1,53410612,53998152,53998153,T,TW,1
NC_037339.1,NC_032661.1,53429517,54017057,54017058,c,ca,1
NC_037339.1,NC_032661.1,53456239,54043778,54043786,g,gccatccaa,8
NC_037339.1,NC_032661.1,53456545,54044091,54044092,g,gc,1
NC_037339.1,NC_032661.1,53456611,54044158,54044162,c,caaaa,4
NC_037339.1,NC_032661.1,53524141,54111864,54111866,A,AAT,2
NC_037339.1,NC_032661.1,53528426,54116149,54116151,a,aat,2
NC_037339.1,NC_032661.1,53534919,54122641,54122648,t,tttttttc,7
NC_037339.1,NC_032661.1,53549430,54137157,54137159,T,TTG,2
NC_037339.1,NC_032661.1,53568339,54156072,54156073,C,CT,1
NC_037339.1,NC_032661.1,53624997,54212533,54212534,t,tC,1
NC_037339.1,NC_032661.1,53794516,54382394,54382395,G,GA,1
NC_037339.1,NC_032661.1,53822811,54410698,54410700,a,aag,2
NC_037339.1,NC_032661.1,53830658,54418544,54418550,G,GCATTGA,6
NC_037339.1,NC_032661.1,53836934,54424922,54424923,a,ac,1
NC_037339.1,NC_032661.1,53852858,54440864,54440869,a,acatac,5
NC_037339.1,NC_032661.1,53913540,54501337,54501338,A,AG,1
NC_037339.1,NC_032661.1,53922743,54510512,54510514,A,AAT,2
NC_037339.1,NC_032661.1,53925682,54513454,54513455,C,CM,1
NC_037339.1,NC_032661.1,53971076,54561575,54561577,g,gac,2
NC_037339.1,NC_032661.1,53971602,54562103,54562105,T,TAK,2
NC_037339.1,NC_032661.1,54039703,54641517,54641518,t,ta,1
NC_037339.1,NC_032661.1,54051946,54653761,54653762,C,CY,1
NC_037339.1,NC_032661.1,54052753,54654570,54654576,A,AGACGTG,6
NC_037339.1,NC_032661.1,54121539,54722533,54722534,T,TG,1
NC_037339.1,NC_032661.1,54129344,54730339,54730354,a,aaaaaataNNNNNNNN,15
NC_037339.1,NC_032661.1,54133741,54734751,54734752,a,aN,1
NC_037339.1,NC_032661.1,54161425,54762440,54762441,c,cM,1
NC_037339.1,NC_032661.1,54162104,54763158,54763159,T,TA,1
NC_037339.1,NC_032661.1,54163776,54764831,54764832,A,AG,1
NC_037339.1,NC_032661.1,54319939,54823796,54823797,g,ga,1
NC_037339.1,NC_032661.1,54353832,54858183,54858185,T,TAA,2
NC_037339.1,NC_032661.1,54355966,54860026,54860027,G,GA,1
NC_037339.1,NC_032661.1,54448656,54952970,54952971,g,ga,1
NC_037339.1,NC_032661.1,54448669,54952984,54952988,t,tgcga,4
NC_037339.1,NC_032661.1,54448907,54953226,54953227,c,ca,1
NC_037339.1,NC_032661.1,54467319,54971640,54971641,T,TK,1
NC_037339.1,NC_032661.1,54476993,54981316,54981319,A,ATCC,3
NC_037339.1,NC_032661.1,54528334,55032644,55032645,g,ga,1
NC_037339.1,NC_032661.1,54528499,55032810,55032828,t,tNNNNNNNNNNNNNNNNNN,18
NC_037339.1,NC_032661.1,54571512,55075844,55075845,t,tg,1
NC_037339.1,NC_032661.1,54571532,55075865,55075866,a,at,1
NC_037339.1,NC_032661.1,54571540,55075874,55075875,a,at,1
NC_037339.1,NC_032661.1,54571554,55075889,55075890,a,at,1
NC_037339.1,NC_032661.1,54571557,55075893,55075894,c,ca,1
NC_037339.1,NC_032661.1,54633154,55137492,55137493,a,at,1
NC_037339.1,NC_032661.1,54670383,55174699,55174700,g,gc,1
NC_037339.1,NC_032661.1,54679081,55183409,55183419,A,ATGAACGCAGT,10
NC_037339.1,NC_032661.1,54682948,55187282,55187283,A,AT,1
NC_037339.1,NC_032661.1,54683776,55188112,55188113,a,at,1
NC_037339.1,NC_032661.1,54683782,55188119,55188120,a,at,1
NC_037339.1,NC_032661.1,54685093,55189431,55189433,g,gat,2
NC_037339.1,NC_032661.1,54689815,55194154,55194155,c,ct,1
NC_037339.1,NC_032661.1,54693573,55197928,55197929,G,GA,1
NC_037339.1,NC_032661.1,54694758,55199245,55199246,g,ga,1
NC_037339.1,NC_032661.1,54696603,55201090,55201091,T,TA,1
NC_037339.1,NC_032661.1,54734163,55238660,55238661,A,AN,1
NC_037339.1,NC_032661.1,54748198,55252707,55252710,t,ttta,3
NC_037339.1,NC_032661.1,54753495,55258008,55258009,c,ct,1
NC_037339.1,NC_032661.1,54753962,55258474,55258475,a,ag,1
NC_037339.1,NC_032661.1,54820861,55325404,55325405,c,cg,1
NC_037339.1,NC_032661.1,54839287,55343452,55343453,a,at,1
NC_037339.1,NC_032661.1,54917809,55421985,55421986,t,ta,1
NC_037339.1,NC_032661.1,54951180,55455364,55455366,t,tNN,2
NC_037339.1,NC_032661.1,54963697,55467886,55467888,A,AAR,2
NC_037339.1,NC_032661.1,54967482,55471672,55471673,A,AG,1
NC_037339.1,NC_032661.1,54994844,55499040,55499041,A,AR,1
NC_037339.1,NC_032661.1,55018947,55523121,55523124,g,gaga,3
NC_037339.1,NC_032661.1,55019325,55523502,55523503,g,ga,1
NC_037339.1,NC_032661.1,55019854,55524038,55524039,t,tN,1
NC_037339.1,NC_032661.1,55034229,55538413,55538414,c,cg,1
NC_037339.1,NC_032661.1,55080731,55584659,55584660,C,CA,1
NC_037339.1,NC_032661.1,55082232,55586161,55586162,A,AC,1
NC_037339.1,NC_032661.1,55111394,55616111,55616129,T,TCTGAGTAACAATAGCCAA,18
NC_037339.1,NC_032661.1,55127131,55631885,55631888,A,AAAC,3
NC_037339.1,NC_032661.1,55130594,55635350,55635351,t,tN,1
NC_037339.1,NC_032661.1,55155946,55717364,55717365,t,tN,1
NC_037339.1,NC_032661.1,55185786,55747221,55747223,t,taa,2
NC_037339.1,NC_032661.1,55235966,55797752,55797759,a,acaaaaac,7
NC_037339.1,NC_032661.1,55255838,55817633,55817634,t,ta,1
NC_037339.1,NC_032661.1,55256407,55818203,55818204,c,ct,1
NC_037339.1,NC_032661.1,55265966,55827766,55827767,c,ct,1
NC_037339.1,NC_032661.1,55278504,55840751,55840752,A,AW,1
NC_037339.1,NC_032661.1,55278666,55840914,55840915,G,GY,1
NC_037339.1,NC_032661.1,55279678,55841927,55841928,t,tg,1
NC_037339.1,NC_032661.1,55283093,55845346,55845347,C,CM,1
NC_037339.1,NC_032661.1,55285085,55848451,55848452,T,TG,1
NC_037339.1,NC_032661.1,55288594,55851961,55851963,t,taa,2
NC_037339.1,NC_032661.1,55290097,55853464,55853467,C,CAAA,3
NC_037339.1,NC_032661.1,55290374,55853743,55853744,G,GA,1
NC_037339.1,NC_032661.1,55292211,55857138,55857139,A,AG,1
NC_037339.1,NC_032661.1,55299697,55864625,55864626,c,ct,1
NC_037339.1,NC_032661.1,55299730,55864658,55864659,g,ga,1
NC_037339.1,NC_032661.1,55299840,55864770,55864771,c,cg,1
NC_037339.1,NC_032661.1,55302267,55867197,55867198,T,TA,1
NC_037339.1,NC_032661.1,55411190,55979235,55979236,G,GA,1
NC_037339.1,NC_032661.1,55457743,56025648,56025649,c,ct,1
NC_037339.1,NC_032661.1,55489174,56057095,56057096,G,GC,1
NC_037339.1,NC_032661.1,55543652,56111572,56111573,C,CA,1
NC_037339.1,NC_032661.1,55553479,56121400,56121401,g,gc,1
NC_037339.1,NC_032661.1,55566844,56134758,56134759,t,ta,1
NC_037339.1,NC_032661.1,55566855,56134770,56134771,t,ta,1
NC_037339.1,NC_032661.1,55567485,56135401,56135403,t,taa,2
NC_037339.1,NC_032661.1,55578558,56146480,56146482,a,acc,2
NC_037339.1,NC_032661.1,55578569,56146493,56146494,g,ga,1
NC_037339.1,NC_032661.1,55644504,56213778,56213781,C,CCTT,3
NC_037339.1,NC_032661.1,55652058,56221354,56221356,T,TCC,2
NC_037339.1,NC_032661.1,55686910,56256220,56256221,a,at,1
NC_037339.1,NC_032661.1,55686933,56256244,56256246,c,caa,2
NC_037339.1,NC_032661.1,55703156,56272472,56272473,T,TG,1
NC_037339.1,NC_032661.1,55712966,56282284,56282286,C,CAA,2
NC_037339.1,NC_032661.1,55715593,56284913,56284914,t,tc,1
NC_037339.1,NC_032661.1,55723223,56292543,56292544,C,CA,1
NC_037339.1,NC_032661.1,55741733,56324343,56324344,c,ct,1
NC_037339.1,NC_032661.1,55767156,56349773,56349775,c,cct,2
NC_037339.1,NC_032661.1,55814740,56397304,56397305,T,TA,1
NC_037339.1,NC_032661.1,55814746,56397311,56397312,T,TY,1
NC_037339.1,NC_032661.1,55825126,56407696,56407698,a,agt,2
NC_037339.1,NC_032661.1,55872035,56454640,56454642,c,cat,2
NC_037339.1,NC_032661.1,55882149,56464758,56464759,A,AR,1
NC_037339.1,NC_032661.1,55969383,56552084,56552086,g,gta,2
NC_037339.1,NC_032661.1,55988074,56570778,56570779,g,gc,1
NC_037339.1,NC_032661.1,55997622,56580328,56580329,g,ga,1
NC_037339.1,NC_032661.1,56065267,56647790,56647792,a,att,2
NC_037339.1,NC_032661.1,56065388,56647913,56647923,a,aagaaataagt,10
NC_037339.1,NC_032661.1,56078035,56660570,56660580,a,aagaaataagt,10
NC_037339.1,NC_032661.1,56183718,56765934,56765936,t,taa,2
NC_037339.1,NC_032661.1,56270122,56852576,56852593,C,CCAAACAAAccactatta,17
NC_037339.1,NC_032661.1,56279029,56861503,56861504,t,tg,1
NC_037339.1,NC_032661.1,56283372,56865847,56865848,g,ga,1
NC_037339.1,NC_032661.1,56323426,56905912,56905913,c,cg,1
NC_037339.1,NC_032661.1,56366247,56948413,56948414,C,CT,1
NC_037339.1,NC_032661.1,56370066,56952254,56952256,a,atc,2
NC_037339.1,NC_032661.1,56379491,56961180,56961182,T,TAA,2
NC_037339.1,NC_032661.1,56395022,56976573,56976576,C,CATT,3
NC_037339.1,NC_032661.1,56401781,56983330,56983332,t,tta,2
NC_037339.1,NC_032661.1,56453903,57035307,57035308,c,ca,1
NC_037339.1,NC_032661.1,56453977,57035382,57035519,a,aatatgtgaaccgtgaacttcctgatgttcaagctggttttagaaaaggcagaggaaccagagatcaaattgccaatatccgctggatcacaggaaaagcaagagagttccagaaaaacatctatttctactttattg,137
NC_037339.1,NC_032661.1,56455130,57036672,57036673,T,TK,1
NC_037339.1,NC_032661.1,56474938,57056362,57056363,G,GA,1
NC_037339.1,NC_032661.1,56480570,57061978,57061979,c,ct,1
NC_037339.1,NC_032661.1,56485611,57067014,57067025,G,GAAACTCTATTA,11
NC_037339.1,NC_032661.1,56485930,57067351,57067362,t,taaatgcaaaaa,11
NC_037339.1,NC_032661.1,56531812,57113275,57113276,g,gt,1
NC_037339.1,NC_032661.1,56632022,57213364,57213365,t,ta,1
NC_037339.1,NC_032661.1,56714850,57296821,57296822,G,GA,1
NC_037339.1,NC_032661.1,56730727,57312678,57312680,c,cta,2
NC_037339.1,NC_032661.1,56730864,57312817,57312818,c,ct,1
NC_037339.1,NC_032661.1,56739807,57321762,57321766,C,CTAAT,4
NC_037339.1,NC_032661.1,56745771,57327731,57327732,t,ta,1
NC_037339.1,NC_032661.1,56747701,57329662,57329664,a,act,2
NC_037339.1,NC_032661.1,56754702,57336658,57336659,t,tN,1
NC_037339.1,NC_032661.1,56764920,57346879,57346883,t,tNNNN,4
NC_037339.1,NC_032661.1,56798046,57380007,57380008,a,at,1
NC_037339.1,NC_032661.1,56802596,57384558,57384562,a,aNNNN,4
NC_037339.1,NC_032661.1,56835975,57418616,57418618,a,aat,2
NC_037339.1,NC_032661.1,56854458,57440889,57440895,t,tggcaaa,6
NC_037339.1,NC_032661.1,56869402,57455837,57455839,A,ACT,2
NC_037339.1,NC_032661.1,56882808,57469259,57469260,C,CT,1
NC_037339.1,NC_032661.1,56892519,57478919,57478920,g,ga,1
NC_037339.1,NC_032661.1,56892586,57478987,57478989,c,cct,2
NC_037339.1,NC_032661.1,56899345,57485748,57485754,t,tagcagc,6
NC_037339.1,NC_032661.1,56983563,57569649,57569650,a,aN,1
NC_037339.1,NC_032661.1,57004384,57590479,57590480,c,ca,1
NC_037339.1,NC_032661.1,57030829,57616918,57616924,t,tatataa,6
NC_037339.1,NC_032661.1,57059530,57645363,57645364,C,CG,1
NC_037339.1,NC_032661.1,57164698,57750478,57750481,T,TTTG,3
NC_037339.1,NC_032661.1,57182142,57767918,57767919,t,tc,1
NC_037339.1,NC_032661.1,57240377,57826236,57826237,c,ca,1
NC_037339.1,NC_032661.1,57270143,57856004,57856006,t,tNN,2
NC_037339.1,NC_032661.1,57296082,57881948,57881949,A,AW,1
NC_037339.1,NC_032661.1,57305917,57891780,57891781,G,GR,1
NC_037339.1,NC_032661.1,57312328,57897699,57897701,C,CTG,2
NC_037339.1,NC_032661.1,57317037,57902394,57902395,A,AC,1
NC_037339.1,NC_032661.1,57331384,57916497,57916498,c,ct,1
NC_037339.1,NC_032661.1,57331419,57916533,57916534,g,gc,1
NC_037339.1,NC_032661.1,57341002,57926332,57926333,t,tc,1
NC_037339.1,NC_032661.1,57361458,57946773,57946774,a,at,1
NC_037339.1,NC_032661.1,57363244,57948559,57948560,T,TC,1
NC_037339.1,NC_032661.1,57376962,57962275,57962276,t,tW,1
NC_037339.1,NC_032661.1,57378732,57964048,57964050,G,GTA,2
NC_037339.1,NC_032661.1,57393689,57979028,57979033,T,TTCTTC,5
NC_037339.1,NC_032661.1,57426258,58011937,58011938,T,TA,1
NC_037339.1,NC_032661.1,57445346,58031032,58031033,T,TG,1
NC_037339.1,NC_032661.1,57518677,58105008,58105011,A,AAGT,3
NC_037339.1,NC_032661.1,57544476,58130812,58130813,g,ga,1
NC_037339.1,NC_032661.1,57580491,58166831,58166832,a,ag,1
NC_037339.1,NC_032661.1,57603766,58190114,58190118,g,ggtcc,4
NC_037339.1,NC_032661.1,58506134,58480369,58480370,A,AT,1
NC_037339.1,NC_032661.1,58508348,58482584,58482585,A,AW,1
NC_037339.1,NC_032661.1,58535750,58509995,58509998,t,tttc,3
NC_037339.1,NC_032661.1,58556260,58530504,58530508,G,GACAA,4
NC_037339.1,NC_032661.1,58589705,58563940,58563965,a,aaaagaccctgatgctgggaaagatt,25
NC_037339.1,NC_032661.1,58635894,58609832,58609833,a,ac,1
NC_037339.1,NC_032661.1,58659039,58632981,58632982,A,AM,1
NC_037339.1,NC_032661.1,58672992,58655186,58655189,g,ggaa,3
NC_037339.1,NC_032661.1,58800074,58782554,58782555,t,tc,1
NC_037339.1,NC_032661.1,58800074,58785789,58785790,t,tc,1
NC_037339.1,NC_032661.1,58802091,58787807,58787808,T,TA,1
NC_037339.1,NC_032661.1,58851317,58863649,58863651,t,tNN,2
NC_037339.1,NC_032661.1,58881122,58893476,58893480,t,tgtgc,4
NC_037339.1,NC_032661.1,58883209,58895567,58895568,C,CR,1
NC_037339.1,NC_032661.1,58884949,58897316,58897317,A,AT,1
NC_037339.1,NC_032661.1,58885268,58897597,58897600,g,gcaa,3
NC_037339.1,NC_032661.1,58885428,58897761,58897762,a,at,1
NC_037339.1,NC_032661.1,58899859,58912418,58912419,g,gt,1
NC_037339.1,NC_032661.1,58913069,58925018,58925019,t,tc,1
NC_037339.1,NC_032661.1,58919874,58931824,58931825,G,GK,1
NC_037339.1,NC_032661.1,58921181,58933132,58933133,t,ta,1
NC_037339.1,NC_032661.1,58955570,58967498,58967499,C,CS,1
NC_037339.1,NC_032661.1,58972742,58984671,58984672,g,gt,1
NC_037339.1,NC_032661.1,59062874,59074806,59074808,a,aNN,2
NC_037339.1,NC_032661.1,59102735,59114674,59114675,T,TG,1
NC_037339.1,NC_032661.1,59157233,59169178,59169180,a,aNN,2
NC_037339.1,NC_032661.1,59158349,59170296,59170297,t,ta,1
NC_037339.1,NC_032661.1,59204646,59216606,59216607,t,tg,1
NC_037339.1,NC_032661.1,59204654,59216615,59216616,a,ag,1
NC_037339.1,NC_032661.1,59303084,59314918,59314919,c,ca,1
NC_037339.1,NC_032661.1,59312895,59324733,59324735,C,CTA,2
NC_037339.1,NC_032661.1,59312946,59324786,59324787,A,AN,1
NC_037339.1,NC_032661.1,59320611,59332637,59332638,C,CG,1
NC_037339.1,NC_032661.1,59329401,59341426,59341430,a,atttt,4
NC_037339.1,NC_032661.1,59332012,59344042,59344052,t,tatatatatca,10
NC_037339.1,NC_032661.1,59350501,59360378,59360380,G,GTA,2
NC_037339.1,NC_032661.1,59354688,59364566,59364567,A,AT,1
NC_037339.1,NC_032661.1,59359983,59369861,59369862,T,TN,1
NC_037339.1,NC_032661.1,59367862,59377743,59377745,A,AAC,2
NC_037339.1,NC_032661.1,59370407,59380290,59380291,A,AR,1
NC_037339.1,NC_032661.1,59376730,59386615,59386616,T,TC,1
NC_037339.1,NC_032661.1,59376963,59386867,59386877,G,GACTGTGGACT,10
NC_037339.1,NC_032661.1,59378876,59388789,59388790,A,AT,1
NC_037339.1,NC_032661.1,59379641,59389552,59389559,c,ctattgAT,7
NC_037339.1,NC_032661.1,59380060,59389978,59389979,T,TG,1
NC_037339.1,NC_032661.1,59419437,59441862,59441863,t,ta,1
NC_037339.1,NC_032661.1,59490903,59515930,59515931,a,at,1
NC_037339.1,NC_032661.1,59492434,59517462,59517483,T,TATGTTTGYTCATTTGTTTTCA,21
NC_037339.1,NC_032661.1,59493139,59518188,59518189,g,gR,1
NC_037339.1,NC_032661.1,59500721,59531229,59531230,a,at,1
NC_037339.1,NC_032661.1,59544971,59576838,59576839,T,TG,1
NC_037339.1,NC_032661.1,59547878,59579750,59579755,a,attttt,5
NC_037339.1,NC_032661.1,59561958,59593831,59593835,A,ACAAG,4
NC_037339.1,NC_032661.1,59562734,59594611,59594617,a,aNNNNNN,6
NC_037339.1,NC_032661.1,59583036,59642568,59642569,t,tc,1
NC_037339.1,NC_032661.1,59590868,59650405,59650407,a,acN,2
NC_037339.1,NC_032661.1,59603291,59662828,59662829,g,ga,1
NC_037339.1,NC_032661.1,59624654,59684218,59684219,T,TG,1
NC_037339.1,NC_032661.1,59627557,59687125,59687126,T,TK,1
NC_037339.1,NC_032661.1,59638974,59698528,59698530,a,aat,2
NC_037339.1,NC_032661.1,59639001,59698557,59698559,a,aat,2
NC_037339.1,NC_032661.1,59645279,59704833,59704834,g,ga,1
NC_037339.1,NC_032661.1,59658865,59714226,59714227,a,at,1
NC_037339.1,NC_032661.1,59675725,59730837,59730838,t,tN,1
NC_037339.1,NC_032661.1,59689480,59744599,59744603,t,tataa,4
NC_037339.1,NC_032661.1,59689496,59744619,59744621,a,atg,2
NC_037339.1,NC_032661.1,59690234,59751551,59751554,a,aaat,3
NC_037339.1,NC_032661.1,59762993,59823880,59823881,C,CN,1
NC_037339.1,NC_032661.1,59825894,59869515,59869518,t,tcac,3
NC_037339.1,NC_032661.1,59898732,59949639,59949641,A,AAC,2
NC_037339.1,NC_032661.1,60072814,60123660,60123666,t,tatataN,6
NC_037339.1,NC_032661.1,60094064,60144918,60144920,a,aNN,2
NC_037339.1,NC_032661.1,60151131,60203893,60203894,a,ac,1
NC_037339.1,NC_032661.1,60643009,60723871,60723872,t,tc,1
NC_037339.1,NC_032661.1,60650442,60731307,60731329,t,ttatccattcatctgctgatgga,22
NC_037339.1,NC_032661.1,60660081,60743857,60743859,A,ACT,2
NC_037339.1,NC_032661.1,60665492,60749271,60749272,a,ag,1
NC_037339.1,NC_032661.1,60665501,60749281,60749282,c,ct,1
NC_037339.1,NC_032661.1,60665537,60749318,60749319,a,at,1
NC_037339.1,NC_032661.1,60740492,60824292,60824296,a,aNNNN,4
NC_037339.1,NC_032661.1,60776126,60859949,60859952,c,ctag,3
NC_037339.1,NC_032661.1,60824163,60909535,60909536,g,gc,1
NC_037339.1,NC_032661.1,60837124,60922527,60922528,a,ac,1
NC_037339.1,NC_032661.1,60842443,60927833,60927837,a,atgtg,4
NC_037339.1,NC_032661.1,60850238,60935630,60935634,C,CCAAT,4
NC_037339.1,NC_032661.1,60863733,60949139,60949140,t,ta,1
NC_037339.1,NC_032661.1,60873026,60958437,60958439,T,TAC,2
NC_037339.1,NC_032661.1,60877678,60963091,60963092,g,ga,1
NC_037339.1,NC_032661.1,60882191,60967607,60967608,T,TG,1
NC_037339.1,NC_032661.1,60898398,60983203,60983211,t,tattctaaa,8
NC_037339.1,NC_032661.1,60914393,60999219,60999221,A,ATC,2
NC_037339.1,NC_032661.1,60932460,61017297,61017298,t,tg,1
NC_037339.1,NC_032661.1,60961080,61045932,61045933,a,at,1
NC_037339.1,NC_032661.1,60961466,61046319,61046320,t,tY,1
NC_037339.1,NC_032661.1,60964924,61049707,61049708,c,ca,1
NC_037339.1,NC_032661.1,60967954,61052740,61052804,a,aaggcaatggcaccccagtccaatactcttgcctggaaaatcccatggatggaggagcctggRag,64
NC_037339.1,NC_032661.1,60974668,61059520,61059523,g,gttt,3
NC_037339.1,NC_032661.1,60975198,61060051,61060053,c,ctg,2
NC_037339.1,NC_032661.1,60986594,61054898,61054899,g,gc,1
NC_037339.1,NC_032661.1,60986716,61055019,61055020,c,ca,1
NC_037339.1,NC_032661.1,60989157,61057457,61057463,t,tttggta,6
NC_037339.1,NC_032661.1,60998313,61066619,61066620,T,TG,1
NC_037339.1,NC_032661.1,60999193,61067500,61067501,T,TA,1
NC_037339.1,NC_032661.1,61002295,61070605,61070620,g,ggtgGAACTGCAAGTC,15
NC_037339.1,NC_032661.1,61006126,61074467,61074469,t,taa,2
NC_037339.1,NC_032661.1,61027761,61095373,61095375,t,tgc,2
NC_037339.1,NC_032661.1,61029275,61096889,61096891,C,CAA,2
NC_037339.1,NC_032661.1,61040970,61121055,61121061,a,aacaaac,6
NC_037339.1,NC_032661.1,61041065,61121156,61121157,a,ac,1
NC_037339.1,NC_032661.1,61049008,61129106,61129107,T,TW,1
NC_037339.1,NC_032661.1,61049931,61130031,61130032,g,ga,1
NC_037339.1,NC_032661.1,61095303,61175476,61175477,g,gt,1
NC_037339.1,NC_032661.1,61153115,61233247,61233259,g,gtatatatatata,12
NC_037339.1,NC_032661.1,61155899,61236043,61236044,c,ct,1
NC_037339.1,NC_032661.1,61202803,61283165,61283166,t,tc,1
NC_037339.1,NC_032661.1,61208671,61289035,61289038,t,tata,3
NC_037339.1,NC_032661.1,61241997,61322352,61322353,C,CA,1
NC_037339.1,NC_032661.1,61268908,61349269,61349270,c,cA,1
NC_037339.1,NC_032661.1,61315336,61395767,61395768,t,ta,1
NC_037339.1,NC_032661.1,61315583,61396019,61396021,C,CTT,2
NC_037339.1,NC_032661.1,61316182,61396625,61396626,g,ga,1
NC_037339.1,NC_032661.1,61599612,61673780,61673781,a,at,1
NC_037339.1,NC_032661.1,61660511,61697684,61697685,a,at,1
NC_037339.1,NC_032661.1,61674158,61711333,61711355,T,TCTGGCCTCTGCCAACCAAGATG,22
NC_037339.1,NC_032661.1,61687503,61725100,61725101,t,tK,1
NC_037339.1,NC_032661.1,61687947,61725545,61725546,G,GT,1
NC_037339.1,NC_032661.1,61690155,61727753,61727758,c,cagttt,5
NC_037339.1,NC_032661.1,63444089,62339448,62339449,G,GA,1
NC_037339.1,NC_032661.1,63483087,62381274,62381276,t,tta,2
NC_037339.1,NC_032661.1,63684160,62597024,62597025,t,tc,1
NC_037339.1,NC_032661.1,63705618,62618599,62618600,G,GR,1
NC_037339.1,NC_032661.1,63743637,62656072,62656073,t,ta,1
NC_037339.1,NC_032661.1,63812826,62724722,62724723,T,TA,1
NC_037339.1,NC_032661.1,63817334,62729241,62729242,G,GR,1
NC_037339.1,NC_032661.1,63840313,62754081,62754082,t,tN,1
NC_037339.1,NC_032661.1,63841406,62755175,62755176,A,AC,1
NC_037339.1,NC_032661.1,63842147,62755917,62755918,a,ag,1
NC_037339.1,NC_032661.1,63843086,62756858,62756859,g,ga,1
NC_037339.1,NC_032661.1,63858816,62772591,62772595,C,CAAAA,4
NC_037339.1,NC_032661.1,63858818,62772597,62772602,C,CAAAAA,5
NC_037339.1,NC_032661.1,63891913,62805732,62805733,g,ga,1
NC_037339.1,NC_032661.1,63908164,62822004,62822005,C,CA,1
NC_037339.1,NC_032661.1,63908718,62822558,62822568,a,atatatatatt,10
NC_037339.1,NC_032661.1,63909271,62823121,62823122,T,TC,1
NC_037339.1,NC_032661.1,63910841,62824693,62824695,C,CRY,2
NC_037339.1,NC_032661.1,63937045,62850902,62850903,t,tc,1
NC_037339.1,NC_032661.1,63937071,62850929,62850937,t,ttgtgtata,8
NC_037339.1,NC_032661.1,63972577,62885857,62885860,c,cgca,3
NC_037339.1,NC_032661.1,63990469,62903755,62903756,t,tg,1
NC_037339.1,NC_032661.1,64007337,62920986,62920987,a,ac,1
NC_037339.1,NC_032661.1,64051548,62985225,62985227,a,aat,2
NC_037339.1,NC_032661.1,64111812,63045031,63045032,t,tW,1
NC_037339.1,NC_032661.1,64121774,63055246,63055247,A,AT,1
NC_037339.1,NC_032661.1,64125645,63059120,63059122,g,gaa,2
NC_037339.1,NC_032661.1,64141729,63074938,63074940,t,ttg,2
NC_037339.1,NC_032661.1,64160788,63094010,63094014,a,aNNNN,4
NC_037339.1,NC_032661.1,64182020,63115244,63115245,T,TC,1
NC_037339.1,NC_032661.1,64231072,63164307,63164313,a,aaaacac,6
NC_037339.1,NC_032661.1,64233118,63166361,63166362,T,TG,1
NC_037339.1,NC_032661.1,64247810,63183939,63183940,t,ta,1
NC_037339.1,NC_032661.1,64255082,63191213,63191218,g,gcagta,5
NC_037339.1,NC_032661.1,64256684,63193179,63193188,A,AGTTACTGTG,9
NC_037339.1,NC_032661.1,64257628,63194422,63194423,G,GT,1
NC_037339.1,NC_032661.1,64258071,63194866,63194871,G,GAGCAA,5
NC_037339.1,NC_032661.1,64258487,63195287,63195290,t,tcta,3
NC_037339.1,NC_032661.1,64267326,63204121,63204123,g,gta,2
NC_037339.1,NC_032661.1,64267727,63204524,63204525,a,ac,1
NC_037339.1,NC_032661.1,64267841,63204736,63204738,c,cat,2
NC_037339.1,NC_032661.1,64268549,63205446,63205447,a,ac,1
NC_037339.1,NC_032661.1,64269740,63206637,63206638,t,ta,1
NC_037339.1,NC_032661.1,64269791,63206689,63206690,T,TC,1
NC_037339.1,NC_032661.1,64272531,63209329,63209330,c,ca,1
NC_037339.1,NC_032661.1,64273208,63210014,63210015,t,ta,1
NC_037339.1,NC_032661.1,64274447,63211256,63211261,g,gactga,5
NC_037339.1,NC_032661.1,64282552,63219127,63219128,c,ct,1
NC_037339.1,NC_032661.1,64284580,63221164,63221165,A,AM,1
NC_037339.1,NC_032661.1,64293196,63229958,63229959,a,ag,1
NC_037339.1,NC_032661.1,64319352,63255107,63255108,g,ga,1
NC_037339.1,NC_032661.1,64321047,63256802,63256845,T,TCAAAGTAGCATTGTTAATAATGTGAGACAAGAATGATAAGAAA,43
NC_037339.1,NC_032661.1,64321816,63257614,63257615,a,ac,1
NC_037339.1,NC_032661.1,64335533,63271327,63271329,a,act,2
NC_037339.1,NC_032661.1,64335828,63271622,63271623,a,ag,1
NC_037339.1,NC_032661.1,64339295,63275088,63275089,A,AG,1
NC_037339.1,NC_032661.1,64340497,63276290,63276291,c,cg,1
NC_037339.1,NC_032661.1,64346639,63282432,63282433,a,aN,1
NC_037339.1,NC_032661.1,64350117,63285911,63285912,c,cg,1
NC_037339.1,NC_032661.1,64367914,63344162,63344194,G,GNNNNNNNNNNNNNNNNNNNNNNNNNNNNNNNN,32
NC_037339.1,NC_032661.1,64445484,63494197,63494199,c,caa,2
NC_037339.1,NC_032661.1,64454847,63503714,63503715,g,gt,1
NC_037339.1,NC_032661.1,64456422,63505290,63505292,t,ttg,2
NC_037339.1,NC_032661.1,64456422,63431568,63431570,t,ttg,2
NC_037339.1,NC_032661.1,64463532,63512411,63512423,t,ttgtgtgtgtgtg,12
NC_037339.1,NC_032661.1,64463532,63438693,63438705,t,ttgtgtgtgtgtg,12
NC_037339.1,NC_032661.1,64471299,63520267,63520273,c,caacaaa,6
NC_037339.1,NC_032661.1,64471299,63445978,63445984,c,caacaaa,6
NC_037339.1,NC_032661.1,64484957,63459751,63459752,t,ta,1
NC_037339.1,NC_032661.1,64495215,63470011,63470012,a,at,1
NC_037339.1,NC_032661.1,64495397,63470194,63470196,c,cat,2
NC_037339.1,NC_032661.1,64495435,63470234,63470236,a,aNN,2
NC_037339.1,NC_032661.1,64503848,63527534,63527535,c,ca,1
NC_037339.1,NC_032661.1,64634086,63626512,63626514,a,act,2
NC_037339.1,NC_032661.1,64659009,63696332,63696346,G,GTCCTAAAGCGATCR,14
NC_037339.1,NC_032661.1,64661776,63699111,63699114,C,CTCT,3
NC_037339.1,NC_032661.1,64677737,63715066,63715068,a,aNN,2
NC_037339.1,NC_032661.1,64694935,63732266,63732269,C,CTTM,3
NC_037339.1,NC_032661.1,64696344,63733679,63733708,G,GcccttctaaaaaataaaaccaagggtGGT,29
NC_037339.1,NC_032661.1,64699335,63736698,63736701,G,GCTA,3
NC_037339.1,NC_032661.1,64699911,63737277,63737278,c,ca,1
NC_037339.1,NC_032661.1,64706236,63743604,63743605,t,ta,1
NC_037339.1,NC_032661.1,64711088,63748097,63748098,A,AW,1
NC_037339.1,NC_032661.1,64734035,63771050,63771054,t,tNNNN,4
NC_037339.1,NC_032661.1,64797631,63834664,63834666,t,ttg,2
NC_037339.1,NC_032661.1,64821065,63853122,63853124,a,agt,2
NC_037339.1,NC_032661.1,64822209,63854129,63854130,A,AR,1
NC_037339.1,NC_032661.1,64822702,63854622,63854623,T,TA,1
NC_037339.1,NC_032661.1,64847962,63879845,63879847,C,CTA,2
NC_037339.1,NC_032661.1,64863834,63893397,63893398,t,tg,1
NC_037339.1,NC_032661.1,64879441,63908855,63908856,t,tg,1
NC_037339.1,NC_032661.1,64955607,63985538,63985548,T,TGYacagcaac,10
NC_037339.1,NC_032661.1,64964772,63994709,63994718,T,TCAGGTTATG,9
NC_037339.1,NC_032661.1,65031032,64086755,64086756,t,tc,1
NC_037339.1,NC_032661.1,65031794,64038784,64038785,g,ga,1
NC_037339.1,NC_032661.1,65031794,64087518,64087519,g,ga,1
NC_037339.1,NC_032661.1,65033261,64088986,64088987,g,ga,1
NC_037339.1,NC_032661.1,65040520,64096157,64096158,A,AG,1
NC_037339.1,NC_032661.1,65085764,64141405,64141420,G,GGTATACCAGGCAGAT,15
NC_037339.1,NC_032661.1,65124501,64184123,64184126,t,tata,3
NC_037339.1,NC_032661.1,65125234,64184859,64184871,c,cttgcctggagaa,12
NC_037339.1,NC_032661.1,65125513,64185153,64185156,a,atat,3
NC_037339.1,NC_032661.1,65138681,64198852,64198853,T,TK,1
NC_037339.1,NC_032661.1,65139548,64199720,64199721,C,CA,1
NC_037339.1,NC_032661.1,65143120,64203299,64203300,a,aM,1
NC_037339.1,NC_032661.1,65144511,64204691,64204692,G,GA,1
NC_037339.1,NC_032661.1,65227130,64287478,64287480,t,tNN,2
NC_037339.1,NC_032661.1,65269289,64329619,64329623,A,AAGAC,4
NC_037339.1,NC_032661.1,65269654,64329988,64329989,A,AG,1
NC_037339.1,NC_032661.1,65288494,64348852,64348853,c,ca,1
NC_037339.1,NC_032661.1,65292418,64352784,64352788,t,tNNNN,4
NC_037339.1,NC_032661.1,65293863,64354233,64354234,G,GT,1
NC_037339.1,NC_032661.1,65309983,64369960,64369961,G,GA,1
NC_037339.1,NC_032661.1,65321634,64381600,64381602,c,cag,2
NC_037339.1,NC_032661.1,65334450,64393700,64393701,g,gt,1
NC_037339.1,NC_032661.1,65337674,64396925,64396929,c,cacaY,4
NC_037339.1,NC_032661.1,65343846,64403099,64403100,c,ct,1
NC_037339.1,NC_032661.1,65348383,64408447,64408451,T,TTGTC,4
NC_037339.1,NC_032661.1,65358729,64418428,64418431,C,CCAY,3
NC_037339.1,NC_032661.1,65539055,64598443,64598445,a,aat,2
NC_037339.1,NC_032661.1,65623763,64683563,64683565,C,CCA,2
NC_037339.1,NC_032661.1,65791972,64855103,64855107,T,TCTAA,4
NC_037339.1,NC_032661.1,65814926,64878062,64878063,c,ct,1
NC_037339.1,NC_032661.1,65815199,64878336,64878337,t,tg,1
NC_037339.1,NC_032661.1,65954029,65016831,65016832,t,tc,1
NC_037339.1,NC_032661.1,66082316,65143951,65143952,c,ct,1
NC_037339.1,NC_032661.1,66083832,65145466,65145467,T,TM,1
NC_037339.1,NC_032661.1,66086571,65148205,65148206,c,ct,1
NC_037339.1,NC_032661.1,66086674,65148309,65148310,g,gt,1
NC_037339.1,NC_032661.1,66087959,65149595,65149596,t,tg,1
NC_037339.1,NC_032661.1,66089460,65151098,65151099,g,gt,1
NC_037339.1,NC_032661.1,66091550,65153189,65153190,c,ct,1
NC_037339.1,NC_032661.1,66119070,65180779,65180780,t,tg,1
NC_037339.1,NC_032661.1,66124301,65185554,65185555,a,at,1
NC_037339.1,NC_032661.1,66125781,65187035,65187036,c,ca,1
NC_037339.1,NC_032661.1,66161504,65223108,65223109,A,AC,1
NC_037339.1,NC_032661.1,66169749,65231353,65231354,g,gc,1
NC_037339.1,NC_032661.1,66239294,65308911,65308912,a,ag,1
NC_037339.1,NC_032661.1,66244823,65314442,65314443,t,tg,1
NC_037339.1,NC_032661.1,66246052,65315675,65315677,t,taa,2
NC_037339.1,NC_032661.1,66258226,65327857,65327858,g,ga,1
NC_037339.1,NC_032661.1,66342498,65411627,65411628,C,CT,1
NC_037339.1,NC_032661.1,66365707,65434844,65434845,A,AT,1
NC_037339.1,NC_032661.1,66384612,65453753,65453754,G,GA,1
NC_037339.1,NC_032661.1,66384722,65453864,65453865,T,TA,1
NC_037339.1,NC_032661.1,66508453,65578316,65578317,T,TC,1
NC_037339.1,NC_032661.1,66556258,65625874,65625875,a,ac,1
NC_037339.1,NC_032661.1,66714832,65690392,65690393,G,GT,1
NC_037339.1,NC_032661.1,66939130,65914193,65914205,C,CNNNNNNNNNNNN,12
NC_037339.1,NC_032661.1,66978402,65953459,65953463,a,aNNNN,4
NC_037339.1,NC_032661.1,66981151,65956212,65956213,C,CM,1
NC_037339.1,NC_032661.1,67016379,65986331,65986332,t,ta,1
NC_037339.1,NC_032661.1,67115322,66084946,66084947,T,TC,1
NC_037339.1,NC_032661.1,67115325,66084950,66084951,c,ct,1
NC_037339.1,NC_032661.1,67115367,66084993,66084994,T,TY,1
NC_037339.1,NC_032661.1,67138570,66108197,66108198,a,aM,1
NC_037339.1,NC_032661.1,67138677,66108305,66108314,g,gactgaaccc,9
NC_037339.1,NC_032661.1,67224443,66193905,66193908,t,tcgg,3
NC_037339.1,NC_032661.1,67231650,66201118,66201138,t,tggaaccagtctgttgttcca,20
NC_037339.1,NC_032661.1,67231817,66201305,66201307,a,act,2
NC_037339.1,NC_032661.1,67304017,66273352,66273357,g,gttttt,5
NC_037339.1,NC_032661.1,67327886,66297214,66297216,a,aat,2
NC_037339.1,NC_032661.1,67357886,66327974,66327983,a,acacttttcc,9
NC_037339.1,NC_032661.1,67475119,66512948,66512950,g,ggt,2
NC_037339.1,NC_032661.1,67489831,66528273,66528274,g,ga,1
NC_037339.1,NC_032661.1,67489960,66528403,66528404,c,ct,1
NC_037339.1,NC_032661.1,67502519,66540960,66540961,A,AG,1
NC_037339.1,NC_032661.1,67502774,66541216,66541217,c,ca,1
NC_037339.1,NC_032661.1,67504359,66543133,66543134,T,TA,1
NC_037339.1,NC_032661.1,67505561,66544335,66544336,T,TW,1
NC_037339.1,NC_032661.1,67516895,66555675,66555676,a,ac,1
NC_037339.1,NC_032661.1,67650570,66666274,66666275,c,cN,1
NC_037339.1,NC_032661.1,67664048,66679627,66679628,T,TC,1
NC_037339.1,NC_032661.1,67696327,66711877,66711878,g,gt,1
NC_037339.1,NC_032661.1,67753233,66768899,66768900,T,TC,1
NC_037339.1,NC_032661.1,67755604,66771271,66771272,G,GA,1
NC_037339.1,NC_032661.1,67758912,66774580,66774582,T,TTC,2
NC_037339.1,NC_032661.1,67834500,66850200,66850207,A,AGTTTGAT,7
NC_037339.1,NC_032661.1,67848319,66864032,66864034,t,tNN,2
NC_037339.1,NC_032661.1,67861254,66876970,66876971,t,ta,1
NC_037339.1,NC_032661.1,67862940,66878657,66878663,t,tNNNNNN,6
NC_037339.1,NC_032661.1,67893774,66909496,66909498,A,AAG,2
NC_037339.1,NC_032661.1,67912250,66927966,66927967,g,ga,1
NC_037339.1,NC_032661.1,67929074,66944792,66944793,c,ct,1
NC_037339.1,NC_032661.1,67934450,66950169,66950170,c,ct,1
NC_037339.1,NC_032661.1,67935710,66951431,66951432,t,ta,1
NC_037339.1,NC_032661.1,67960149,66975619,66975621,a,att,2
NC_037339.1,NC_032661.1,67961501,66976949,66976950,T,TC,1
NC_037339.1,NC_032661.1,67965065,66980512,66980513,A,AG,1
NC_037339.1,NC_032661.1,67984557,67000003,67000005,t,tac,2
NC_037339.1,NC_032661.1,67988920,67004368,67004378,t,tatatataaaa,10
NC_037339.1,NC_032661.1,68021343,67036803,67036804,c,ct,1
NC_037339.1,NC_032661.1,68050943,67066423,67066424,G,GC,1
NC_037339.1,NC_032661.1,68092267,67107773,67107775,T,TTY,2
NC_037339.1,NC_032661.1,68112924,67128635,67128636,A,AC,1
NC_037339.1,NC_032661.1,68116039,67131752,67131755,t,tagc,3
NC_037339.1,NC_032661.1,68132167,67147928,67147930,a,aNN,2
NC_037339.1,NC_032661.1,68145765,67160815,67160816,T,TW,1
NC_037339.1,NC_032661.1,68208844,67223358,67223359,g,ga,1
NC_037339.1,NC_032661.1,68215495,67230003,67230037,c,ccgcagcctaccaggctcctccgtccatgggattt,34
NC_037339.1,NC_032661.1,68234894,67249433,67249434,C,CY,1
NC_037339.1,NC_032661.1,68234897,67249437,67249438,C,CT,1
NC_037339.1,NC_032661.1,68237903,67252445,67252446,A,AT,1
NC_037339.1,NC_032661.1,68326716,67340924,67340926,A,AGG,2
NC_037339.1,NC_032661.1,68350432,67364869,67364889,a,atNNNNNNNNNNNNNNNNNNN,20
NC_037339.1,NC_032661.1,68403456,67418422,67418423,c,ct,1
NC_037339.1,NC_032661.1,68403479,67418446,67418447,g,ga,1
NC_037339.1,NC_032661.1,68403508,67418476,67418477,t,ta,1
NC_037339.1,NC_032661.1,68406080,67421051,67421052,a,at,1
NC_037339.1,NC_032661.1,68433723,67445882,67445884,g,ggc,2
NC_037339.1,NC_032661.1,68510663,67524391,67524392,G,GA,1
NC_037339.1,NC_032661.1,68515857,67557421,67557424,C,CCAA,3
NC_037339.1,NC_032661.1,68520162,67561730,67561731,t,tg,1
NC_037339.1,NC_032661.1,68627385,67652553,67652554,C,CA,1
NC_037339.1,NC_032661.1,68638087,67663252,67663254,A,ACT,2
NC_037339.1,NC_032661.1,68644442,67669612,67669613,a,ac,1
NC_037339.1,NC_032661.1,68676839,67701947,67701948,a,at,1
NC_037339.1,NC_032661.1,68677082,67702192,67702194,t,tta,2
NC_037339.1,NC_032661.1,68677110,67702222,67702223,g,ga,1
NC_037339.1,NC_032661.1,68708176,67733183,67733184,T,TG,1
NC_037339.1,NC_032661.1,68734543,67759551,67759552,G,GT,1
NC_037339.1,NC_032661.1,68742412,67767429,67767430,T,TY,1
NC_037339.1,NC_032661.1,68829904,67854773,67854775,a,aac,2
NC_037339.1,NC_032661.1,68859411,67884308,67884317,T,TCAAAACTGG,9
NC_037339.1,NC_032661.1,68862578,67887347,67887348,t,tg,1
NC_037339.1,NC_032661.1,68934060,67958835,67958836,g,ga,1
NC_037339.1,NC_032661.1,68934114,67958891,67958892,g,ga,1
NC_037339.1,NC_032661.1,68948222,67972990,67972994,A,AACTT,4
NC_037339.1,NC_032661.1,68952955,67977671,67977672,a,ag,1
NC_037339.1,NC_032661.1,68967168,67991877,67991878,A,AT,1
NC_037339.1,NC_032661.1,68975754,68042842,68042864,c,ctgtgggattccccaggcaagaa,22
NC_037339.1,NC_032661.1,69152961,68221833,68221835,c,cca,2
NC_037339.1,NC_032661.1,69157037,68225911,68225915,C,CTATT,4
NC_037339.1,NC_032661.1,69339692,68719339,68719340,a,at,1
NC_037339.1,NC_032661.1,69379628,68759285,68759289,T,TATTA,4
NC_037339.1,NC_032661.1,69382717,68762378,68762379,G,GS,1
NC_037339.1,NC_032661.1,69390268,68769931,68769932,a,ag,1
NC_037339.1,NC_032661.1,69395942,68775606,68775607,G,GT,1
NC_037339.1,NC_032661.1,69403892,68783559,68783560,C,CT,1
NC_037339.1,NC_032661.1,69508062,68887361,68887362,c,ca,1
NC_037339.1,NC_032661.1,69508340,68887640,68887641,T,TC,1
NC_037339.1,NC_032661.1,69510359,68889663,68889669,A,ACTGAGT,6
NC_037339.1,NC_032661.1,69524338,68903645,68903646,t,ta,1
NC_037339.1,NC_032661.1,69524566,68903874,68903877,G,GCTT,3
NC_037339.1,NC_032661.1,69542553,68921880,68921884,G,GATAT,4
NC_037339.1,NC_032661.1,69544935,68925488,68925492,C,CAGTT,4
NC_037339.1,NC_032661.1,69556888,68937503,68937509,t,tctcaca,6
NC_037339.1,NC_032661.1,69559156,68939777,68939780,A,AAAT,3
NC_037339.1,NC_032661.1,69564510,68945134,68945136,C,CGT,2
NC_037339.1,NC_032661.1,69580414,68960907,68960917,G,GATTGGTTATK,10
NC_037339.1,NC_032661.1,69592126,68972622,68972626,a,atatg,4
NC_037339.1,NC_032661.1,69597598,68978083,68978101,T,TCAGGGCAGGTCACAGGGW,18
NC_037339.1,NC_032661.1,69610931,68991412,68991413,c,ca,1
NC_037339.1,NC_032661.1,69625063,69005563,69005575,C,CCTTAAAGTCACY,12
NC_037339.1,NC_032661.1,69645224,69025781,69025782,T,TK,1
NC_037339.1,NC_032661.1,69659509,69040096,69040100,C,CTGTT,4
NC_037339.1,NC_032661.1,69659543,69040134,69040136,t,tag,2
NC_037339.1,NC_032661.1,69663247,69043827,69043889,T,TATGTCTGAGaatatagaaaaagcaaagatgCACCACAATACAAGGTCATGGATATTCATCAC,62
NC_037339.1,NC_032661.1,69665247,69045887,69045894,G,GACATACT,7
NC_037339.1,NC_032661.1,69668006,69048654,69048655,a,ac,1
NC_037339.1,NC_032661.1,69686806,69067457,69067466,G,GGCCTCTTTT,9
NC_037339.1,NC_032661.1,69689608,69070268,69070277,g,gggaaacagt,9
NC_037339.1,NC_032661.1,69689731,69070400,69070418,c,cagcattaaagAGCATTNa,18
NC_037339.1,NC_032661.1,69691438,69072122,69072129,T,TTCAATAG,7
NC_037339.1,NC_032661.1,69712428,69093552,69093554,t,tca,2
NC_037339.1,NC_032661.1,69725848,69106974,69106975,a,ac,1
NC_037339.1,NC_032661.1,69726245,69107372,69107373,a,ag,1
NC_037339.1,NC_032661.1,69738269,69119406,69119409,a,atat,3
NC_037339.1,NC_032661.1,69750687,69131828,69131829,t,tc,1
NC_037339.1,NC_032661.1,69751093,69132235,69132243,C,CTGGGGACA,8
NC_037339.1,NC_032661.1,69752031,69133184,69133185,t,tc,1
NC_037339.1,NC_032661.1,69754509,69135668,69135669,c,ca,1
NC_037339.1,NC_032661.1,69768039,69149228,69149240,T,TCCTCATCATTCA,12
NC_037339.1,NC_032661.1,69768200,69149406,69149407,t,tc,1
NC_037339.1,NC_032661.1,69771690,69152898,69152900,G,GGK,2
NC_037339.1,NC_032661.1,69774115,69155321,69155322,t,ta,1
NC_037339.1,NC_032661.1,69778996,69160203,69160204,T,TM,1
NC_037339.1,NC_032661.1,69806261,69181506,69181510,A,ATTRT,4
NC_037339.1,NC_032661.1,69806271,69181520,69181521,G,GT,1
NC_037339.1,NC_032661.1,69806848,69182097,69182098,a,ac,1
NC_037339.1,NC_032661.1,69806915,69182165,69182166,t,ta,1
NC_037339.1,NC_032661.1,69825606,69196588,69196589,t,tg,1
NC_037339.1,NC_032661.1,69825923,69196906,69196907,g,gt,1
NC_037339.1,NC_032661.1,69840084,69211341,69211344,T,TATC,3
NC_037339.1,NC_032661.1,69840539,69211800,69211804,T,TAAAC,4
NC_037339.1,NC_032661.1,69841667,69212930,69212931,G,GA,1
NC_037339.1,NC_032661.1,69841710,69212989,69212990,T,TG,1
NC_037339.1,NC_032661.1,69948190,69197176,69197177,t,tc,1
NC_037339.1,NC_032661.1,70356606,69178879,69178880,A,AC,1
NC_037339.1,NC_032661.1,70357351,69179624,69179625,A,AG,1
NC_037339.1,NC_032661.1,71532663,69622363,69622365,g,gtt,2
NC_037339.1,NC_032661.1,71534374,69624028,69624029,t,tY,1
NC_037339.1,NC_032661.1,71534389,69624044,69624046,T,TAG,2
NC_037339.1,NC_032661.1,71534397,69624054,69624055,t,tc,1
NC_037339.1,NC_032661.1,71535412,69625060,69625061,A,AT,1
NC_037339.1,NC_032661.1,71535419,69625068,69625069,T,TC,1
NC_037339.1,NC_032661.1,71535570,69625218,69625219,T,TC,1
NC_037339.1,NC_032661.1,71535614,69625263,69625265,t,ttc,2
NC_037339.1,NC_032661.1,71549907,69639587,69639588,t,tc,1
NC_037339.1,NC_032661.1,71558851,69652845,69652849,g,gacaa,4
NC_037339.1,NC_032661.1,71570118,69663455,69663462,t,ttaaaaaa,7
NC_037339.1,NC_032661.1,71574863,69668208,69668209,G,GT,1
NC_037339.1,NC_032661.1,71579554,69672908,69672909,c,ca,1
NC_037339.1,NC_032661.1,71596925,69692191,69692193,c,caa,2
NC_037339.1,NC_032661.1,71611966,69707236,69707237,C,CG,1
NC_037339.1,NC_032661.1,71628434,69731640,69731641,t,ta,1
NC_037339.1,NC_032661.1,71630896,69734104,69734105,t,ta,1
NC_037339.1,NC_032661.1,71641995,69745222,69745223,g,gc,1
NC_037339.1,NC_032661.1,71642260,69745488,69745503,T,TGATTAATTaccagga,15
NC_037339.1,NC_032661.1,71642966,69746209,69746210,C,CA,1
NC_037339.1,NC_032661.1,71649069,69754483,69754485,a,aRt,2
NC_037339.1,NC_032661.1,71653454,69758631,69758632,t,ta,1
NC_037339.1,NC_032661.1,71661249,69766431,69766432,a,ag,1
NC_037339.1,NC_032661.1,71662030,69767221,69767223,c,caa,2
NC_037339.1,NC_032661.1,71665367,69772785,69772786,t,tg,1
NC_037339.1,NC_032661.1,71992607,69562573,69562574,G,GA,1
NC_037339.1,NC_032661.1,71992655,69562622,69562623,A,AM,1
NC_037339.1,NC_032661.1,71993235,69563203,69563204,t,ta,1
NC_037339.1,NC_032661.1,71994174,69564143,69564144,C,CG,1
NC_037339.1,NC_032661.1,71995717,69565694,69565695,g,ga,1
NC_037339.1,NC_032661.1,72480471,69597558,69597576,T,TCCACGCCAGCCCCGGAGC,18
NC_037339.1,NC_032661.1,72481407,69598505,69598506,A,AC,1
NC_037339.1,NC_032661.1,72483342,69600442,69600443,a,at,1
NC_037339.1,NC_032661.1,72485973,69603051,69603052,T,TC,1
NC_037339.1,NC_032661.1,72605353,70267108,70267109,a,ag,1
NC_037339.1,NC_032661.1,72605854,70267610,70267611,T,TY,1
NC_037339.1,NC_032661.1,72606083,70267840,70267841,C,CY,1
NC_037339.1,NC_032661.1,72607330,70269088,70269093,t,ttaaaa,5
NC_037339.1,NC_032661.1,72608635,70270399,70270401,a,aac,2
NC_037339.1,NC_032661.1,72608912,70270675,70270676,G,GA,1
NC_037339.1,NC_032661.1,72616062,70277843,70277844,g,ga,1
NC_037339.1,NC_032661.1,72617442,70279224,70279225,G,GS,1
NC_037339.1,NC_032661.1,72623464,70287254,70287255,a,at,1
NC_037339.1,NC_032661.1,72625454,70289245,70289249,G,GGGGC,4
NC_037339.1,NC_032661.1,72627297,70291093,70291108,C,CATGAATTCATTGGAG,15
NC_037339.1,NC_032661.1,72632267,70296093,70296094,C,CA,1
NC_037339.1,NC_032661.1,72633965,70297792,70297803,T,TTCAACAAGCTA,11
NC_037339.1,NC_032661.1,72635916,70299753,70299754,G,GY,1
NC_037339.1,NC_032661.1,72643392,70307233,70307234,T,TG,1
NC_037339.1,NC_032661.1,72644765,70308605,70308609,G,GTATR,4
NC_037339.1,NC_032661.1,72646714,70310558,70310559,a,ac,1
NC_037339.1,NC_032661.1,72649119,70312963,70312964,c,ca,1
NC_037339.1,NC_032661.1,72652694,70316533,70316534,T,TC,1
NC_037339.1,NC_032661.1,72653470,70317309,70317338,C,CAGTRTGACAATTTCTAGAAAAAGTATGAY,29
NC_037339.1,NC_032661.1,72661552,70325402,70325403,C,CY,1
NC_037339.1,NC_032661.1,72662292,70326143,70326150,g,gggggtga,7
NC_037339.1,NC_032661.1,72664285,70329347,70329348,g,gt,1
NC_037339.1,NC_032661.1,72667640,70332199,70332200,T,TK,1
NC_037339.1,NC_032661.1,72672656,70337219,70337224,a,aagact,5
NC_037339.1,NC_032661.1,72676002,70340572,70340573,g,gc,1
NC_037339.1,NC_032661.1,72681268,70345838,70345839,T,TY,1
NC_037339.1,NC_032661.1,72690507,70355081,70355083,t,taa,2
NC_037339.1,NC_032661.1,72694374,70358954,70358955,c,ct,1
NC_037339.1,NC_032661.1,72703579,70368154,70368155,T,TC,1
NC_037339.1,NC_032661.1,72703610,70368186,70368187,T,TG,1
NC_037339.1,NC_032661.1,72711105,70375673,70375674,g,gc,1
NC_037339.1,NC_032661.1,72715346,70379940,70379948,t,taaaaaaaa,8
NC_037339.1,NC_032661.1,72721854,70386456,70386458,t,tca,2
NC_037339.1,NC_032661.1,72722173,70386777,70386778,g,gt,1
NC_037339.1,NC_032661.1,72838504,70537979,70537982,g,ggaa,3
NC_037339.1,NC_032661.1,72842156,70541637,70541638,a,at,1
NC_037339.1,NC_032661.1,72852908,70552416,70552421,t,taaaaa,5
NC_037339.1,NC_032661.1,72861196,70568507,70568508,a,at,1
NC_037339.1,NC_032661.1,72866804,70576525,70576526,T,TC,1
NC_037339.1,NC_032661.1,72870346,70580065,70580066,a,at,1
NC_037339.1,NC_032661.1,72875057,70584791,70584792,T,TG,1
NC_037339.1,NC_032661.1,72881003,70590740,70590741,T,TA,1
NC_037339.1,NC_032661.1,72886100,70595843,70595844,G,GS,1
NC_037339.1,NC_032661.1,72912190,70623209,70623210,G,GK,1
NC_037339.1,NC_032661.1,72913829,70624122,70624123,A,AG,1
NC_037339.1,NC_032661.1,72938037,70648334,70648335,a,at,1
NC_037339.1,NC_032661.1,72964560,70659057,70659058,C,CS,1
NC_037339.1,NC_032661.1,72965299,70659796,70659798,A,ACT,2
NC_037339.1,NC_032661.1,72967186,70661687,70661688,t,tc,1
NC_037339.1,NC_032661.1,72969048,70663549,70663550,a,ac,1
NC_037339.1,NC_032661.1,72969652,70664154,70664155,c,ca,1
NC_037339.1,NC_032661.1,72975482,70669985,70669986,c,ct,1
NC_037339.1,NC_032661.1,72985160,70679635,70679636,G,GC,1
NC_037339.1,NC_032661.1,72985911,70680387,70680388,A,AC,1
NC_037339.1,NC_032661.1,73019188,70713709,70713717,A,AAGTGCTAC,8
NC_037339.1,NC_032661.1,73019397,70713926,70713930,G,GANNN,4
NC_037339.1,NC_032661.1,73019439,70713972,70713973,C,CG,1
NC_037339.1,NC_032661.1,73021147,70716597,70716599,T,TAG,2
NC_037339.1,NC_032661.1,73021526,70716950,70716951,C,CT,1
NC_037339.1,NC_032661.1,73022732,70718144,70718145,t,ta,1
NC_037339.1,NC_032661.1,73022800,70718204,70718205,A,AC,1
NC_037339.1,NC_032661.1,73024565,70719970,70719971,t,tg,1
NC_037339.1,NC_032661.1,73026615,70722025,70722026,T,TG,1
NC_037339.1,NC_032661.1,73042535,70737948,70737949,C,CA,1
NC_037339.1,NC_032661.1,73043715,70739121,70739122,t,tc,1
NC_037339.1,NC_032661.1,73043948,70739354,70739355,G,GC,1
NC_037339.1,NC_032661.1,73045413,70740821,70740823,A,AAC,2
NC_037339.1,NC_032661.1,73181233,70876596,70876597,t,ta,1
NC_037339.1,NC_032661.1,73261979,70957344,70957350,t,ttcttaa,6
NC_037339.1,NC_032661.1,73262304,70957675,70957676,t,tc,1
NC_037339.1,NC_032661.1,73403459,71098896,71098897,G,GA,1
NC_037339.1,NC_032661.1,73514705,71209930,71209931,g,ga,1
NC_037339.1,NC_032661.1,73527708,71222934,71222935,t,tN,1
NC_037339.1,NC_032661.1,73608051,71298364,71298365,C,CT,1
NC_037339.1,NC_032661.1,73609320,71299634,71299635,c,ca,1
NC_037339.1,NC_032661.1,73682239,71372241,71372250,C,CCCTTTGCAG,9
NC_037339.1,NC_032661.1,73888691,71579365,71579366,t,tN,1
NC_037339.1,NC_032661.1,73903658,71594340,71594341,a,aN,1
NC_037339.1,NC_032661.1,73941087,71631776,71631777,G,GT,1
NC_037339.1,NC_032661.1,73987355,71677831,71677832,C,CA,1
NC_037339.1,NC_032661.1,73987388,71677865,71677867,T,TAA,2
NC_037339.1,NC_032661.1,74043081,71733566,71733568,c,cat,2
NC_037339.1,NC_032661.1,74097135,71787831,71787832,g,gt,1
NC_037339.1,NC_032661.1,74280509,71967240,71967241,T,TA,1
NC_037339.1,NC_032661.1,74315993,72003483,72003485,A,AAC,2
NC_037339.1,NC_032661.1,74316081,72003574,72003578,C,CNNNN,4
NC_037339.1,NC_032661.1,74343007,72030503,72030504,c,ca,1
NC_037339.1,NC_032661.1,74361371,72048868,72048869,A,AG,1
NC_037339.1,NC_032661.1,74448659,72135820,72135821,A,AG,1
NC_037339.1,NC_032661.1,74450660,72137866,72137867,T,TK,1
NC_037339.1,NC_032661.1,74514884,72201794,72201795,A,AC,1
NC_037339.1,NC_032661.1,74580485,72291263,72291264,c,ca,1
NC_037339.1,NC_032661.1,74584363,72296345,72296346,t,tg,1
NC_037339.1,NC_032661.1,74641667,72353652,72353653,t,tg,1
NC_037339.1,NC_032661.1,74641760,72353744,72353745,C,CY,1
NC_037339.1,NC_032661.1,74679778,72392030,72392032,a,aac,2
NC_037339.1,NC_032661.1,74718935,72431187,72431188,G,GA,1
NC_037339.1,NC_032661.1,74776673,72488529,72488530,c,ct,1
NC_037339.1,NC_032661.1,74942831,72655934,72655935,C,CY,1
NC_037339.1,NC_032661.1,75014365,72727470,72727472,c,cgg,2
NC_037339.1,NC_032661.1,75108784,72821701,72821706,A,AAAGTG,5
NC_037339.1,NC_032661.1,75137447,72850369,72850370,a,aR,1
NC_037339.1,NC_032661.1,75141264,72854184,72854185,T,TA,1
NC_037339.1,NC_032661.1,75311772,73023192,73023193,A,AW,1
NC_037339.1,NC_032661.1,75311802,73023224,73023225,C,CG,1
NC_037339.1,NC_032661.1,75368978,73080398,73080400,t,tca,2
NC_037339.1,NC_032661.1,75384847,73096268,73096271,T,TAGA,3
NC_037339.1,NC_032661.1,75570627,73422294,73422296,T,TAA,2
NC_037339.1,NC_032661.1,75675855,73529271,73529273,t,tNN,2
NC_037339.1,NC_032661.1,75745943,73600363,73600364,T,TY,1
NC_037339.1,NC_032661.1,75874874,73729299,73729300,A,AT,1
NC_037339.1,NC_032661.1,75877246,73731672,73731673,c,ca,1
NC_037339.1,NC_032661.1,76397677,74249799,74249801,C,CTT,2
NC_037339.1,NC_032661.1,76732412,74590071,74590073,G,GCT,2
NC_037339.1,NC_032661.1,76803106,74661472,74661473,a,ag,1
NC_037339.1,NC_032661.1,76943398,74802631,74802633,c,ccg,2
NC_037339.1,NC_032661.1,76996725,74855993,74855994,g,gt,1
NC_037339.1,NC_032661.1,77083176,74942508,74942509,A,AW,1
NC_037339.1,NC_032661.1,77085373,74944706,74944707,G,GR,1
NC_037339.1,NC_032661.1,77099105,74958441,74958443,G,GTC,2
NC_037339.1,NC_032661.1,77119177,74978558,74978559,a,ac,1
NC_037339.1,NC_032661.1,77123668,74983049,74983053,G,GCTCT,4
NC_037339.1,NC_032661.1,77138602,74998266,74998267,t,tc,1
NC_037339.1,NC_032661.1,77138609,74998274,74998275,t,tc,1
NC_037339.1,NC_032661.1,77138627,74998293,74998294,c,ca,1
NC_037339.1,NC_032661.1,77212962,75102553,75102554,C,CM,1
NC_037339.1,NC_032661.1,77212968,75102560,75102561,A,AG,1
NC_037339.1,NC_032661.1,77213076,75102671,75102672,t,tg,1
NC_037339.1,NC_032661.1,77264895,75153586,75153587,a,ac,1
NC_037339.1,NC_032661.1,77314404,75202821,75202832,c,caatggaaacag,11
NC_037339.1,NC_032661.1,77543412,75432873,75432874,t,tg,1
NC_037339.1,NC_032661.1,77543451,75432913,75432914,g,ga,1
NC_037339.1,NC_032661.1,77810232,75704077,75704078,A,AR,1
NC_037339.1,NC_032661.1,77820245,75715923,75715924,t,tg,1
NC_037339.1,NC_032661.1,77820348,75716027,75716029,g,gga,2
NC_037339.1,NC_032661.1,77825233,75720913,75720914,C,CM,1
NC_037339.1,NC_032661.1,77975346,75870996,75871005,t,tagttttgga,9
NC_037339.1,NC_032661.1,77980657,75876318,75876319,G,GA,1
NC_037339.1,NC_032661.1,78068910,75964382,75964383,t,tg,1
NC_037339.1,NC_032661.1,78196750,76044305,76044306,G,GK,1
NC_037339.1,NC_032661.1,78196755,76044311,76044313,C,CAA,2
NC_037339.1,NC_032661.1,78387208,76242972,76242973,C,CA,1
NC_037339.1,NC_032661.1,78521099,76381491,76381492,C,CN,1
NC_037339.1,NC_032661.1,78531822,76392215,76392219,C,CACTA,4
NC_037339.1,NC_032661.1,78642954,76503601,76503603,T,TAA,2
NC_037339.1,NC_032661.1,78644479,76505130,76505132,A,ATT,2
NC_037339.1,NC_032661.1,78669972,76530632,76530634,t,taa,2
NC_037339.1,NC_032661.1,78716636,76577398,76577412,a,aaaaagaaagaaaag,14
NC_037339.1,NC_032661.1,78717081,76577856,76577858,C,CGA,2
NC_037339.1,NC_032661.1,78849439,76710167,76710168,a,at,1
NC_037339.1,NC_032661.1,78858178,76718907,76718917,G,GNNNNNNNNNN,10
NC_037339.1,NC_032661.1,79054355,76915151,76915153,g,gga,2
NC_037339.1,NC_032661.1,79292425,77167448,77167451,a,aagt,3
NC_037339.1,NC_032661.1,79491199,77371063,77371073,c,ctctcTTATCT,10
NC_037339.1,NC_032661.1,79700982,77531874,77531881,a,atatatat,7
NC_037339.1,NC_032661.1,79815869,77646683,77646684,T,TG,1
NC_037339.1,NC_032661.1,79815886,77646701,77646702,G,GA,1
NC_037339.1,NC_032661.1,79952385,77782422,77782424,g,gta,2
NC_037339.1,NC_032661.1,80185882,78079844,78079846,A,AAC,2
NC_037339.1,NC_032661.1,80389537,78283443,78283444,T,TC,1
NC_037339.1,NC_032661.1,80517447,78459893,78459894,T,TA,1
NC_037339.1,NC_032661.1,80524151,78466598,78466599,A,AW,1
NC_037339.1,NC_032661.1,80635212,78577662,78577663,C,CY,1
NC_037339.1,NC_032661.1,80774181,78754024,78754025,t,ta,1
NC_037339.1,NC_032661.1,80793033,78772883,78772884,a,ac,1
NC_037339.1,NC_032661.1,80823666,78803519,78803520,T,TA,1
NC_037339.1,NC_032661.1,80848801,78828655,78828656,t,ta,1
NC_037339.1,NC_032661.1,80906601,78886483,78886484,C,CM,1
NC_037339.1,NC_032661.1,80906770,78886653,78886654,A,AG,1
NC_037339.1,NC_032661.1,80907070,78886954,78886956,a,att,2
NC_037339.1,NC_032661.1,81005365,78985276,78985277,c,ct,1
NC_037339.1,NC_032661.1,81048690,79028604,79028605,A,AT,1
NC_037339.1,NC_032661.1,81114693,79094639,79094645,t,tacacac,6
NC_037339.1,NC_032661.1,81117545,79097501,79097502,c,ct,1
NC_037339.1,NC_032661.1,81141205,79121264,79121265,c,ct,1
NC_037339.1,NC_032661.1,81164663,79144690,79144691,A,AC,1
NC_037339.1,NC_032661.1,81165148,79145176,79145182,a,aNNNNNN,6
NC_037339.1,NC_032661.1,81174964,79155002,79155003,C,CA,1
NC_037339.1,NC_032661.1,81189888,79169928,79169929,G,GT,1
NC_037339.1,NC_032661.1,81216824,79196880,79196883,a,aaat,3
NC_037339.1,NC_032661.1,81219220,79199280,79199281,a,at,1
NC_037339.1,NC_032661.1,81230694,79211528,79211529,T,TC,1
NC_037339.1,NC_032661.1,81259609,79240002,79240003,G,GT,1
NC_037339.1,NC_032661.1,81276358,79256556,79256557,t,ta,1
NC_037339.1,NC_032661.1,81311376,79291491,79291493,C,CTG,2
NC_037339.1,NC_032661.1,81314270,79294388,79294389,C,CY,1
NC_037339.1,NC_032661.1,81321191,79301296,79301298,T,TCA,2
NC_037339.1,NC_032661.1,81346492,79326605,79326607,a,aaN,2
NC_037339.1,NC_032661.1,81355630,79335745,79335747,C,CAA,2
NC_037339.1,NC_032661.1,81371581,79420717,79420718,T,TK,1
NC_037339.1,NC_032661.1,81392303,79441969,79441970,T,TA,1
NC_037339.1,NC_032661.1,81401112,79451280,79451282,C,CTA,2
NC_037339.1,NC_032661.1,81401182,79451352,79451354,C,CTA,2
NC_037339.1,NC_032661.1,81462886,79513058,79513061,T,TGTC,3
NC_037339.1,NC_032661.1,81603830,79654173,79654174,c,ct,1
NC_037339.1,NC_032661.1,81826061,79922227,79922228,c,ca,1
NC_037339.1,NC_032661.1,81881405,79977571,79977572,G,GK,1
NC_037339.1,NC_032661.1,81914898,80011061,80011062,c,ca,1
NC_037339.1,NC_032661.1,81927133,80023290,80023291,A,AG,1
NC_037339.1,NC_032661.1,82002304,80098305,80098307,a,act,2
NC_037339.1,NC_032661.1,82057728,80180882,80180883,A,AR,1
NC_037339.1,NC_032661.1,82275265,80398302,80398303,c,ca,1
NC_037339.1,NC_032661.1,82276933,80399840,80399841,G,GS,1
NC_037339.1,NC_032661.1,82280584,80403491,80403492,G,GA,1
NC_037339.1,NC_032661.1,82448698,80569862,80569864,a,aag,2
NC_037339.1,NC_032661.1,82500021,80627005,80627007,T,TCG,2
NC_037339.1,NC_032661.1,82647754,80778846,80778847,G,GK,1
NC_037339.1,NC_032661.1,82794783,80925891,80925892,c,ct,1
NC_037339.1,NC_032661.1,82795132,80926241,80926242,T,TG,1
NC_037339.1,NC_032661.1,82802056,80933166,80933168,C,CAA,2
NC_037339.1,NC_032661.1,82920364,81051486,81051487,C,CT,1
NC_037339.1,NC_032661.1,82932090,81063208,81063211,g,gact,3
NC_037339.1,NC_032661.1,82934493,81065615,81065616,a,aN,1
NC_037339.1,NC_032661.1,82937237,81068352,81068353,A,AG,1
NC_037339.1,NC_032661.1,82947663,81078749,81078754,A,AGAAAC,5
NC_037339.1,NC_032661.1,83020052,81151148,81151149,c,ct,1
NC_037339.1,NC_032661.1,83020374,81151471,81151473,c,cta,2
NC_037339.1,NC_032661.1,83220497,81350628,81350635,G,GATAATTA,7
NC_037339.1,NC_032661.1,83311200,81440986,81440987,c,ca,1
NC_037339.1,NC_032661.1,83323281,81453069,81453070,c,cg,1
NC_037339.1,NC_032661.1,83340211,81470008,81470010,T,TAC,2
NC_037339.1,NC_032661.1,83373716,81503471,81503473,C,CCM,2
NC_037339.1,NC_032661.1,83412671,81542448,81542449,t,ta,1
NC_037339.1,NC_032661.1,83478204,81607871,81607872,a,ag,1
NC_037339.1,NC_032661.1,83494476,81624160,81624161,a,aC,1
NC_037339.1,NC_032661.1,83496568,81626255,81626269,C,CTGCAGAATATTCTG,14
NC_037339.1,NC_032661.1,83525008,81654723,81654724,G,GT,1
NC_037339.1,NC_032661.1,83566795,81696512,81696513,c,cM,1
NC_037339.1,NC_032661.1,83758552,81887192,81887193,a,ag,1
NC_037339.1,NC_032661.1,83758567,81887208,81887209,g,ga,1
NC_037339.1,NC_032661.1,83783494,81912134,81912135,C,CY,1
NC_037339.1,NC_032661.1,83813196,81941860,81941861,g,gt,1
NC_037339.1,NC_032661.1,83824155,81952819,81952836,T,TTATTACATAGAATATTA,17
NC_037339.1,NC_032661.1,83826051,81954737,81954739,a,aaG,2
NC_037339.1,NC_032661.1,83841366,81969765,81969771,c,ctgtgtg,6
NC_037339.1,NC_032661.1,83845847,81974255,81974257,g,gtc,2
NC_037339.1,NC_032661.1,83889018,82020119,82020120,C,CM,1
NC_037339.1,NC_032661.1,83902248,82033379,82033399,g,gagtgggtcAGGCTCTGCTTT,20
NC_037339.1,NC_032661.1,83914496,82045650,82045651,G,GT,1
NC_037339.1,NC_032661.1,83919327,82050477,82050478,c,ct,1
NC_037339.1,NC_032661.1,83919629,82050780,82050782,C,CTT,2
NC_037339.1,NC_032661.1,83919652,82050805,82050820,G,GGCATAATAAATATCA,15
NC_037339.1,NC_032661.1,83925887,82057064,82057065,t,tc,1
NC_037339.1,NC_032661.1,83983116,82111271,82111274,G,GAGA,3
NC_037339.1,NC_032661.1,83986047,82114207,82114209,a,atg,2
NC_037339.1,NC_032661.1,84019040,82149084,82149085,a,ag,1
NC_037339.1,NC_032661.1,84031347,82165192,82165193,C,CN,1
NC_037339.1,NC_032661.1,84032319,82168202,82168204,T,TTA,2
NC_037339.1,NC_032661.1,84036216,82172098,82172099,A,AW,1
NC_037339.1,NC_032661.1,84075353,82211247,82211249,t,tta,2
NC_037339.1,NC_032661.1,84075387,82211283,82211284,a,ag,1
NC_037339.1,NC_032661.1,84076694,82212591,82212596,T,TTCATC,5
NC_037339.1,NC_032661.1,84089797,82225696,82225699,A,ACTT,3
NC_037339.1,NC_032661.1,84140542,82276448,82276449,T,TY,1
NC_037339.1,NC_032661.1,84200099,82336008,82336028,T,TNNNNNNNNNNNNNNNNNNNN,20
NC_037339.1,NC_032661.1,84231245,82367175,82367176,g,ga,1
NC_037339.1,NC_032661.1,84239569,82375501,82375502,g,gc,1
NC_037339.1,NC_032661.1,84264761,82400401,82400402,C,CA,1
NC_037339.1,NC_032661.1,84267138,82402779,82402780,G,GA,1
NC_037339.1,NC_032661.1,84333806,82469509,82469510,A,AT,1
NC_037339.1,NC_032661.1,84333808,82469512,82469513,T,TA,1
NC_037339.1,NC_032661.1,84385686,82521425,82521426,C,CS,1
NC_037339.1,NC_032661.1,84457577,82609561,82609562,g,gt,1
NC_037339.1,NC_032661.1,84507911,82659600,82659601,C,CY,1
NC_037339.1,NC_032661.1,84678443,82850689,82850690,T,TW,1
NC_037339.1,NC_032661.1,84679151,82851398,82851399,C,CA,1
NC_037339.1,NC_032661.1,84686330,82858578,82858579,A,AC,1
NC_037339.1,NC_032661.1,84686634,82858884,82858885,G,GR,1
NC_037339.1,NC_032661.1,84691893,82864146,82864148,A,ACG,2
NC_037339.1,NC_032661.1,84713856,82886125,82886126,G,GA,1
NC_037339.1,NC_032661.1,84713888,82886158,82886242,A,AACCCGACATACGCATGCTCtacgattcagcaattccactcctaagcaTGTGTTCACCCACAATGCATACAAATGTGCACCAAAC,84
NC_037339.1,NC_032661.1,84717988,82890343,82890346,c,cagt,3
NC_037339.1,NC_032661.1,84721961,82894316,82894317,G,GR,1
NC_037339.1,NC_032661.1,84725760,82898121,82898122,g,gA,1
NC_037339.1,NC_032661.1,84728276,82900637,82900638,T,TM,1
NC_037339.1,NC_032661.1,84728506,82900868,82900869,a,ag,1
NC_037339.1,NC_032661.1,84830551,83004194,83004200,C,CAACTTT,6
NC_037339.1,NC_032661.1,84831093,83004742,83004743,C,CG,1
NC_037339.1,NC_032661.1,84851589,83025344,83025347,g,gtgt,3
NC_037339.1,NC_032661.1,84852789,83026450,83026452,t,tNN,2
NC_037339.1,NC_032661.1,84909825,83081519,83081542,A,AAGATCAATAGATCAATAATTGAC,23
NC_037339.1,NC_032661.1,84916787,83088505,83088506,G,GA,1
NC_037339.1,NC_032661.1,84950927,83122645,83122646,G,GS,1
NC_037339.1,NC_032661.1,84951017,83122736,83122737,G,GS,1
NC_037339.1,NC_032661.1,84991318,83163050,83163051,C,CG,1
NC_037339.1,NC_032661.1,85101949,83271460,83271462,C,CCS,2
NC_037339.1,NC_032661.1,85103002,83272515,83272516,G,GR,1
NC_037339.1,NC_032661.1,85106782,83276295,83276296,A,AC,1
NC_037339.1,NC_032661.1,85114518,83284240,83284241,C,CM,1
NC_037339.1,NC_032661.1,85122405,83292128,83292129,G,GC,1
NC_037339.1,NC_032661.1,85174016,83348174,83348176,T,TTA,2
NC_037339.1,NC_032661.1,85236016,83410179,83410180,C,CG,1
NC_037339.1,NC_032661.1,85236094,83410258,83410259,c,cg,1
NC_037339.1,NC_032661.1,85236179,83410344,83410345,c,cg,1
NC_037339.1,NC_032661.1,85300057,83473211,83473212,A,AG,1
NC_037339.1,NC_032661.1,85463734,83713599,83713600,C,CG,1
NC_037339.1,NC_032661.1,85507301,83757060,83757061,C,CY,1
NC_037339.1,NC_032661.1,85509536,83759294,83759295,C,CA,1
NC_037339.1,NC_032661.1,85571746,83821818,83821820,t,tta,2
NC_037339.1,NC_032661.1,85784028,84035616,84035617,C,CA,1
NC_037339.1,NC_032661.1,85870489,84121612,84121613,G,GA,1
NC_037339.1,NC_032661.1,85971264,84220018,84220019,a,ag,1
NC_037339.1,NC_032661.1,86004089,84252843,84252850,c,ccagcaaa,7
NC_037339.1,NC_032661.1,86014100,84263056,84263057,C,CG,1
NC_037339.1,NC_032661.1,86075425,84324286,84324290,A,AGGCT,4
NC_037339.1,NC_032661.1,86087766,84336630,84336631,G,GC,1
NC_037339.1,NC_032661.1,86129097,84377587,84377588,C,CM,1
NC_037339.1,NC_032661.1,86163718,84411484,84411485,A,AR,1
NC_037339.1,NC_032661.1,86168133,84415886,84415887,A,AG,1
NC_037339.1,NC_032661.1,86184999,84432728,84432731,A,ATNN,3
NC_037339.1,NC_032661.1,86204909,84452641,84452642,C,CT,1
NC_037339.1,NC_032661.1,86204950,84452683,84452684,C,CT,1
NC_037339.1,NC_032661.1,86248957,84496711,84496718,c,ctttcact,7
NC_037339.1,NC_032661.1,86269820,84518404,84518410,C,CTCTCTA,6
NC_037339.1,NC_032661.1,86269862,84518452,84518454,C,CNN,2
NC_037339.1,NC_032661.1,86269915,84518509,84518510,G,GC,1
NC_037339.1,NC_032661.1,86302981,84551503,84551559,T,TGGCAGGGGCGTCAGGGCTGGGGGCGTGGCCTCCCGAACATGTGGCAGGGGCGTCAG,56
NC_037339.1,NC_032661.1,86303085,84551663,84551664,G,GA,1
NC_037339.1,NC_032661.1,86346539,84595378,84595381,t,tttg,3
NC_037339.1,NC_032661.1,86347256,84596098,84596099,C,CT,1
NC_037339.1,NC_032661.1,86349227,84597676,84597677,T,TA,1
NC_037339.1,NC_032661.1,86349310,84597760,84597761,A,AC,1
NC_037339.1,NC_032661.1,86349739,84598190,84598191,A,AC,1
NC_037339.1,NC_032661.1,86350220,84598918,84598967,A,AGTCCTTTCTGACTAGAGTCTGGATTCTGTCCCATGGCTGGTTTGAGGGG,49
NC_037339.1,NC_032661.1,86450962,84699375,84699376,T,TK,1
NC_037339.1,NC_032661.1,86502465,84751149,84751150,C,CA,1
NC_037339.1,NC_032661.1,86604011,84854295,84854299,a,acccc,4
NC_037339.1,NC_032661.1,86608232,84858519,84858520,A,AG,1
NC_037339.1,NC_032661.1,86639535,84889258,84889259,G,GN,1
NC_037339.1,NC_032661.1,86682843,84932693,84932703,C,CCCGGGGGCCG,10
NC_037339.1,NC_032661.1,86740362,84989935,84989936,G,GC,1
NC_037339.1,NC_032661.1,86795786,85055890,85055891,C,CT,1
NC_037339.1,NC_032661.1,86807885,85068022,85068023,T,TK,1
NC_037339.1,NC_032661.1,86858017,85126538,85126539,A,AR,1
NC_037339.1,NC_032661.1,86862062,85130584,85130600,G,GTCCCCGGCCGGAGCCT,16
NC_037339.1,NC_032661.1,86868950,85137483,85137484,G,GR,1
NC_037339.1,NC_032661.1,86926090,85190966,85190967,t,tg,1
NC_037339.1,NC_032661.1,86926362,85191238,85191240,G,GGT,2
NC_037339.1,NC_032661.1,86926378,85191256,85191257,G,GT,1
NC_037339.1,NC_032661.1,86926424,85191303,85191304,T,TC,1
NC_037339.1,NC_032661.1,86926574,85191454,85191514,G,GTGGCTCACATGTGGGGGTGTGGGGTTCCCATGGCTCATATGTGGGGGTGTGGGGTTCCCA,60
NC_037339.1,NC_032661.1,86926765,85191707,85191708,T,TG,1
NC_037339.1,NC_032661.1,86926800,85191743,85191744,G,GT,1
NC_037339.1,NC_032661.1,86926804,85191748,85191749,T,TK,1
NC_037339.1,NC_032661.1,86927999,85192943,85192944,T,TG,1
NC_037339.1,NC_032661.1,86928133,85193078,85193079,A,AG,1
NC_037339.1,NC_032661.1,86928148,85193094,85193095,G,GA,1
NC_037339.1,NC_032661.1,86928206,85193153,85193154,A,AG,1
NC_037339.1,NC_032661.1,86928250,85193198,85193199,G,GC,1
NC_037339.1,NC_032661.1,86928328,85193275,85193276,G,GA,1
NC_037339.1,NC_032661.1,86928341,85193289,85193291,A,AAG,2
NC_037339.1,NC_032661.1,86929150,85194099,85194100,c,ct,1
NC_037339.1,NC_032661.1,86929165,85194115,85194116,G,GA,1
NC_037339.1,NC_032661.1,86929266,85194216,85194217,T,TG,1
NC_037339.1,NC_032661.1,86929753,85194700,85194701,A,AC,1
NC_037339.1,NC_032661.1,86987484,85264636,85264637,C,CS,1
NC_037339.1,NC_032661.1,87003892,85281049,85281050,G,GC,1
NC_037339.1,NC_032661.1,87034731,85311888,85311890,T,TTC,2
NC_037339.1,NC_032661.1,87043783,85320943,85320944,G,GA,1
NC_037339.1,NC_032661.1,87073628,85350791,85350796,T,TGCTGC,5
NC_037339.1,NC_032661.1,87078695,85355795,85355796,t,ta,1
NC_037339.1,NC_032661.1,87082587,85359692,85359694,C,CTG,2
NC_037339.1,NC_032661.1,87082604,85359711,85359712,T,TG,1
NC_037339.1,NC_032661.1,87126005,85403848,85403849,C,CT,1
NC_037339.1,NC_032661.1,87126821,85404662,85404671,A,ATGGTTTAAG,9
NC_037339.1,NC_032661.1,87143307,85415819,85415820,G,GC,1
NC_037339.1,NC_032661.1,87143362,85415875,85415876,T,TG,1
NC_037339.1,NC_032661.1,87143586,85416100,85416101,a,at,1
NC_037339.1,NC_032661.1,87143712,85416227,85416228,C,CG,1
NC_037339.1,NC_032661.1,87144111,85416624,85416625,a,ac,1
NC_037339.1,NC_032661.1,87144717,85417230,85417235,g,gacttc,5
NC_037339.1,NC_032661.1,87145671,85418190,85418191,g,gt,1
NC_037339.1,NC_032661.1,87148630,85421150,85421159,C,CTTTACTTTY,9
NC_037339.1,NC_032661.1,87158270,85430814,85430816,A,ACT,2
NC_037339.1,NC_032661.1,87158362,85430908,85430909,A,AT,1
NC_037339.1,NC_032661.1,87158935,85431478,85431480,G,GGA,2
NC_037339.1,NC_032661.1,87158938,85431483,85431484,G,GT,1
NC_037339.1,NC_032661.1,87159086,85431631,85431632,a,ac,1
NC_037339.1,NC_032661.1,87159114,85431660,85431661,t,tc,1
NC_037339.1,NC_032661.1,87159155,85431702,85431703,g,gc,1
NC_037339.1,NC_032661.1,87159262,85431811,85431812,t,tc,1
NC_037339.1,NC_032661.1,87159398,85431948,85431949,G,GC,1
