Reference ID,Query ID,Reference POS,Query POS,Query END,REF,ALT,SVLEN
NC_037333.1,NC_032655.1,106333,553,555,A,AAG,2
NC_037333.1,NC_032655.1,106518,739,740,G,GT,1
NC_037333.1,NC_032655.1,110175,4397,4398,T,TG,1
NC_037333.1,NC_032655.1,182480,69305,69306,g,gt,1
NC_037333.1,NC_032655.1,182673,69499,69500,c,ca,1
NC_037333.1,NC_032655.1,183124,69950,69951,a,ag,1
NC_037333.1,NC_032655.1,184947,71774,71775,A,AT,1
NC_037333.1,NC_032655.1,189860,76690,76691,t,ta,1
NC_037333.1,NC_032655.1,229489,116204,116205,a,ag,1
NC_037333.1,NC_032655.1,243636,130355,130357,t,taa,2
NC_037333.1,NC_032655.1,245477,132196,132197,g,gt,1
NC_037333.1,NC_032655.1,253428,140149,140153,g,ggaaa,4
NC_037333.1,NC_032655.1,257104,143829,143830,a,at,1
NC_037333.1,NC_032655.1,295087,180125,180127,t,taa,2
NC_037333.1,NC_032655.1,303883,189941,189942,A,AG,1
NC_037333.1,NC_032655.1,304298,190358,190367,t,tcatgccatc,9
NC_037333.1,NC_032655.1,304467,190536,190539,t,tctc,3
NC_037333.1,NC_032655.1,316994,203168,203169,t,tc,1
NC_037333.1,NC_032655.1,321617,208041,208042,T,TC,1
NC_037333.1,NC_032655.1,393353,279879,279880,T,TW,1
NC_037333.1,NC_032655.1,398516,285046,285047,t,tc,1
NC_037333.1,NC_032655.1,436558,323095,323097,A,AAG,2
NC_037333.1,NC_032655.1,463404,349873,349874,c,ct,1
NC_037333.1,NC_032655.1,514012,401583,401584,g,ga,1
NC_037333.1,NC_032655.1,514458,402030,402032,A,ATC,2
NC_037333.1,NC_032655.1,529901,417499,417504,a,acacac,5
NC_037333.1,NC_032655.1,529960,417563,417566,C,CATG,3
NC_037333.1,NC_032655.1,539541,427148,427149,t,ta,1
NC_037333.1,NC_032655.1,540008,427616,427617,t,tc,1
NC_037333.1,NC_032655.1,549573,437224,437225,c,ct,1
NC_037333.1,NC_032655.1,554888,442539,442547,a,aNNNNNNNN,8
NC_037333.1,NC_032655.1,558875,446541,446542,g,gc,1
NC_037333.1,NC_032655.1,566221,453887,453892,c,ctttat,5
NC_037333.1,NC_032655.1,571314,458984,458985,a,at,1
NC_037333.1,NC_032655.1,573864,461534,461544,a,atttttttttt,10
NC_037333.1,NC_032655.1,613293,502097,502098,g,gc,1
NC_037333.1,NC_032655.1,623473,515482,515483,G,GC,1
NC_037333.1,NC_032655.1,623487,515497,515498,T,TC,1
NC_037333.1,NC_032655.1,623494,515505,515506,A,AT,1
NC_037333.1,NC_032655.1,629423,530777,530778,t,tY,1
NC_037333.1,NC_032655.1,633808,535164,535165,t,ta,1
NC_037333.1,NC_032655.1,637297,540149,540156,a,accctcct,7
NC_037333.1,NC_032655.1,642147,546163,546164,t,tc,1
NC_037333.1,NC_032655.1,696526,600563,600564,T,TG,1
NC_037333.1,NC_032655.1,705378,609570,609571,c,ca,1
NC_037333.1,NC_032655.1,709967,614158,614159,a,at,1
NC_037333.1,NC_032655.1,713025,617225,617226,c,ca,1
NC_037333.1,NC_032655.1,729494,633284,633285,c,ca,1
NC_037333.1,NC_032655.1,735188,638997,638998,a,ac,1
NC_037333.1,NC_032655.1,735977,639787,639788,t,tc,1
NC_037333.1,NC_032655.1,754559,658376,658377,T,TC,1
NC_037333.1,NC_032655.1,754775,658593,658594,A,AT,1
NC_037333.1,NC_032655.1,760961,664783,664784,A,AR,1
NC_037333.1,NC_032655.1,765231,669053,669054,c,ct,1
NC_037333.1,NC_032655.1,804210,710431,710432,a,at,1
NC_037333.1,NC_032655.1,844438,749862,749870,t,tatatataW,8
NC_037333.1,NC_032655.1,851687,758063,758066,T,TTAK,3
NC_037333.1,NC_032655.1,863135,769550,769551,T,TG,1
NC_037333.1,NC_032655.1,863777,770193,770194,C,CA,1
NC_037333.1,NC_032655.1,864057,770474,770476,A,AAC,2
NC_037333.1,NC_032655.1,866102,772520,772521,C,CY,1
NC_037333.1,NC_032655.1,872055,778470,778471,a,at,1
NC_037333.1,NC_032655.1,872764,779180,779181,a,ag,1
NC_037333.1,NC_032655.1,874095,780512,780513,a,at,1
NC_037333.1,NC_032655.1,878975,785410,785411,C,CM,1
NC_037333.1,NC_032655.1,884660,791078,791079,g,gc,1
NC_037333.1,NC_032655.1,887246,793668,793669,t,tc,1
NC_037333.1,NC_032655.1,891989,798322,798332,A,AAGCTTCTTAC,10
NC_037333.1,NC_032655.1,901423,807758,807765,t,tgaaagtg,7
NC_037333.1,NC_032655.1,973375,894592,894594,t,tga,2
NC_037333.1,NC_032655.1,974991,896210,896211,t,tg,1
NC_037333.1,NC_032655.1,975005,896225,896226,t,tc,1
NC_037333.1,NC_032655.1,982034,903254,903286,a,atatatatatatatatttatttatttatttatt,32
NC_037333.1,NC_032655.1,991671,912893,912894,a,ac,1
NC_037333.1,NC_032655.1,1002800,924013,924014,t,tg,1
NC_037333.1,NC_032655.1,1031498,952712,952715,A,AACT,3
NC_037333.1,NC_032655.1,1032186,953404,953406,T,TTR,2
NC_037333.1,NC_032655.1,1040482,961699,961702,t,tttg,3
NC_037333.1,NC_032655.1,1071765,993001,993002,T,TY,1
NC_037333.1,NC_032655.1,1085527,1006782,1006783,t,tg,1
NC_037333.1,NC_032655.1,1088457,1009726,1009727,T,TC,1
NC_037333.1,NC_032655.1,1091692,1012962,1012963,t,tg,1
NC_037333.1,NC_032655.1,1093173,1014455,1014456,a,ag,1
NC_037333.1,NC_032655.1,1097125,1018266,1018267,A,AW,1
NC_037333.1,NC_032655.1,1138865,1060693,1060695,t,tNN,2
NC_037333.1,NC_032655.1,1141469,1063300,1063302,t,tta,2
NC_037333.1,NC_032655.1,1143697,1065531,1065532,A,AM,1
NC_037333.1,NC_032655.1,1150719,1072577,1072578,c,ct,1
NC_037333.1,NC_032655.1,1160055,1081915,1081918,C,CGGT,3
NC_037333.1,NC_032655.1,1160915,1082778,1082780,A,AAG,2
NC_037333.1,NC_032655.1,1161424,1083290,1083291,T,TK,1
NC_037333.1,NC_032655.1,1165756,1088352,1088354,a,att,2
NC_037333.1,NC_032655.1,1180876,1103477,1103478,a,ag,1
NC_037333.1,NC_032655.1,1184149,1106753,1106791,a,aatatatatatatatatatatatatatatatatatatat,38
NC_037333.1,NC_032655.1,1190454,1113079,1113087,c,caaaagtag,8
NC_037333.1,NC_032655.1,1191262,1113897,1113902,a,aaaaat,5
NC_037333.1,NC_032655.1,1192436,1115077,1115078,c,ca,1
NC_037333.1,NC_032655.1,1194200,1116851,1116853,c,cat,2
NC_037333.1,NC_032655.1,1198131,1120461,1120462,c,ca,1
NC_037333.1,NC_032655.1,1206133,1127801,1127802,g,gt,1
NC_037333.1,NC_032655.1,1206480,1128149,1128153,a,aaaat,4
NC_037333.1,NC_032655.1,1275828,1188520,1188521,a,ag,1
NC_037333.1,NC_032655.1,1275831,1188524,1188525,g,gc,1
NC_037333.1,NC_032655.1,1384812,1398370,1398372,g,gtt,2
NC_037333.1,NC_032655.1,1948080,1492862,1492863,a,ac,1
NC_037333.1,NC_032655.1,1951166,1495949,1495950,t,tY,1
NC_037333.1,NC_032655.1,1978915,1538925,1538927,t,tNN,2
NC_037333.1,NC_032655.1,1992560,1552567,1552583,a,aaatatgtatatatatg,16
NC_037333.1,NC_032655.1,1992809,1552832,1552852,c,catatatatatatatatatat,20
NC_037333.1,NC_032655.1,1995637,1555682,1555686,g,gtata,4
NC_037333.1,NC_032655.1,2016908,1576956,1576958,t,tNN,2
NC_037333.1,NC_032655.1,2084781,1644831,1644832,c,ct,1
NC_037333.1,NC_032655.1,2084781,1688676,1688677,c,ct,1
NC_037333.1,NC_032655.1,2084805,1688701,1688702,c,ct,1
NC_037333.1,NC_032655.1,2086239,1690136,1690137,a,at,1
NC_037333.1,NC_032655.1,2227728,1832026,1832027,T,TK,1
NC_037333.1,NC_032655.1,2227818,1832118,1832119,t,ta,1
NC_037333.1,NC_032655.1,2324723,1929027,1929028,t,ta,1
NC_037333.1,NC_032655.1,2483416,2314796,2314797,A,AT,1
NC_037333.1,NC_032655.1,2534932,2444075,2444076,a,ac,1
NC_037333.1,NC_032655.1,2584544,2449656,2449662,t,ttatata,6
NC_037333.1,NC_032655.1,2886635,2769574,2769575,a,at,1
NC_037333.1,NC_032655.1,2906654,2789599,2789600,c,ct,1
NC_037333.1,NC_032655.1,2929611,2813380,2813381,A,AT,1
NC_037333.1,NC_032655.1,2949364,2833213,2833214,G,GA,1
NC_037333.1,NC_032655.1,2971898,2855755,2855756,C,CA,1
NC_037333.1,NC_032655.1,2972983,2856841,2856844,c,cMaa,3
NC_037333.1,NC_032655.1,2973688,2857549,2857570,T,TNNNNNNNNNNNNNNNNNNNNN,21
NC_037333.1,NC_032655.1,2977792,2861673,2861689,c,caaaaaaaaaaatattt,16
NC_037333.1,NC_032655.1,2979396,2863293,2863294,g,ga,1
NC_037333.1,NC_032655.1,2997593,2881492,2881504,a,atgtgtgtgtgtg,12
NC_037333.1,NC_032655.1,3002509,2886422,2886424,T,TTC,2
NC_037333.1,NC_032655.1,3002718,2886633,2886634,A,AW,1
NC_037333.1,NC_032655.1,3003671,2887587,2887589,T,TAC,2
NC_037333.1,NC_032655.1,3014734,2898655,2898656,T,TC,1
NC_037333.1,NC_032655.1,3018057,2901989,2901990,T,TY,1
NC_037333.1,NC_032655.1,3028104,2912121,2912125,g,ggttc,4
NC_037333.1,NC_032655.1,3028978,2913005,2913011,t,tgGGATA,6
NC_037333.1,NC_032655.1,3029939,2913973,2913977,T,TAGAW,4
NC_037333.1,NC_032655.1,3037587,2921627,2921628,T,TC,1
NC_037333.1,NC_032655.1,3041041,2925083,2925086,a,aaag,3
NC_037333.1,NC_032655.1,3079851,2963929,2963930,t,tc,1
NC_037333.1,NC_032655.1,3081060,2965139,2965141,T,TTA,2
NC_037333.1,NC_032655.1,3101755,2987529,2987534,a,aaattg,5
NC_037333.1,NC_032655.1,3278890,3163636,3163637,c,ct,1
NC_037333.1,NC_032655.1,3384316,3339749,3339750,a,ag,1
NC_037333.1,NC_032655.1,3385048,3340476,3340627,a,aggcctggcgagctgcggttcatggggtcgcaaagagtcggacacgactgagcgactgaactgaactgaactgaaaggggtcCTAGGGccaaaagtttgagaactgctgcttGTAAACTGACTCTTAGGGCGGTGAAACATATTTCTTTGAG,151
NC_037333.1,NC_032655.1,3390656,3346083,3346085,C,CCT,2
NC_037333.1,NC_032655.1,3392702,3348133,3348134,A,AW,1
NC_037333.1,NC_032655.1,3403686,3359124,3359128,t,ttttg,4
NC_037333.1,NC_032655.1,3404575,3360019,3360020,c,ct,1
NC_037333.1,NC_032655.1,3423560,3379045,3379046,a,at,1
NC_037333.1,NC_032655.1,3424278,3379764,3379768,T,TATTA,4
NC_037333.1,NC_032655.1,3442801,3398290,3398291,T,TW,1
NC_037333.1,NC_032655.1,3468122,3423609,3423610,t,ta,1
NC_037333.1,NC_032655.1,3481735,3437377,3437379,A,AAT,2
NC_037333.1,NC_032655.1,3485408,3441053,3441054,G,GR,1
NC_037333.1,NC_032655.1,3486155,3441801,3441802,T,TW,1
NC_037333.1,NC_032655.1,3516343,3513734,3513735,G,GA,1
NC_037333.1,NC_032655.1,3516848,3514240,3514241,C,CT,1
NC_037333.1,NC_032655.1,3517000,3514393,3514397,A,AGGAC,4
NC_037333.1,NC_032655.1,3517249,3514646,3514647,G,GC,1
NC_037333.1,NC_032655.1,3539900,3537375,3537377,c,cat,2
NC_037333.1,NC_032655.1,3543149,3540628,3540632,T,TCTTA,4
NC_037333.1,NC_032655.1,3548192,3545675,3545676,T,TY,1
NC_037333.1,NC_032655.1,3569221,3566528,3566529,G,GA,1
NC_037333.1,NC_032655.1,3595191,3592498,3592502,a,atgtg,4
NC_037333.1,NC_032655.1,3640522,3640006,3640007,c,ca,1
NC_037333.1,NC_032655.1,3825799,3749003,3749023,A,AAGATGTGAAGGCTTATTCTG,20
NC_037333.1,NC_032655.1,3892515,3780316,3780317,G,GR,1
NC_037333.1,NC_032655.1,3899875,3787676,3787677,T,TA,1
NC_037333.1,NC_032655.1,3912260,3800092,3800094,t,tac,2
NC_037333.1,NC_032655.1,3924201,3812031,3812032,g,ga,1
NC_037333.1,NC_032655.1,3926762,3814592,3814593,T,TK,1
NC_037333.1,NC_032655.1,3930014,3817844,3817845,t,ta,1
NC_037333.1,NC_032655.1,3975911,3865617,3865619,t,tNN,2
NC_037333.1,NC_032655.1,4021406,3910778,3910779,G,GA,1
NC_037333.1,NC_032655.1,4040399,3929428,3929429,c,ct,1
NC_037333.1,NC_032655.1,4059533,3949021,3949022,t,tg,1
NC_037333.1,NC_032655.1,4101654,3990055,3990056,G,GA,1
NC_037333.1,NC_032655.1,4112528,4000970,4000971,g,gc,1
NC_037333.1,NC_032655.1,4119703,4008145,4008152,t,ttggtgtg,7
NC_037333.1,NC_032655.1,4119745,4008194,4008195,a,at,1
NC_037333.1,NC_032655.1,4121807,4010258,4010259,C,CA,1
NC_037333.1,NC_032655.1,4123526,4011973,4011974,t,tc,1
NC_037333.1,NC_032655.1,4127522,4015966,4015967,A,AG,1
NC_037333.1,NC_032655.1,4164990,4053598,4053599,A,AT,1
NC_037333.1,NC_032655.1,4168854,4057463,4057464,c,cg,1
NC_037333.1,NC_032655.1,4169339,4057949,4057951,a,aac,2
NC_037333.1,NC_032655.1,4174977,4064866,4064867,a,at,1
NC_037333.1,NC_032655.1,4182588,4072559,4072560,t,tc,1
NC_037333.1,NC_032655.1,4183214,4073185,4073186,a,ac,1
NC_037333.1,NC_032655.1,4184128,4074101,4074103,c,ctt,2
NC_037333.1,NC_032655.1,4199858,4089841,4089842,a,ac,1
NC_037333.1,NC_032655.1,4201310,4091294,4091296,g,gaa,2
NC_037333.1,NC_032655.1,4207558,4097547,4097548,c,ca,1
NC_037333.1,NC_032655.1,4228280,4118409,4118410,T,TW,1
NC_037333.1,NC_032655.1,4239668,4129800,4129801,t,tg,1
NC_037333.1,NC_032655.1,4268754,4158889,4158890,T,TA,1
NC_037333.1,NC_032655.1,4289381,4179525,4179526,c,ct,1
NC_037333.1,NC_032655.1,4362569,4250447,4250448,g,gt,1
NC_037333.1,NC_032655.1,4363322,4251201,4251202,c,ct,1
NC_037333.1,NC_032655.1,4452859,4461950,4461951,T,TY,1
NC_037333.1,NC_032655.1,4525183,4534624,4534625,a,at,1
NC_037333.1,NC_032655.1,4539220,4548614,4548615,T,TK,1
NC_037333.1,NC_032655.1,4566524,4576252,4576254,c,ccg,2
NC_037333.1,NC_032655.1,4626281,4636417,4636418,C,CS,1
NC_037333.1,NC_032655.1,4660973,4672551,4672552,T,TA,1
NC_037333.1,NC_032655.1,4662112,4673691,4673692,T,TG,1
NC_037333.1,NC_032655.1,4663434,4675014,4675110,T,TACTGTTGTATTCCTTCTGYACTGAGTTTATCAGCCCAAGATATCTANNNNNNNNNNNNNNNNNNNNNNNNNNNNNNNNNNNNNNNNNNNNNNNNNC,96
NC_037333.1,NC_032655.1,4701474,4713159,4713175,A,AGTTCTGCTGCGGCAGC,16
NC_037333.1,NC_032655.1,4783031,4794784,4794805,G,GGATATTAAGTTGTATCCTTTC,21
NC_037333.1,NC_032655.1,4786648,4798422,4798423,c,ca,1
NC_037333.1,NC_032655.1,4791544,4803318,4803319,A,AG,1
NC_037333.1,NC_032655.1,4813807,4827675,4827684,a,acactgtttc,9
NC_037333.1,NC_032655.1,4826032,4839983,4839989,a,aNNNNNN,6
NC_037333.1,NC_032655.1,4874753,5002295,5002296,g,ga,1
NC_037333.1,NC_032655.1,4875093,5002636,5002638,A,AGG,2
NC_037333.1,NC_032655.1,4888000,5015543,5015544,a,at,1
NC_037333.1,NC_032655.1,4899629,4898489,4898490,g,ga,1
NC_037333.1,NC_032655.1,4969989,4966309,4966311,C,CTA,2
NC_037333.1,NC_032655.1,5130805,5149582,5149583,a,ag,1
NC_037333.1,NC_032655.1,5137529,5156305,5156306,t,ta,1
NC_037333.1,NC_032655.1,5139442,5158219,5158220,T,TA,1
NC_037333.1,NC_032655.1,5160600,5179380,5179381,G,GR,1
NC_037333.1,NC_032655.1,5182488,5201528,5201529,A,AC,1
NC_037333.1,NC_032655.1,5184344,5203385,5203386,a,at,1
NC_037333.1,NC_032655.1,5210950,5230000,5230003,c,cttt,3
NC_037333.1,NC_032655.1,5219225,5238273,5238274,g,gT,1
NC_037333.1,NC_032655.1,5433563,5462276,5462277,T,TA,1
NC_037333.1,NC_032655.1,5434223,5462983,5462984,G,GA,1
NC_037333.1,NC_032655.1,5435782,5464567,5464570,g,ggat,3
NC_037333.1,NC_032655.1,5440110,5468410,5468411,T,TA,1
NC_037333.1,NC_032655.1,5441560,5469883,5469891,a,agttcagtc,8
NC_037333.1,NC_032655.1,5442123,5470454,5470456,g,gcc,2
NC_037333.1,NC_032655.1,5442142,5470475,5470483,g,gtcacgttt,8
NC_037333.1,NC_032655.1,5444768,5473105,5473110,A,AGACTG,5
NC_037333.1,NC_032655.1,5455764,5777260,5777262,g,gtt,2
NC_037333.1,NC_032655.1,5692472,6105236,6105237,t,tc,1
NC_037333.1,NC_032655.1,5692961,6105725,6105734,C,CTTAGGGCAA,9
NC_037333.1,NC_032655.1,5693814,6106587,6106595,a,aaccctctt,8
NC_037333.1,NC_032655.1,5733254,6146133,6146136,C,CAGA,3
NC_037333.1,NC_032655.1,5783709,6196596,6196597,T,TA,1
NC_037333.1,NC_032655.1,5786023,6198906,6198910,C,CGAGY,4
NC_037333.1,NC_032655.1,5787573,6200445,6200447,a,aag,2
NC_037333.1,NC_032655.1,5787850,6200724,6200725,a,at,1
NC_037333.1,NC_032655.1,5788652,6201539,6201540,C,CT,1
NC_037333.1,NC_032655.1,5789456,6202330,6202336,t,tttgttg,6
NC_037333.1,NC_032655.1,5789763,6202644,6202648,C,CTGGA,4
NC_037333.1,NC_032655.1,5791431,6204312,6204314,g,gtt,2
NC_037333.1,NC_032655.1,5793161,6206044,6206045,g,gc,1
NC_037333.1,NC_032655.1,5793662,6206545,6206546,c,ct,1
NC_037333.1,NC_032655.1,5794886,6207769,6207772,t,taaa,3
NC_037333.1,NC_032655.1,5799055,6212017,6212018,a,at,1
NC_037333.1,NC_032655.1,5799055,6666913,6666914,a,at,1
NC_037333.1,NC_032655.1,5799412,6667271,6667273,C,CTT,2
NC_037333.1,NC_032655.1,5812851,6225813,6225817,g,gagat,4
NC_037333.1,NC_032655.1,5812851,6680708,6680712,g,gagat,4
NC_037333.1,NC_032655.1,5815350,6683211,6683212,G,GA,1
NC_037333.1,NC_032655.1,5824203,6692059,6692066,a,ataacTAT,7
NC_037333.1,NC_032655.1,5824203,6266944,6266951,a,ataacTAT,7
NC_037333.1,NC_032655.1,5832916,6276656,6276657,T,TA,1
NC_037333.1,NC_032655.1,5832916,6700615,6700616,T,TA,1
NC_037333.1,NC_032655.1,5837368,6705254,6705255,G,GN,1
NC_037333.1,NC_032655.1,5839746,6283489,6283491,T,TTC,2
NC_037333.1,NC_032655.1,5839746,6707632,6707634,T,TTC,2
NC_037333.1,NC_032655.1,5849972,6717861,6717881,A,AACATGGGTTCCTCATGTGTT,20
NC_037333.1,NC_032655.1,5872569,6315570,6315571,A,AC,1
NC_037333.1,NC_032655.1,5872569,6740498,6740499,A,AC,1
NC_037333.1,NC_032655.1,5878925,6746917,6746918,c,ct,1
NC_037333.1,NC_032655.1,5885556,6327523,6327527,a,aaaac,4
NC_037333.1,NC_032655.1,5885670,6327641,6327651,A,AGGAAACTACC,10
NC_037333.1,NC_032655.1,5895654,6337643,6337645,a,aNN,2
NC_037333.1,NC_032655.1,5895808,6337799,6337804,a,actttt,5
NC_037333.1,NC_032655.1,5898070,6340064,6340065,a,ag,1
NC_037333.1,NC_032655.1,5898124,6340119,6340120,c,ct,1
NC_037333.1,NC_032655.1,5898151,6340147,6340148,c,ct,1
NC_037333.1,NC_032655.1,6016299,6848970,6848972,A,AAT,2
NC_037333.1,NC_032655.1,6025075,6857769,6857777,c,ctcagtcgt,8
NC_037333.1,NC_032655.1,6031514,6863562,6863564,C,CAG,2
NC_037333.1,NC_032655.1,6044540,6876213,6876214,C,CG,1
NC_037333.1,NC_032655.1,6052354,6884030,6884032,T,TAA,2
NC_037333.1,NC_032655.1,6055342,6887021,6887023,a,aaC,2
NC_037333.1,NC_032655.1,6060726,6892401,6892402,t,tg,1
NC_037333.1,NC_032655.1,6173351,7033103,7033106,A,AATC,3
NC_037333.1,NC_032655.1,6209758,7069385,7069386,A,AC,1
NC_037333.1,NC_032655.1,6316408,7175874,7175875,t,ta,1
NC_037333.1,NC_032655.1,6319887,7179357,7179358,T,TK,1
NC_037333.1,NC_032655.1,6364070,7233582,7233595,t,ttattgactatgcc,13
NC_037333.1,NC_032655.1,6390498,7260421,7260422,C,CR,1
NC_037333.1,NC_032655.1,6436657,7308187,7308188,T,TY,1
NC_037333.1,NC_032655.1,6464130,7335698,7335699,c,ca,1
NC_037333.1,NC_032655.1,6510185,7381372,7381373,G,GT,1
NC_037333.1,NC_032655.1,6519838,7391026,7391027,G,GA,1
NC_037333.1,NC_032655.1,6526966,7398165,7398166,A,AR,1
NC_037333.1,NC_032655.1,6553755,7424961,7424962,a,ac,1
NC_037333.1,NC_032655.1,6571654,7442862,7442863,t,tc,1
NC_037333.1,NC_032655.1,6592772,7463940,7463941,C,CG,1
NC_037333.1,NC_032655.1,6596661,7467829,7467830,A,AC,1
NC_037333.1,NC_032655.1,6633475,7504711,7504722,t,ttcactctccac,11
NC_037333.1,NC_032655.1,6633801,7505048,7505049,c,ca,1
NC_037333.1,NC_032655.1,6633821,7505069,7505073,c,cagtt,4
NC_037333.1,NC_032655.1,6794276,7727848,7727849,T,TK,1
NC_037333.1,NC_032655.1,6836970,7770349,7770350,A,AC,1
NC_037333.1,NC_032655.1,6866033,7804716,7804720,a,agctg,4
NC_037333.1,NC_032655.1,6866035,7804722,7804724,a,agg,2
NC_037333.1,NC_032655.1,6906165,7846541,7846542,g,gt,1
NC_037333.1,NC_032655.1,6935905,7875797,7875798,a,at,1
NC_037333.1,NC_032655.1,7018109,7956381,7956382,a,at,1
NC_037333.1,NC_032655.1,7048023,7986303,7986307,A,AGATT,4
NC_037333.1,NC_032655.1,7077003,8015294,8015295,A,AT,1
NC_037333.1,NC_032655.1,7153768,8090977,8090978,T,TC,1
NC_037333.1,NC_032655.1,7199685,8136913,8136939,T,TCTTTAAAGATAAGACTGACTCCAGAC,26
NC_037333.1,NC_032655.1,7218849,8156160,8156161,c,ct,1
NC_037333.1,NC_032655.1,7231104,8168417,8168418,c,ca,1
NC_037333.1,NC_032655.1,7240568,8177881,8177893,a,aaaagagggagag,12
NC_037333.1,NC_032655.1,7275204,8212501,8212502,A,AC,1
NC_037333.1,NC_032655.1,7301173,8238470,8238472,a,aNN,2
NC_037333.1,NC_032655.1,7361876,8299654,8299655,A,AG,1
NC_037333.1,NC_032655.1,7426822,8364626,8364627,T,TA,1
NC_037333.1,NC_032655.1,7470851,8408691,8408708,A,ACAAANNNNNNNNNNNNN,17
NC_037333.1,NC_032655.1,7480924,8418779,8418780,a,at,1
NC_037333.1,NC_032655.1,7494279,8432132,8432133,G,GC,1
NC_037333.1,NC_032655.1,7498641,8436498,8436499,c,ca,1
NC_037333.1,NC_032655.1,7499672,8437530,8437531,c,ca,1
NC_037333.1,NC_032655.1,7501277,8439135,8439136,a,ag,1
NC_037333.1,NC_032655.1,7502048,8439907,8439908,g,ga,1
NC_037333.1,NC_032655.1,7507654,8445514,8445524,G,GAACAGATAAA,10
NC_037333.1,NC_032655.1,7511096,8448963,8448966,A,AMTC,3
NC_037333.1,NC_032655.1,7525784,8463079,8463082,t,tgaa,3
NC_037333.1,NC_032655.1,7526489,8463786,8463791,a,actgat,5
NC_037333.1,NC_032655.1,7530682,8467974,8467976,g,ggt,2
NC_037333.1,NC_032655.1,7534141,8471435,8471437,G,GGA,2
NC_037333.1,NC_032655.1,7582868,8521467,8521469,a,aNN,2
NC_037333.1,NC_032655.1,7592271,8530872,8530873,t,ta,1
NC_037333.1,NC_032655.1,7608179,8546781,8546784,g,gttc,3
NC_037333.1,NC_032655.1,7673198,8611802,8611803,a,ag,1
NC_037333.1,NC_032655.1,7673291,8611896,8611899,a,aaat,3
NC_037333.1,NC_032655.1,7706317,8644919,8644920,G,GA,1
NC_037333.1,NC_032655.1,7709411,8648014,8648022,a,atatatatg,8
NC_037333.1,NC_032655.1,7709454,8648065,8648071,a,atatatg,6
NC_037333.1,NC_032655.1,7709947,8648561,8648566,g,gttttt,5
NC_037333.1,NC_032655.1,7710097,8648716,8648717,G,GT,1
NC_037333.1,NC_032655.1,7711239,8649859,8649865,t,tagcagc,6
NC_037333.1,NC_032655.1,7712537,8651163,8651164,T,TA,1
NC_037333.1,NC_032655.1,7712594,8651221,8651222,T,TC,1
NC_037333.1,NC_032655.1,7745334,8670554,8670555,T,TC,1
NC_037333.1,NC_032655.1,7745337,8670558,8670559,A,AT,1
NC_037333.1,NC_032655.1,7759510,8684726,8684727,C,CM,1
NC_037333.1,NC_032655.1,7862595,8789277,8789284,G,GTGAGAGK,7
NC_037333.1,NC_032655.1,7888641,8815316,8815318,g,ggt,2
NC_037333.1,NC_032655.1,7889768,8816449,8816450,A,AM,1
NC_037333.1,NC_032655.1,7900352,8827035,8827036,g,ga,1
NC_037333.1,NC_032655.1,7929769,8856450,8856451,a,at,1
NC_037333.1,NC_032655.1,8036103,8914491,8914492,a,ac,1
NC_037333.1,NC_032655.1,8051680,8930071,8930082,g,gccaccagaaaa,11
NC_037333.1,NC_032655.1,8148921,9038137,9038143,t,ttttttg,6
NC_037333.1,NC_032655.1,8176861,9066106,9066107,c,ct,1
NC_037333.1,NC_032655.1,8269939,9159204,9159206,a,att,2
NC_037333.1,NC_032655.1,8341814,9231012,9231013,t,ta,1
NC_037333.1,NC_032655.1,8365030,9254232,9254276,t,tgcaCTANNNNNNNNNNNNNNNNNNNNNNNNNNNNNNNNNNNNNN,44
NC_037333.1,NC_032655.1,8404028,9293186,9293189,a,aNNN,3
NC_037333.1,NC_032655.1,8405462,9294623,9294624,a,at,1
NC_037333.1,NC_032655.1,8612033,9494783,9494784,t,ta,1
NC_037333.1,NC_032655.1,8612805,9495556,9495558,g,gct,2
NC_037333.1,NC_032655.1,8643659,9526443,9526444,A,AG,1
NC_037333.1,NC_032655.1,8674006,9560105,9560106,a,ac,1
NC_037333.1,NC_032655.1,8677220,9563320,9563321,c,ca,1
NC_037333.1,NC_032655.1,8712719,9599524,9599525,c,ca,1
NC_037333.1,NC_032655.1,8740735,9627540,9627541,t,tA,1
NC_037333.1,NC_032655.1,8766294,9653705,9653706,t,tK,1
NC_037333.1,NC_032655.1,8797699,9685197,9685199,c,ctg,2
NC_037333.1,NC_032655.1,8818415,9705918,9705919,c,ca,1
NC_037333.1,NC_032655.1,8818449,9705953,9705954,a,at,1
NC_037333.1,NC_032655.1,8818508,9706014,9706015,g,ga,1
NC_037333.1,NC_032655.1,8879877,9767264,9767265,a,at,1
NC_037333.1,NC_032655.1,8890944,9778332,9778333,T,TA,1
NC_037333.1,NC_032655.1,8905946,9793336,9793340,a,aaaNN,4
NC_037333.1,NC_032655.1,8912188,9799581,9799583,c,ctg,2
NC_037333.1,NC_032655.1,8919517,9806669,9806670,A,AW,1
NC_037333.1,NC_032655.1,8925305,9812462,9812463,T,TG,1
NC_037333.1,NC_032655.1,8928362,9815520,9815523,g,gttc,3
NC_037333.1,NC_032655.1,8937292,9822552,9822553,a,ag,1
NC_037333.1,NC_032655.1,8944721,9829984,9829985,T,TC,1
NC_037333.1,NC_032655.1,8952458,9837723,9837724,C,CG,1
NC_037333.1,NC_032655.1,8955918,9841184,9841185,g,ga,1
NC_037333.1,NC_032655.1,8972072,9857381,9857392,T,TAGAYYGACAGA,11
NC_037333.1,NC_032655.1,8980955,9866566,9866567,T,TA,1
NC_037333.1,NC_032655.1,8994055,9879710,9879711,A,AG,1
NC_037333.1,NC_032655.1,8997822,9883487,9883488,A,AT,1
NC_037333.1,NC_032655.1,8997838,9883504,9883506,A,AGT,2
NC_037333.1,NC_032655.1,8997917,9883585,9883586,T,TC,1
NC_037333.1,NC_032655.1,8998007,9883675,9883676,A,AT,1
NC_037333.1,NC_032655.1,8998213,9883878,9883879,G,GT,1
NC_037333.1,NC_032655.1,8998506,9884169,9884170,A,AG,1
NC_037333.1,NC_032655.1,8998818,9884481,9884482,A,AT,1
NC_037333.1,NC_032655.1,8998928,9884592,9884593,C,CT,1
NC_037333.1,NC_032655.1,8998940,9884605,9884606,G,GT,1
NC_037333.1,NC_032655.1,8999016,9884681,9884683,c,ctg,2
NC_037333.1,NC_032655.1,9055591,9907282,9907284,t,tgc,2
NC_037333.1,NC_032655.1,9056278,9907971,9907979,G,GCATCATCa,8
NC_037333.1,NC_032655.1,9068376,9920004,9920005,c,ca,1
NC_037333.1,NC_032655.1,9068403,9920032,9920038,t,tNNNNNN,6
NC_037333.1,NC_032655.1,9071756,9923398,9923399,G,GT,1
NC_037333.1,NC_032655.1,9091184,9991317,9991318,T,TA,1
NC_037333.1,NC_032655.1,9097790,9997916,9997917,G,GR,1
NC_037333.1,NC_032655.1,9101800,10001928,10001929,C,CT,1
NC_037333.1,NC_032655.1,9105406,10005535,10005538,a,aagt,3
NC_037333.1,NC_032655.1,9111791,10018072,10018074,c,ctt,2
NC_037333.1,NC_032655.1,9122215,10027903,10027904,A,AM,1
NC_037333.1,NC_032655.1,9141322,10047007,10047008,A,AC,1
NC_037333.1,NC_032655.1,9194817,10253677,10253678,C,CY,1
NC_037333.1,NC_032655.1,9197696,10256553,10256554,T,TW,1
NC_037333.1,NC_032655.1,9227499,10286083,10286084,t,ta,1
NC_037333.1,NC_032655.1,9232814,10291399,10291400,G,GR,1
NC_037333.1,NC_032655.1,9261785,10304321,10304322,g,ga,1
NC_037333.1,NC_032655.1,9280228,10322884,10322885,t,tg,1
NC_037333.1,NC_032655.1,9291105,10333763,10333768,c,cagcag,5
NC_037333.1,NC_032655.1,9338055,10388557,10388560,t,tata,3
NC_037333.1,NC_032655.1,9357961,10408270,10408271,c,ct,1
NC_037333.1,NC_032655.1,9365944,10416254,10416255,t,tc,1
NC_037333.1,NC_032655.1,9402597,10452692,10452693,g,ga,1
NC_037333.1,NC_032655.1,9405580,10455677,10455678,t,ta,1
NC_037333.1,NC_032655.1,9405826,10455923,10455925,a,aat,2
NC_037333.1,NC_032655.1,9408025,10458120,10458125,a,aggcag,5
NC_037333.1,NC_032655.1,9411393,10461376,10461394,t,tatatatatattatatata,18
NC_037333.1,NC_032655.1,9413404,10463457,10463459,a,act,2
NC_037333.1,NC_032655.1,9413613,10463668,10463669,T,TA,1
NC_037333.1,NC_032655.1,9414532,10464591,10464592,a,at,1
NC_037333.1,NC_032655.1,9427168,10477236,10477237,A,AW,1
NC_037333.1,NC_032655.1,9437123,10487196,10487197,A,AR,1
NC_037333.1,NC_032655.1,9437652,10487726,10487727,c,ca,1
NC_037333.1,NC_032655.1,9497714,10521423,10521424,A,AC,1
NC_037333.1,NC_032655.1,9503003,10526710,10526711,T,TG,1
NC_037333.1,NC_032655.1,9519287,10542992,10542993,a,ag,1
NC_037333.1,NC_032655.1,9649243,10695001,10695004,g,gacc,3
NC_037333.1,NC_032655.1,9667693,10713453,10713455,a,aNN,2
NC_037333.1,NC_032655.1,9682278,10727981,10727982,G,GR,1
NC_037333.1,NC_032655.1,9685567,10731323,10731324,g,gt,1
NC_037333.1,NC_032655.1,9691024,10736819,10736827,a,aaaaaaaac,8
NC_037333.1,NC_032655.1,9700313,10746128,10746129,A,AW,1
NC_037333.1,NC_032655.1,9705540,10751368,10751369,g,ga,1
NC_037333.1,NC_032655.1,9717197,10762963,10762964,t,tc,1
NC_037333.1,NC_032655.1,9736556,10782354,10782356,g,gga,2
NC_037333.1,NC_032655.1,9738293,10784093,10784094,a,ac,1
NC_037333.1,NC_032655.1,9739035,10784835,10784843,a,acgatggtg,8
NC_037333.1,NC_032655.1,9748579,10794388,10794397,g,gactgtttcc,9
NC_037333.1,NC_032655.1,9748599,10794417,10794418,g,gc,1
NC_037333.1,NC_032655.1,9752746,10798587,10798589,A,AAT,2
NC_037333.1,NC_032655.1,9758870,10804728,10804730,T,TTG,2
NC_037333.1,NC_032655.1,9825883,10892173,10892174,c,ct,1
NC_037333.1,NC_032655.1,9827482,10893773,10893774,A,AW,1
NC_037333.1,NC_032655.1,9827587,10893880,10893881,C,CT,1
NC_037333.1,NC_032655.1,9831641,10897936,10897949,t,tcttcttcttcttY,13
NC_037333.1,NC_032655.1,9853894,10924148,10924150,g,gtc,2
NC_037333.1,NC_032655.1,9854310,10924566,10924570,a,attag,4
NC_037333.1,NC_032655.1,9857743,10928005,10928006,T,TW,1
NC_037333.1,NC_032655.1,9889047,10959337,10959338,t,tc,1
NC_037333.1,NC_032655.1,9890495,10960786,10960788,t,ttc,2
NC_037333.1,NC_032655.1,9896518,10966816,10966817,A,AW,1
NC_037333.1,NC_032655.1,9906180,10976483,10976484,C,CT,1
NC_037333.1,NC_032655.1,9929603,10996348,10996351,A,AAGC,3
NC_037333.1,NC_032655.1,9945711,11012460,11012461,C,CA,1
NC_037333.1,NC_032655.1,10016039,11082855,11082856,a,ac,1
NC_037333.1,NC_032655.1,10018328,11085142,11085143,g,gc,1
NC_037333.1,NC_032655.1,10024779,11091586,11091587,t,ta,1
NC_037333.1,NC_032655.1,10026409,11093218,11093219,T,TA,1
NC_037333.1,NC_032655.1,10063610,11130338,11130340,c,cat,2
NC_037333.1,NC_032655.1,10083778,11150513,11150515,t,tca,2
NC_037333.1,NC_032655.1,10150141,11222577,11222578,G,GS,1
NC_037333.1,NC_032655.1,10219852,11292190,11292194,T,TTGAC,4
NC_037333.1,NC_032655.1,10223519,11295861,11295862,A,AC,1
NC_037333.1,NC_032655.1,10388219,11454506,11454507,c,ca,1
NC_037333.1,NC_032655.1,10392112,11458402,11458404,C,CTA,2
NC_037333.1,NC_032655.1,10406742,11473035,11473036,a,at,1
NC_037333.1,NC_032655.1,10409120,11475417,11475418,A,AC,1
NC_037333.1,NC_032655.1,10409516,11475814,11475816,g,gaa,2
NC_037333.1,NC_032655.1,10424267,11490572,11490573,c,ct,1
NC_037333.1,NC_032655.1,10428839,11495145,11495146,C,CA,1
NC_037333.1,NC_032655.1,10431874,11498181,11498182,A,AG,1
NC_037333.1,NC_032655.1,10512166,11578391,11578393,T,TNN,2
NC_037333.1,NC_032655.1,10563220,11629522,11629532,a,aNNNNNNNNNN,10
NC_037333.1,NC_032655.1,10699190,11764811,11764816,t,taaaaa,5
NC_037333.1,NC_032655.1,10747685,11813312,11813333,T,TGAAAAATNNNNNNNNNNNNNN,21
NC_037333.1,NC_032655.1,10793270,11858940,11858941,a,at,1
NC_037333.1,NC_032655.1,10841702,11907320,11907328,a,aNNNNNNNN,8
NC_037333.1,NC_032655.1,10894252,11959783,11959786,T,TTAG,3
NC_037333.1,NC_032655.1,10938998,12013475,12013476,a,at,1
NC_037333.1,NC_032655.1,10972382,12046860,12046861,g,ga,1
NC_037333.1,NC_032655.1,10980260,12056761,12056762,c,ct,1
NC_037333.1,NC_032655.1,11013499,12090003,12090004,t,tg,1
NC_037333.1,NC_032655.1,11033553,12110069,12110072,T,TCTG,3
NC_037333.1,NC_032655.1,11042477,12118980,12118981,A,AT,1
NC_037333.1,NC_032655.1,11043964,12120467,12120471,T,TGAAA,4
NC_037333.1,NC_032655.1,11054697,12128765,12128766,g,gT,1
NC_037333.1,NC_032655.1,11061814,12135881,12135882,C,CY,1
NC_037333.1,NC_032655.1,11064998,12139066,12139070,T,TGACA,4
NC_037333.1,NC_032655.1,11098935,12173963,12173964,A,AT,1
NC_037333.1,NC_032655.1,11099631,12174660,12174662,t,taa,2
NC_037333.1,NC_032655.1,11101066,12176092,12176094,C,CCT,2
NC_037333.1,NC_032655.1,11107688,12182714,12182715,g,ga,1
NC_037333.1,NC_032655.1,11107717,12182744,12182749,A,AAACTT,5
NC_037333.1,NC_032655.1,11113773,12188858,12188878,t,tcctcctccaatgcatgaaag,20
NC_037333.1,NC_032655.1,11129664,12204776,12204777,a,ag,1
NC_037333.1,NC_032655.1,11132359,12207471,12207472,G,GR,1
NC_037333.1,NC_032655.1,11156484,12231934,12231936,c,cca,2
NC_037333.1,NC_032655.1,11167795,12245558,12245563,a,aatcag,5
NC_037333.1,NC_032655.1,11226751,12304532,12304533,g,gt,1
NC_037333.1,NC_032655.1,11229684,12307466,12307468,a,aNN,2
NC_037333.1,NC_032655.1,11230944,12308726,12308753,t,tggcgtaaagctcaacattcagaaaacg,27
NC_037333.1,NC_032655.1,11254971,12332782,12332788,T,TACGCTC,6
NC_037333.1,NC_032655.1,11288876,12366692,12366694,T,TGG,2
NC_037333.1,NC_032655.1,11312440,12390257,12390259,c,ctg,2
NC_037333.1,NC_032655.1,11326473,12404306,12404307,a,ag,1
NC_037333.1,NC_032655.1,11368960,12448571,12448572,T,TG,1
NC_037333.1,NC_032655.1,11374121,12453717,12453718,a,ac,1
NC_037333.1,NC_032655.1,11374319,12453913,12453914,g,gt,1
NC_037333.1,NC_032655.1,11404442,12484037,12484038,T,TG,1
NC_037333.1,NC_032655.1,11405535,12485130,12485131,C,CG,1
NC_037333.1,NC_032655.1,11411990,12491575,12491576,c,ct,1
NC_037333.1,NC_032655.1,11414309,12493896,12493916,t,tgcagtccaagggactcccaa,20
NC_037333.1,NC_032655.1,11414602,12494209,12494227,t,tcccatgaaagtgatggga,18
NC_037333.1,NC_032655.1,11415669,12495294,12495296,t,tac,2
NC_037333.1,NC_032655.1,11421931,12501548,12501549,c,cg,1
NC_037333.1,NC_032655.1,11433680,12513362,12513363,t,tc,1
NC_037333.1,NC_032655.1,11451126,12530560,12530564,A,ATARR,4
NC_037333.1,NC_032655.1,11454715,12534154,12534159,A,AAAACT,5
NC_037333.1,NC_032655.1,11464952,12544401,12544402,C,CT,1
NC_037333.1,NC_032655.1,11465275,12544724,12544725,T,TA,1
NC_037333.1,NC_032655.1,11471141,12550587,12550592,t,ttttta,5
NC_037333.1,NC_032655.1,11482234,12561621,12561665,t,tttttttttcttttatttttcttttattttcttttattccttttc,44
NC_037333.1,NC_032655.1,11491258,12570681,12570685,g,ggaaa,4
NC_037333.1,NC_032655.1,11578532,12657971,12657972,A,AR,1
NC_037333.1,NC_032655.1,11583466,12662906,12662907,C,CT,1
NC_037333.1,NC_032655.1,11667818,12766937,12766938,t,tW,1
NC_037333.1,NC_032655.1,11670094,12769216,12769217,a,ag,1
NC_037333.1,NC_032655.1,11673340,12772379,12772381,g,gga,2
NC_037333.1,NC_032655.1,11677588,12776425,12776426,T,TW,1
NC_037333.1,NC_032655.1,11736431,12835614,12835615,t,ta,1
NC_037333.1,NC_032655.1,11753030,12852215,12852219,t,tNNNN,4
NC_037333.1,NC_032655.1,11768249,12867439,12867440,a,ag,1
NC_037333.1,NC_032655.1,11790102,12889202,12889203,g,ga,1
NC_037333.1,NC_032655.1,11790154,12889255,12889257,g,gga,2
NC_037333.1,NC_032655.1,11886923,12983142,12983143,A,AG,1
NC_037333.1,NC_032655.1,11910138,13006360,13006361,T,TC,1
NC_037333.1,NC_032655.1,11912045,13008269,13008271,T,TTG,2
NC_037333.1,NC_032655.1,11916644,13012875,13012876,T,TG,1
NC_037333.1,NC_032655.1,11917242,13013474,13013475,G,GS,1
NC_037333.1,NC_032655.1,11927336,13024464,13024465,A,AR,1
NC_037333.1,NC_032655.1,11938059,13035191,13035192,T,TY,1
NC_037333.1,NC_032655.1,11947342,13044473,13044474,g,gc,1
NC_037333.1,NC_032655.1,11955763,13052902,13052903,C,CM,1
NC_037333.1,NC_032655.1,11976434,13073873,13073876,T,TAGA,3
NC_037333.1,NC_032655.1,11986235,13083681,13083683,T,TTC,2
NC_037333.1,NC_032655.1,11995040,13092497,13092498,A,AG,1
NC_037333.1,NC_032655.1,11995923,13093381,13093383,C,CTG,2
NC_037333.1,NC_032655.1,12000664,13098122,13098124,c,cag,2
NC_037333.1,NC_032655.1,12004078,13101542,13101548,a,aaaaaat,6
NC_037333.1,NC_032655.1,12004390,13101860,13101861,A,AC,1
NC_037333.1,NC_032655.1,12093010,13210153,13210155,C,CAG,2
NC_037333.1,NC_032655.1,12096559,13213702,13213704,a,aag,2
NC_037333.1,NC_032655.1,12096633,13213778,13213780,c,ctg,2
NC_037333.1,NC_032655.1,12097295,13214442,13214443,c,ct,1
NC_037333.1,NC_032655.1,12098282,13215424,13215425,c,ct,1
NC_037333.1,NC_032655.1,12163511,13282071,13282076,t,tgctgc,5
NC_037333.1,NC_032655.1,12293534,13413003,13413006,T,TTTA,3
NC_037333.1,NC_032655.1,12307863,13427354,13427355,g,gc,1
NC_037333.1,NC_032655.1,12340071,13459494,13459500,A,ATTAGTC,6
NC_037333.1,NC_032655.1,12369842,13490019,13490023,c,ctaga,4
NC_037333.1,NC_032655.1,12459341,13583142,13583144,G,GAC,2
NC_037333.1,NC_032655.1,12513659,13641036,13641038,A,AAT,2
NC_037333.1,NC_032655.1,12546792,13674167,13674172,a,agaatc,5
NC_037333.1,NC_032655.1,12643715,13769116,13769118,G,GCA,2
NC_037333.1,NC_032655.1,12645099,13770492,13770494,a,acc,2
NC_037333.1,NC_032655.1,12645556,13770948,13770951,c,caga,3
NC_037333.1,NC_032655.1,12646014,13771391,13771407,a,attgaaaaggcaagagt,16
NC_037333.1,NC_032655.1,12646516,13771908,13771909,a,at,1
NC_037333.1,NC_032655.1,12661518,13786900,13786911,g,gctggatggcat,11
NC_037333.1,NC_032655.1,12672718,13798153,13798154,A,AM,1
NC_037333.1,NC_032655.1,12686031,13811466,13811467,A,AT,1
NC_037333.1,NC_032655.1,12761037,13886533,13886534,a,at,1
NC_037333.1,NC_032655.1,12805131,14010151,14010152,a,ag,1
NC_037333.1,NC_032655.1,12869947,14074962,14074963,G,GC,1
NC_037333.1,NC_032655.1,12875705,14080728,14080729,A,AW,1
NC_037333.1,NC_032655.1,12880352,14085365,14085366,c,ct,1
NC_037333.1,NC_032655.1,12888179,13949834,13949838,t,tgaag,4
NC_037333.1,NC_032655.1,12890509,13952157,13952158,A,AR,1
NC_037333.1,NC_032655.1,12891309,13952958,13952961,C,CTAT,3
NC_037333.1,NC_032655.1,12891929,13953605,13953606,C,CA,1
NC_037333.1,NC_032655.1,12892064,13953741,13953742,G,GR,1
NC_037333.1,NC_032655.1,12908189,13969880,13969881,a,ag,1
NC_037333.1,NC_032655.1,12977547,14128765,14128766,A,AW,1
NC_037333.1,NC_032655.1,13019777,14170530,14170531,a,at,1
NC_037333.1,NC_032655.1,13061671,14212420,14212421,C,CY,1
NC_037333.1,NC_032655.1,13062435,14213184,14213195,C,CGGTTTACTGTG,11
NC_037333.1,NC_032655.1,13062517,14213277,14213278,g,gc,1
NC_037333.1,NC_032655.1,13139695,14295071,14295072,a,ag,1
NC_037333.1,NC_032655.1,13155541,14310919,14310920,a,ac,1
NC_037333.1,NC_032655.1,13155717,14311096,14311097,A,AC,1
NC_037333.1,NC_032655.1,13159524,14314904,14314905,G,GR,1
NC_037333.1,NC_032655.1,13169831,14325212,14325213,A,AG,1
NC_037333.1,NC_032655.1,13170472,14325854,14325856,C,CAT,2
NC_037333.1,NC_032655.1,13170623,14326007,14326008,A,AG,1
NC_037333.1,NC_032655.1,13212307,14367569,14367571,t,taa,2
NC_037333.1,NC_032655.1,13264565,14419831,14419833,A,AAT,2
NC_037333.1,NC_032655.1,13347388,14502604,14502605,A,AG,1
NC_037333.1,NC_032655.1,13384318,14539379,14539381,A,AAG,2
NC_037333.1,NC_032655.1,13453448,14658975,14658976,C,CA,1
NC_037333.1,NC_032655.1,13520721,14715689,14715694,c,ctccct,5
NC_037333.1,NC_032655.1,13575020,14982007,14982008,T,TW,1
NC_037333.1,NC_032655.1,13599022,14744472,14744473,a,ac,1
NC_037333.1,NC_032655.1,13599133,14744584,14744586,a,aac,2
NC_037333.1,NC_032655.1,13605638,14751091,14751092,A,AT,1
NC_037333.1,NC_032655.1,13737826,15140130,15140131,g,gt,1
NC_037333.1,NC_032655.1,13737850,15140155,15140156,c,ct,1
NC_037333.1,NC_032655.1,13881138,15303201,15303210,t,tatNNNNNNN,9
NC_037333.1,NC_032655.1,13917619,15339695,15339696,A,AT,1
NC_037333.1,NC_032655.1,13923535,15345612,15345613,G,GT,1
NC_037333.1,NC_032655.1,13976303,15398382,15398383,t,ta,1
NC_037333.1,NC_032655.1,13982546,15404627,15404628,a,ag,1
NC_037333.1,NC_032655.1,13986055,15408136,15408137,C,CY,1
NC_037333.1,NC_032655.1,14016342,15438423,15438424,c,ct,1
NC_037333.1,NC_032655.1,14016592,15438674,15438679,G,GGGGGK,5
NC_037333.1,NC_032655.1,14033062,15455148,15455150,A,AAG,2
NC_037333.1,NC_032655.1,14068591,15490511,15490512,T,TC,1
NC_037333.1,NC_032655.1,14130610,15553486,15553487,C,CA,1
NC_037333.1,NC_032655.1,14154868,15577746,15577747,g,ga,1
NC_037333.1,NC_032655.1,14165410,15588289,15588291,t,tac,2
NC_037333.1,NC_032655.1,14173476,15596356,15596357,a,at,1
NC_037333.1,NC_032655.1,14173755,15596635,15596636,C,CW,1
NC_037333.1,NC_032655.1,14175839,15598714,15598715,c,ct,1
NC_037333.1,NC_032655.1,14176369,15599242,15599243,c,ct,1
NC_037333.1,NC_032655.1,14176468,15599341,15599342,t,tg,1
NC_037333.1,NC_032655.1,14176643,15599517,15599518,a,at,1
NC_037333.1,NC_032655.1,14177035,15599909,15599910,g,ga,1
NC_037333.1,NC_032655.1,14177304,15600178,15600179,A,AG,1
NC_037333.1,NC_032655.1,14177941,15600812,15600813,A,AG,1
NC_037333.1,NC_032655.1,14177972,15600844,15600846,c,ctt,2
NC_037333.1,NC_032655.1,14178031,15600905,15600906,t,ta,1
NC_037333.1,NC_032655.1,14178038,15600913,15600914,t,tg,1
NC_037333.1,NC_032655.1,14178117,15600992,15600993,G,GA,1
NC_037333.1,NC_032655.1,14178484,15601353,15601354,T,TA,1
NC_037333.1,NC_032655.1,14178500,15601370,15601371,A,AC,1
NC_037333.1,NC_032655.1,14226719,15630174,15630177,c,cgaa,3
NC_037333.1,NC_032655.1,14226988,15630446,15630448,a,atg,2
NC_037333.1,NC_032655.1,14228376,15631836,15631848,g,gaagaaatcaaaa,12
NC_037333.1,NC_032655.1,14229785,15633259,15633261,t,tcc,2
NC_037333.1,NC_032655.1,14230256,15633732,15633733,t,ta,1
NC_037333.1,NC_032655.1,14231151,15634628,15634635,a,atgttcat,7
NC_037333.1,NC_032655.1,14231557,15635041,15635042,g,ga,1
NC_037333.1,NC_032655.1,14245327,15648813,15648814,a,at,1
NC_037333.1,NC_032655.1,14270656,15674164,15674165,t,tg,1
NC_037333.1,NC_032655.1,14270677,15674186,15674187,c,cg,1
NC_037333.1,NC_032655.1,14277990,15681540,15681541,A,AR,1
NC_037333.1,NC_032655.1,14280293,15683845,15683846,A,AT,1
NC_037333.1,NC_032655.1,14286516,15690068,15690069,t,tc,1
NC_037333.1,NC_032655.1,14286904,15690457,15690488,t,tgtatgcccagcaacgggattgctggatcata,31
NC_037333.1,NC_032655.1,14288214,15691798,15691799,a,at,1
NC_037333.1,NC_032655.1,14295113,15698708,15698709,c,ct,1
NC_037333.1,NC_032655.1,14312452,15716183,15716184,a,at,1
NC_037333.1,NC_032655.1,14318595,15722329,15722330,A,AT,1
NC_037333.1,NC_032655.1,14322448,15726194,15726195,C,CY,1
NC_037333.1,NC_032655.1,14322457,15726204,15726205,A,AC,1
NC_037333.1,NC_032655.1,14352200,15755952,15755955,a,agct,3
NC_037333.1,NC_032655.1,14361444,15765199,15765200,T,TY,1
NC_037333.1,NC_032655.1,14585110,15994118,15994119,T,TA,1
NC_037333.1,NC_032655.1,14654909,16064565,16064567,C,CCA,2
NC_037333.1,NC_032655.1,14719161,16128806,16128807,t,ta,1
NC_037333.1,NC_032655.1,15005887,16414764,16414768,C,CTCTT,4
NC_037333.1,NC_032655.1,15088841,16482857,16482858,c,ca,1
NC_037333.1,NC_032655.1,15122495,16517457,16517460,g,gtct,3
NC_037333.1,NC_032655.1,15320425,16723837,16723838,c,ca,1
NC_037333.1,NC_032655.1,15337669,16740959,16740960,a,at,1
NC_037333.1,NC_032655.1,15352520,16755811,16755812,C,CG,1
NC_037333.1,NC_032655.1,15369919,16773217,16773219,c,cgt,2
NC_037333.1,NC_032655.1,15388261,16791560,16791561,A,AG,1
NC_037333.1,NC_032655.1,15409630,16812933,16812936,t,tctc,3
NC_037333.1,NC_032655.1,15462306,16865747,16865748,g,gN,1
NC_037333.1,NC_032655.1,15501097,16904215,16904216,t,tW,1
NC_037333.1,NC_032655.1,15502657,16905776,16905777,A,AG,1
NC_037333.1,NC_032655.1,15506825,16909920,16909921,A,AG,1
NC_037333.1,NC_032655.1,15546146,16949695,16949698,T,TATG,3
NC_037333.1,NC_032655.1,15571861,16975412,16975413,C,CM,1
NC_037333.1,NC_032655.1,15589253,16992799,16992800,t,ta,1
NC_037333.1,NC_032655.1,15593147,16996696,16996698,g,gga,2
NC_037333.1,NC_032655.1,15593305,16996856,16996857,t,tg,1
NC_037333.1,NC_032655.1,15594589,16998141,16998142,c,cM,1
NC_037333.1,NC_032655.1,15603340,17006909,17006913,C,CTATT,4
NC_037333.1,NC_032655.1,15618177,17021744,17021749,a,aaaaac,5
NC_037333.1,NC_032655.1,15623849,17027420,17027421,c,ct,1
NC_037333.1,NC_032655.1,15628135,17031704,17031705,t,tK,1
NC_037333.1,NC_032655.1,15668099,17071669,17071671,t,tac,2
NC_037333.1,NC_032655.1,15709107,17115792,17115805,a,agagaagcctggtg,13
NC_037333.1,NC_032655.1,15714626,17121329,17121330,T,TW,1
NC_037333.1,NC_032655.1,15718319,17125020,17125023,G,GTTC,3
NC_037333.1,NC_032655.1,15725033,17131689,17131690,T,TC,1
NC_037333.1,NC_032655.1,15751997,17158675,17158676,t,tc,1
NC_037333.1,NC_032655.1,15752542,17159221,17159222,t,tc,1
NC_037333.1,NC_032655.1,15776668,17183001,17183002,A,AT,1
NC_037333.1,NC_032655.1,15903454,17309807,17309808,C,CY,1
NC_037333.1,NC_032655.1,15929802,17336801,17336802,c,cg,1
NC_037333.1,NC_032655.1,15946651,17353649,17353650,t,tN,1
NC_037333.1,NC_032655.1,15968582,17371071,17371072,A,AC,1
NC_037333.1,NC_032655.1,15968599,17371089,17371090,T,TA,1
NC_037333.1,NC_032655.1,15996236,17398734,17398735,T,TY,1
NC_037333.1,NC_032655.1,15998096,17400595,17400603,A,ACATCAGTM,8
NC_037333.1,NC_032655.1,16018319,17420829,17420830,A,AW,1
NC_037333.1,NC_032655.1,16033096,17435613,17435615,T,TTC,2
NC_037333.1,NC_032655.1,16035076,17438335,17438336,c,ct,1
NC_037333.1,NC_032655.1,16037837,17441094,17441095,t,tg,1
NC_037333.1,NC_032655.1,16167261,17570978,17570979,g,ga,1
NC_037333.1,NC_032655.1,16247968,17652190,17652191,t,ta,1
NC_037333.1,NC_032655.1,16298560,17702786,17702787,g,gt,1
NC_037333.1,NC_032655.1,16302310,17706538,17706539,t,tY,1
NC_037333.1,NC_032655.1,16307162,17711392,17711393,G,GA,1
NC_037333.1,NC_032655.1,16311379,17715612,17715613,C,CT,1
NC_037333.1,NC_032655.1,16315212,17719446,17719447,t,ta,1
NC_037333.1,NC_032655.1,16398424,17802455,17802456,a,aM,1
NC_037333.1,NC_032655.1,16424157,17828186,17828187,A,AG,1
NC_037333.1,NC_032655.1,16436539,17840569,17840570,G,GR,1
NC_037333.1,NC_032655.1,16449831,17853864,17853866,a,aag,2
NC_037333.1,NC_032655.1,16455371,17859408,17859409,C,CA,1
NC_037333.1,NC_032655.1,16457806,17861844,17861850,a,aNNNNNN,6
NC_037333.1,NC_032655.1,16483436,17887433,17887434,A,AT,1
NC_037333.1,NC_032655.1,16483663,17887661,17887663,G,GAC,2
NC_037333.1,NC_032655.1,16486833,17890834,17890835,g,gt,1
NC_037333.1,NC_032655.1,16549591,17965577,17965580,t,tttN,3
NC_037333.1,NC_032655.1,16593749,18009740,18009741,T,TA,1
NC_037333.1,NC_032655.1,16610562,18026462,18026463,a,ac,1
NC_037333.1,NC_032655.1,16730148,18145096,18145097,A,AC,1
NC_037333.1,NC_032655.1,16730169,18145118,18145119,C,CA,1
NC_037333.1,NC_032655.1,16730197,18145147,18145148,T,TC,1
NC_037333.1,NC_032655.1,16730251,18145201,18145202,g,gc,1
NC_037333.1,NC_032655.1,16873340,18287989,18287998,a,acatttcatg,9
NC_037333.1,NC_032655.1,16889023,18303680,18303683,A,AAAG,3
NC_037333.1,NC_032655.1,16958829,18366009,18366010,t,ta,1
NC_037333.1,NC_032655.1,16962579,18369760,18369761,G,GW,1
NC_037333.1,NC_032655.1,16964481,18371663,18371666,T,TTTC,3
NC_037333.1,NC_032655.1,16982851,18390038,18390039,a,ac,1
NC_037333.1,NC_032655.1,16994013,18401216,18401217,a,ac,1
NC_037333.1,NC_032655.1,17045246,18447304,18447305,C,CT,1
NC_037333.1,NC_032655.1,17052898,18454959,18454960,C,CA,1
NC_037333.1,NC_032655.1,17157792,18560006,18560009,C,CAAA,3
NC_037333.1,NC_032655.1,17158471,18560688,18560690,t,taa,2
NC_037333.1,NC_032655.1,17265235,18667658,18667659,G,GS,1
NC_037333.1,NC_032655.1,17280389,18682816,18682817,T,TG,1
NC_037333.1,NC_032655.1,17345401,18747832,18747836,A,ACTGT,4
NC_037333.1,NC_032655.1,17355989,18758426,18758427,g,ga,1
NC_037333.1,NC_032655.1,17356838,18759275,18759277,a,aac,2
NC_037333.1,NC_032655.1,17356843,18759282,18759283,c,ca,1
NC_037333.1,NC_032655.1,17362890,18765333,18765334,C,CR,1
NC_037333.1,NC_032655.1,17363592,18766038,18766039,C,CA,1
NC_037333.1,NC_032655.1,17395585,18798040,18798043,a,aaag,3
NC_037333.1,NC_032655.1,17421381,18823959,18823961,a,aNN,2
NC_037333.1,NC_032655.1,17475477,18879020,18879021,G,GT,1
NC_037333.1,NC_032655.1,17613592,19017472,19017476,g,gtgtt,4
NC_037333.1,NC_032655.1,17620037,19023920,19023922,t,tNN,2
NC_037333.1,NC_032655.1,17668970,19087251,19087252,g,gt,1
NC_037333.1,NC_032655.1,17687767,19106018,19106020,A,AAT,2
NC_037333.1,NC_032655.1,17700109,19118363,19118364,A,AW,1
NC_037333.1,NC_032655.1,17701214,19119471,19119474,g,ggtt,3
NC_037333.1,NC_032655.1,17707261,19125530,19125533,t,tctc,3
NC_037333.1,NC_032655.1,17710902,19128745,19128747,C,CAK,2
NC_037333.1,NC_032655.1,17753816,19191656,19191657,C,CA,1
NC_037333.1,NC_032655.1,17807218,19260307,19260318,a,ataaggcagttc,11
NC_037333.1,NC_032655.1,17852763,19304945,19304946,T,TC,1
NC_037333.1,NC_032655.1,17881423,19333107,19333108,g,ga,1
NC_037333.1,NC_032655.1,18181484,19647861,19647862,C,CT,1
NC_037333.1,NC_032655.1,18182690,19649068,19649069,t,ta,1
NC_037333.1,NC_032655.1,18202153,19668533,19668543,G,GAGAAAGATGC,10
NC_037333.1,NC_032655.1,18246183,19714612,19714613,G,GC,1
NC_037333.1,NC_032655.1,18247066,19715496,19715498,a,aat,2
NC_037333.1,NC_032655.1,18308706,19776970,19776971,g,ga,1
NC_037333.1,NC_032655.1,18367686,19839173,19839175,c,caa,2
NC_037333.1,NC_032655.1,18453380,19924607,19924608,G,GA,1
NC_037333.1,NC_032655.1,18992457,20501658,20501664,T,TCCTTCA,6
NC_037333.1,NC_032655.1,18995812,20505026,20505027,T,TY,1
NC_037333.1,NC_032655.1,19003122,20512323,20512324,G,GC,1
NC_037333.1,NC_032655.1,19005889,20515143,20515144,a,aR,1
NC_037333.1,NC_032655.1,19006331,20515586,20515587,g,gc,1
NC_037333.1,NC_032655.1,19008889,20518247,20518258,A,ACTGTCTGTCAT,11
NC_037333.1,NC_032655.1,19008893,20518262,20518263,T,TA,1
NC_037333.1,NC_032655.1,19037024,20550139,20550141,C,CAT,2
NC_037333.1,NC_032655.1,19043429,20556319,20556320,c,ct,1
NC_037333.1,NC_032655.1,19045930,20558821,20558838,c,cagaattttccacagttt,17
NC_037333.1,NC_032655.1,19083608,20596050,20596051,t,ta,1
NC_037333.1,NC_032655.1,19141398,20653785,20653790,T,TCACAG,5
NC_037333.1,NC_032655.1,19152755,20665146,20665147,t,tg,1
NC_037333.1,NC_032655.1,19278940,20791998,20792010,a,aNNNNNNNNNNNN,12
NC_037333.1,NC_032655.1,19299537,20811599,20811600,g,gc,1
NC_037333.1,NC_032655.1,19306499,20818551,20818579,g,gtgtgtgtgtgtgtgtatatatatatata,28
NC_037333.1,NC_032655.1,19449447,20908148,20908149,T,TY,1
NC_037333.1,NC_032655.1,19599133,21080828,21080829,T,TC,1
NC_037333.1,NC_032655.1,19610450,21092145,21092154,a,atgcagtttc,9
NC_037333.1,NC_032655.1,19661390,21143075,21143076,a,at,1
NC_037333.1,NC_032655.1,19678218,21159910,21159914,t,tgaga,4
NC_037333.1,NC_032655.1,19678221,21159917,21159925,c,cccttggga,8
NC_037333.1,NC_032655.1,19731358,21214404,21214405,c,ct,1
NC_037333.1,NC_032655.1,19814808,21298292,21298293,C,CA,1
NC_037333.1,NC_032655.1,19819856,21303466,21303467,T,TG,1
NC_037333.1,NC_032655.1,19825591,21309104,21309106,g,gaa,2
NC_037333.1,NC_032655.1,19834929,21318385,21318386,A,AT,1
NC_037333.1,NC_032655.1,19836087,21320020,21320021,a,ag,1
NC_037333.1,NC_032655.1,19883400,21368197,21368198,A,AT,1
NC_037333.1,NC_032655.1,19887252,21372051,21372052,t,tY,1
NC_037333.1,NC_032655.1,19889923,21374723,21374724,g,ga,1
NC_037333.1,NC_032655.1,20088796,21575008,21575023,a,aatatatattatatat,15
NC_037333.1,NC_032655.1,20308012,21800075,21800076,A,AT,1
NC_037333.1,NC_032655.1,20370373,21861351,21861352,t,ta,1
NC_037333.1,NC_032655.1,20370383,21861362,21861363,t,ta,1
NC_037333.1,NC_032655.1,20370411,21861391,21861392,T,TG,1
NC_037333.1,NC_032655.1,20425636,21916425,21916426,g,gc,1
NC_037333.1,NC_032655.1,20452829,21943085,21943086,c,cg,1
NC_037333.1,NC_032655.1,20560563,22073798,22073799,G,GR,1
NC_037333.1,NC_032655.1,20599101,22111817,22111818,a,at,1
NC_037333.1,NC_032655.1,20629153,22168481,22168483,g,gaa,2
NC_037333.1,NC_032655.1,20699613,22238489,22238490,C,CA,1
NC_037333.1,NC_032655.1,20702150,22241026,22241027,G,GC,1
NC_037333.1,NC_032655.1,20705114,22243994,22243995,G,GT,1
NC_037333.1,NC_032655.1,20762477,22301371,22301373,t,tta,2
NC_037333.1,NC_032655.1,20891557,22430593,22430594,c,ct,1
NC_037333.1,NC_032655.1,20914748,22455334,22455335,A,AG,1
NC_037333.1,NC_032655.1,20923068,22463660,22463661,A,AG,1
NC_037333.1,NC_032655.1,20979414,22520084,22520085,t,ta,1
NC_037333.1,NC_032655.1,21022905,22563580,22563585,G,GGTAAA,5
NC_037333.1,NC_032655.1,21054305,22594994,22595006,t,tNNNNNNNNNNNN,12
NC_037333.1,NC_032655.1,21062989,22603690,22603692,a,aag,2
NC_037333.1,NC_032655.1,21073226,22613923,22613926,A,ATCC,3
NC_037333.1,NC_032655.1,21259994,22811492,22811493,t,ta,1
NC_037333.1,NC_032655.1,21267339,22819067,22819077,a,aattTATTTCc,10
NC_037333.1,NC_032655.1,21276163,22829801,22829802,C,CG,1
NC_037333.1,NC_032655.1,21285900,22839542,22839551,a,acactgtttc,9
NC_037333.1,NC_032655.1,21286747,22840397,22840398,T,TY,1
NC_037333.1,NC_032655.1,21318784,22872457,22872458,g,ga,1
NC_037333.1,NC_032655.1,21318794,22872468,22872472,c,cccag,4
NC_037333.1,NC_032655.1,21367679,22921181,22921182,c,ca,1
NC_037333.1,NC_032655.1,21392800,22946282,22946306,g,gcctcTCTTAGTCAGGAAGNNNNNN,24
NC_037333.1,NC_032655.1,21434416,22987930,22987932,T,TTC,2
NC_037333.1,NC_032655.1,21457864,23011380,23011381,A,AC,1
NC_037333.1,NC_032655.1,21463622,23017142,23017143,t,tW,1
NC_037333.1,NC_032655.1,21478304,23031825,23031826,T,TC,1
NC_037333.1,NC_032655.1,21479599,23033121,23033126,a,ataaac,5
NC_037333.1,NC_032655.1,21487827,23041613,23041615,g,gga,2
NC_037333.1,NC_032655.1,21488086,23041874,23041878,a,ataat,4
NC_037333.1,NC_032655.1,21488089,23041881,23041882,t,ta,1
NC_037333.1,NC_032655.1,21528353,23049100,23049101,t,ta,1
NC_037333.1,NC_032655.1,21611652,23210371,23210374,G,GATT,3
NC_037333.1,NC_032655.1,21617946,23216668,23216669,C,CM,1
NC_037333.1,NC_032655.1,21776774,23379002,23379003,T,TC,1
NC_037333.1,NC_032655.1,21779412,23381635,23381649,t,tggcaacccactcca,14
NC_037333.1,NC_032655.1,21830970,23433263,23433264,g,gc,1
NC_037333.1,NC_032655.1,21840001,23442298,23442299,c,ct,1
NC_037333.1,NC_032655.1,21945894,23559763,23559765,t,taa,2
NC_037333.1,NC_032655.1,21973951,23588010,23588011,A,AR,1
NC_037333.1,NC_032655.1,21988889,23602952,23602953,C,CT,1
NC_037333.1,NC_032655.1,21994300,23608368,23608374,T,TGGGCTC,6
NC_037333.1,NC_032655.1,22025905,23639889,23639891,T,TTA,2
NC_037333.1,NC_032655.1,22039965,23653951,23653952,g,gt,1
NC_037333.1,NC_032655.1,22096694,23710676,23710677,C,CY,1
NC_037333.1,NC_032655.1,22101044,23715031,23715047,T,TCTACAGGGAGCATGTC,16
NC_037333.1,NC_032655.1,22189462,23803479,23803483,a,agggt,4
NC_037333.1,NC_032655.1,22242805,23856827,23856828,T,TA,1
NC_037333.1,NC_032655.1,22242847,23856870,23856871,T,TA,1
NC_037333.1,NC_032655.1,22259988,23874009,23874014,t,tctgta,5
NC_037333.1,NC_032655.1,22306010,23919300,23919314,A,AATTATCAGAGGAAT,14
NC_037333.1,NC_032655.1,22307329,23920633,23920634,t,ta,1
NC_037333.1,NC_032655.1,22360494,23973764,23973765,G,GS,1
NC_037333.1,NC_032655.1,22384635,24355551,24355558,A,ATGGAATC,7
NC_037333.1,NC_032655.1,22385281,24356204,24356205,C,CY,1
NC_037333.1,NC_032655.1,22425355,23998763,23998770,a,ataagcat,7
NC_037333.1,NC_032655.1,22427123,24000538,24000550,G,GGTCATGGCCCTA,12
NC_037333.1,NC_032655.1,22819363,24445622,24445623,G,GS,1
NC_037333.1,NC_032655.1,22863292,24489132,24489145,a,atgaaagtgaaaag,13
NC_037333.1,NC_032655.1,22865467,24491316,24491317,t,ta,1
NC_037333.1,NC_032655.1,22867496,24493346,24493349,T,TATY,3
NC_037333.1,NC_032655.1,22870785,24496635,24496636,T,TC,1
NC_037333.1,NC_032655.1,22872018,24497869,24497872,t,taaa,3
NC_037333.1,NC_032655.1,22876713,24502567,24502568,t,ta,1
NC_037333.1,NC_032655.1,22896363,24522213,24522216,t,tagc,3
NC_037333.1,NC_032655.1,22902218,24528076,24528078,a,agg,2
NC_037333.1,NC_032655.1,22902527,24528387,24528388,c,ct,1
NC_037333.1,NC_032655.1,22903984,24529845,24529846,T,TC,1
NC_037333.1,NC_032655.1,22906689,24532543,24532570,C,CGTTTATACCAACCNNNNNNNNNNNNNN,27
NC_037333.1,NC_032655.1,22910344,24536235,24536236,a,at,1
NC_037333.1,NC_032655.1,22910504,24536396,24536397,G,GA,1
NC_037333.1,NC_032655.1,22932020,24557920,24557921,G,GR,1
NC_037333.1,NC_032655.1,23008667,24634273,24634274,g,gc,1
NC_037333.1,NC_032655.1,23032369,24657985,24657986,G,GA,1
NC_037333.1,NC_032655.1,23040292,24665908,24665909,c,cN,1
NC_037333.1,NC_032655.1,23091880,24723652,24723653,A,AW,1
NC_037333.1,NC_032655.1,23092665,24724438,24724441,A,AACT,3
NC_037333.1,NC_032655.1,23095726,24727498,24727500,a,aac,2
NC_037333.1,NC_032655.1,23101070,24732847,24732848,G,GK,1
NC_037333.1,NC_032655.1,23146322,24778103,24778105,a,acc,2
NC_037333.1,NC_032655.1,23146401,24778184,24778186,t,tta,2
NC_037333.1,NC_032655.1,23227169,24886773,24886774,C,CA,1
NC_037333.1,NC_032655.1,23253083,24912696,24912701,c,cttttt,5
NC_037333.1,NC_032655.1,23347931,25007593,25007594,A,AT,1
NC_037333.1,NC_032655.1,23352518,25012174,25012175,a,ag,1
NC_037333.1,NC_032655.1,23389804,25049374,25049375,a,at,1
NC_037333.1,NC_032655.1,23428640,25092096,25092100,a,aNNNN,4
NC_037333.1,NC_032655.1,23471838,25135311,25135312,A,AC,1
NC_037333.1,NC_032655.1,23489938,25153416,25153428,a,aNNNNNNNNNNNN,12
NC_037333.1,NC_032655.1,23533346,25196862,25196866,T,TTAAG,4
NC_037333.1,NC_032655.1,23671956,25335644,25335645,T,TK,1
NC_037333.1,NC_032655.1,23682883,25346573,25346579,g,gccgttt,6
NC_037333.1,NC_032655.1,23736704,25400401,25400402,C,CM,1
NC_037333.1,NC_032655.1,23833323,25496927,25496928,C,CA,1
NC_037333.1,NC_032655.1,23882870,25550418,25550420,t,ttg,2
NC_037333.1,NC_032655.1,23926565,25597748,25597750,G,GTA,2
NC_037333.1,NC_032655.1,24024307,25707401,25707408,t,tcaataac,7
NC_037333.1,NC_032655.1,24140188,25823091,25823092,G,GA,1
NC_037333.1,NC_032655.1,24147190,25830094,25830097,C,CTCT,3
NC_037333.1,NC_032655.1,24340683,26022544,26022547,c,cgtg,3
NC_037333.1,NC_032655.1,24463402,26147544,26147545,t,ta,1
NC_037333.1,NC_032655.1,24465113,26149255,26149256,g,gt,1
NC_037333.1,NC_032655.1,24612285,26288917,26288926,a,aaaagaatac,9
NC_037333.1,NC_032655.1,24668758,26369769,26369770,a,at,1
NC_037333.1,NC_032655.1,24685681,26386691,26386692,A,AR,1
NC_037333.1,NC_032655.1,24722154,26423166,26423167,G,GK,1
NC_037333.1,NC_032655.1,24754395,26453292,26453293,A,AW,1
NC_037333.1,NC_032655.1,24821954,26520851,26520852,T,TK,1
NC_037333.1,NC_032655.1,24853122,26552026,26552027,A,AT,1
NC_037333.1,NC_032655.1,24870304,26570021,26570022,t,tg,1
NC_037333.1,NC_032655.1,24873703,26573763,26573764,T,TW,1
NC_037333.1,NC_032655.1,24952868,26652937,26652939,a,aag,2
NC_037333.1,NC_032655.1,24953357,26653417,26653418,t,tg,1
NC_037333.1,NC_032655.1,24958714,26658776,26658777,g,gt,1
NC_037333.1,NC_032655.1,24961800,26661863,26661881,t,tNNNNNNNNNNNtatataa,18
NC_037333.1,NC_032655.1,24964039,26664120,26664122,A,ACT,2
NC_037333.1,NC_032655.1,25001478,26701927,26701933,t,tgacaaa,6
NC_037333.1,NC_032655.1,25120951,26879963,26879965,C,CTT,2
NC_037333.1,NC_032655.1,25293104,27093474,27093475,G,GA,1
NC_037333.1,NC_032655.1,25317826,27118198,27118199,t,tg,1
NC_037333.1,NC_032655.1,25317851,27118224,27118225,t,tg,1
NC_037333.1,NC_032655.1,25354995,27155374,27155375,c,ca,1
NC_037333.1,NC_032655.1,25364282,27164660,27164661,g,ga,1
NC_037333.1,NC_032655.1,25371073,27171452,27171453,a,at,1
NC_037333.1,NC_032655.1,25372262,27181007,27181008,a,at,1
NC_037333.1,NC_032655.1,25619391,27426860,27426861,c,cg,1
NC_037333.1,NC_032655.1,25919396,27731478,27731479,A,AT,1
NC_037333.1,NC_032655.1,25998514,27809064,27809066,C,CCT,2
NC_037333.1,NC_032655.1,26032437,27842922,27842923,a,ac,1
NC_037333.1,NC_032655.1,26060623,27871113,27871114,G,GA,1
NC_037333.1,NC_032655.1,26556018,28361294,28361295,a,at,1
NC_037333.1,NC_032655.1,26556765,28362042,28362043,t,tc,1
NC_037333.1,NC_032655.1,26568756,28374031,28374033,c,cat,2
NC_037333.1,NC_032655.1,26579343,28384619,28384620,T,TC,1
NC_037333.1,NC_032655.1,26659769,28467596,28467597,t,tc,1
NC_037333.1,NC_032655.1,26677704,28485533,28485534,g,gc,1
NC_037333.1,NC_032655.1,26773448,28582394,28582395,t,tg,1
NC_037333.1,NC_032655.1,27258024,29066066,29066069,c,catg,3
NC_037333.1,NC_032655.1,27258207,29066252,29066254,c,cca,2
NC_037333.1,NC_032655.1,27516387,29330133,29330140,T,TTGAAACC,7
NC_037333.1,NC_032655.1,27516785,29330541,29330542,G,GA,1
NC_037333.1,NC_032655.1,27548247,29362012,29362016,T,TTCCY,4
NC_037333.1,NC_032655.1,27557698,29371468,29371483,a,aacccctggaagaggg,15
NC_037333.1,NC_032655.1,27652618,29521213,29521233,c,catggggtcgcaaagagttgg,20
NC_037333.1,NC_032655.1,27671313,29542091,29542092,G,GT,1
NC_037333.1,NC_032655.1,27695139,29565825,29565827,c,caa,2
NC_037333.1,NC_032655.1,27706046,29576735,29576738,C,CAAT,3
NC_037333.1,NC_032655.1,27726020,29596706,29596725,t,tcaccagatCCAgtgatcca,19
NC_037333.1,NC_032655.1,27726386,29597091,29597092,t,tc,1
NC_037333.1,NC_032655.1,27778704,29649410,29649411,g,ga,1
NC_037333.1,NC_032655.1,27787713,29658422,29658427,a,attttt,5
NC_037333.1,NC_032655.1,27788028,29658740,29658741,T,TC,1
NC_037333.1,NC_032655.1,27792791,29663505,29663510,a,aaagat,5
NC_037333.1,NC_032655.1,27850387,29723924,29723925,g,gc,1
NC_037333.1,NC_032655.1,27934163,29807716,29807717,G,GC,1
NC_037333.1,NC_032655.1,27935534,29809088,29809089,A,AT,1
NC_037333.1,NC_032655.1,27935633,29809188,29809189,t,ta,1
NC_037333.1,NC_032655.1,27941915,29815471,29815478,a,ataaatat,7
NC_037333.1,NC_032655.1,27956743,29830307,29830309,t,tta,2
NC_037333.1,NC_032655.1,28258610,30132534,30132535,t,tc,1
NC_037333.1,NC_032655.1,28282644,30156571,30156572,G,GA,1
NC_037333.1,NC_032655.1,28291827,30165755,30165757,t,taa,2
NC_037333.1,NC_032655.1,28402602,30280096,30280097,a,at,1
NC_037333.1,NC_032655.1,28421480,30298975,30298976,c,ct,1
NC_037333.1,NC_032655.1,28698025,30576617,30576618,t,ta,1
NC_037333.1,NC_032655.1,28838393,30716888,30716889,T,TG,1
NC_037333.1,NC_032655.1,28839365,30717862,30717863,c,ca,1
NC_037333.1,NC_032655.1,28849128,30727631,30727632,a,at,1
NC_037333.1,NC_032655.1,28883668,30762173,30762174,c,ca,1
NC_037333.1,NC_032655.1,28925376,30803624,30803625,T,TC,1
NC_037333.1,NC_032655.1,28925384,30803633,30803634,A,AG,1
NC_037333.1,NC_032655.1,29206960,31086641,31086642,a,ag,1
NC_037333.1,NC_032655.1,29280442,31160128,31160129,c,ct,1
NC_037333.1,NC_032655.1,29362089,31241775,31241776,t,ta,1
NC_037333.1,NC_032655.1,29397079,31277040,31277041,t,ta,1
NC_037333.1,NC_032655.1,29417595,31297557,31297560,t,tcta,3
NC_037333.1,NC_032655.1,29456267,31336558,31336559,t,ta,1
NC_037333.1,NC_032655.1,29619859,31500553,31500555,A,AGG,2
NC_037333.1,NC_032655.1,30261757,32141225,32141226,c,ct,1
NC_037333.1,NC_032655.1,30280950,32160420,32160422,t,ttc,2
NC_037333.1,NC_032655.1,30941052,32886723,32886724,t,tc,1
NC_037333.1,NC_032655.1,31172795,33118125,33118126,G,GK,1
NC_037333.1,NC_032655.1,31431220,33452076,33452077,t,ta,1
NC_037333.1,NC_032655.1,31511651,33532621,33532622,A,AK,1
NC_037333.1,NC_032655.1,31542628,33563602,33563603,g,gt,1
NC_037333.1,NC_032655.1,31696529,33717942,33717943,a,ac,1
NC_037333.1,NC_032655.1,31710132,33734791,33734801,t,tggcggatgca,10
NC_037333.1,NC_032655.1,32174773,34201108,34201109,t,ta,1
NC_037333.1,NC_032655.1,32288169,34344091,34344092,c,ct,1
NC_037333.1,NC_032655.1,32325828,34381576,34381577,t,ta,1
NC_037333.1,NC_032655.1,32359822,34415408,34415410,a,att,2
NC_037333.1,NC_032655.1,32376009,34431132,34431133,C,CG,1
NC_037333.1,NC_032655.1,32406987,34462113,34462114,g,gc,1
NC_037333.1,NC_032655.1,32629359,34684250,34684251,a,ag,1
NC_037333.1,NC_032655.1,32629370,34684262,34684263,t,ta,1
NC_037333.1,NC_032655.1,32634646,34689511,34689512,T,TA,1
NC_037333.1,NC_032655.1,33524707,35066387,35066388,A,AT,1
NC_037333.1,NC_032655.1,33525714,35067395,35067396,c,ca,1
NC_037333.1,NC_032655.1,33527382,35069064,35069065,a,ag,1
NC_037333.1,NC_032655.1,33688339,35230003,35230004,g,ga,1
NC_037333.1,NC_032655.1,33715024,35256690,35256691,A,AM,1
NC_037333.1,NC_032655.1,33715031,35256698,35256699,T,TA,1
NC_037333.1,NC_032655.1,34036156,35641951,35641952,G,GT,1
NC_037333.1,NC_032655.1,34157675,35763295,35763296,C,CA,1
NC_037333.1,NC_032655.1,34259356,35864978,35864984,T,TACAAAN,6
NC_037333.1,NC_032655.1,34286016,35891641,35891642,c,ca,1
NC_037333.1,NC_032655.1,34286415,35892041,35892042,a,at,1
NC_037333.1,NC_032655.1,34372924,35978490,35978492,t,tNN,2
NC_037333.1,NC_032655.1,34473770,36079262,36079264,a,aag,2
NC_037333.1,NC_032655.1,34582734,36234118,36234119,t,ta,1
NC_037333.1,NC_032655.1,34582937,36234321,36234322,c,ct,1
NC_037333.1,NC_032655.1,34583023,36234408,36234409,t,ta,1
NC_037333.1,NC_032655.1,34937797,36590158,36590160,A,AAT,2
NC_037333.1,NC_032655.1,35870969,36682763,36682764,C,CY,1
NC_037333.1,NC_032655.1,35911556,36724070,36724071,A,AG,1
NC_037333.1,NC_032655.1,36059422,36872624,36872625,t,tg,1
NC_037333.1,NC_032655.1,36382814,37203432,37203433,c,ct,1
NC_037333.1,NC_032655.1,36479210,37299821,37299822,c,ct,1
NC_037333.1,NC_032655.1,36723966,37544045,37544046,t,tN,1
NC_037333.1,NC_032655.1,37030312,37853842,37853843,t,ta,1
NC_037333.1,NC_032655.1,37044355,37867886,37867887,A,AT,1
NC_037333.1,NC_032655.1,37046418,37869950,37869951,T,TG,1
NC_037333.1,NC_032655.1,37098996,37920392,37920393,c,ca,1
NC_037333.1,NC_032655.1,37103160,37924557,37924558,t,tc,1
NC_037333.1,NC_032655.1,37164877,38066906,38066907,G,GT,1
NC_037333.1,NC_032655.1,37167720,38069749,38069750,g,gt,1
NC_037333.1,NC_032655.1,37168773,37991358,37991359,G,GT,1
NC_037333.1,NC_032655.1,37168773,38070782,38070783,G,GT,1
NC_037333.1,NC_032655.1,37169033,38071043,38071044,A,AT,1
NC_037333.1,NC_032655.1,37189240,38091274,38091279,T,TAATTG,5
NC_037333.1,NC_032655.1,37229628,38131667,38131668,t,ta,1
NC_037333.1,NC_032655.1,37339681,38241723,38241724,a,at,1
NC_037333.1,NC_032655.1,37612705,38514985,38514988,a,atat,3
NC_037333.1,NC_032655.1,37669832,38571987,38571988,T,TC,1
NC_037333.1,NC_032655.1,37691962,38594125,38594126,G,GA,1
NC_037333.1,NC_032655.1,37772102,38674618,38674619,a,at,1
NC_037333.1,NC_032655.1,37772758,38675274,38675275,A,AT,1
NC_037333.1,NC_032655.1,37790918,38693396,38693398,t,tac,2
NC_037333.1,NC_032655.1,37792814,38695286,38695289,g,gtct,3
NC_037333.1,NC_032655.1,37863364,38765685,38765686,a,at,1
NC_037333.1,NC_032655.1,37870119,38772442,38772443,g,ga,1
NC_037333.1,NC_032655.1,37870497,38772823,38772831,t,tggtttttg,8
NC_037333.1,NC_032655.1,37870510,38772844,38772846,t,tgg,2
NC_037333.1,NC_032655.1,37944598,38848631,38848633,T,TAC,2
NC_037333.1,NC_032655.1,38025842,38931543,38931545,a,atg,2
NC_037333.1,NC_032655.1,38110282,39015923,39015924,C,CY,1
NC_037333.1,NC_032655.1,38150411,39056057,39056058,C,CY,1
NC_037333.1,NC_032655.1,38153855,39059502,39059503,t,tc,1
NC_037333.1,NC_032655.1,38159179,39064828,39064830,C,CTT,2
NC_037333.1,NC_032655.1,38160049,39065704,39065707,A,AATT,3
NC_037333.1,NC_032655.1,38163971,39069633,39069634,t,tc,1
NC_037333.1,NC_032655.1,38164553,39070216,39070218,a,att,2
NC_037333.1,NC_032655.1,38169336,39074985,39074990,T,TGCAGC,5
NC_037333.1,NC_032655.1,38181380,39087029,39087030,a,ag,1
NC_037333.1,NC_032655.1,38183699,39089463,39089466,t,tgga,3
NC_037333.1,NC_032655.1,38184416,39090183,39090184,a,ac,1
NC_037333.1,NC_032655.1,38210854,39116634,39116635,A,AC,1
NC_037333.1,NC_032655.1,38368289,39275871,39275875,c,ccttt,4
NC_037333.1,NC_032655.1,38372161,39279747,39279749,t,ttc,2
NC_037333.1,NC_032655.1,38389864,39297458,39297459,A,AC,1
NC_037333.1,NC_032655.1,38410770,39353423,39353425,C,CTA,2
NC_037333.1,NC_032655.1,38538179,39521076,39521077,c,ct,1
NC_037333.1,NC_032655.1,38549875,39532815,39532819,t,tatac,4
NC_037333.1,NC_032655.1,38663006,39660146,39660148,t,tga,2
NC_037333.1,NC_032655.1,38666674,39663820,39663822,a,aac,2
NC_037333.1,NC_032655.1,38672817,39669967,39669968,G,GC,1
NC_037333.1,NC_032655.1,38691780,39691028,39691029,G,GA,1
NC_037333.1,NC_032655.1,38719724,39719057,39719058,t,tY,1
NC_037333.1,NC_032655.1,38721867,39721201,39721202,a,ac,1
NC_037333.1,NC_032655.1,38749539,39748814,39748815,A,AC,1
NC_037333.1,NC_032655.1,38751270,39750546,39750547,g,gc,1
NC_037333.1,NC_032655.1,38753762,39753040,39753041,C,CY,1
NC_037333.1,NC_032655.1,38841208,39837206,39837208,T,TTA,2
NC_037333.1,NC_032655.1,38842188,39838188,39838189,A,AG,1
NC_037333.1,NC_032655.1,38844408,39840401,39840402,a,aR,1
NC_037333.1,NC_032655.1,38846049,39842043,39842045,g,ggt,2
NC_037333.1,NC_032655.1,38874598,39870595,39870596,T,TC,1
NC_037333.1,NC_032655.1,38883310,39879310,39879312,c,caa,2
NC_037333.1,NC_032655.1,38884632,39880634,39880635,t,ta,1
NC_037333.1,NC_032655.1,38911070,39907070,39907072,t,tNN,2
NC_037333.1,NC_032655.1,38983509,39979509,39979510,C,CY,1
NC_037333.1,NC_032655.1,39005703,40001707,40001722,A,AATAAGAACAAATGTG,15
NC_037333.1,NC_032655.1,39034019,40030046,40030047,a,at,1
NC_037333.1,NC_032655.1,39054450,40050479,40050480,a,ag,1
NC_037333.1,NC_032655.1,39105720,40101772,40101773,g,gt,1
NC_037333.1,NC_032655.1,39131476,40127529,40127530,t,ta,1
NC_037333.1,NC_032655.1,39218807,40214867,40214869,a,aNN,2
NC_037333.1,NC_032655.1,39271301,40266885,40266886,C,CT,1
NC_037333.1,NC_032655.1,39271303,40266888,40266889,T,TA,1
NC_037333.1,NC_032655.1,39356565,40536587,40536606,C,CCNNNNNNNNNNNNNNNNNN,19
NC_037333.1,NC_032655.1,39372502,40552353,40552366,C,CTNNNNNNNNNNNN,13
NC_037333.1,NC_032655.1,39436002,40622701,40622702,G,GC,1
NC_037333.1,NC_032655.1,39437761,40696974,40696975,t,tg,1
NC_037333.1,NC_032655.1,39437761,40624465,40624466,t,tg,1
NC_037333.1,NC_032655.1,39437787,40624492,40624493,g,gc,1
NC_037333.1,NC_032655.1,39452338,40634415,40634419,g,gaaaa,4
NC_037333.1,NC_032655.1,39476400,40730407,40730408,g,gt,1
NC_037333.1,NC_032655.1,39512133,40760435,40760436,T,TA,1
NC_037333.1,NC_032655.1,39552832,40801140,40801141,C,CY,1
NC_037333.1,NC_032655.1,39555541,40803850,40803851,g,gc,1
NC_037333.1,NC_032655.1,39578861,40827173,40827174,c,ct,1
NC_037333.1,NC_032655.1,39623958,40875021,40875022,A,AC,1
NC_037333.1,NC_032655.1,39655980,40907055,40907056,g,gc,1
NC_037333.1,NC_032655.1,39719126,40970034,40970035,T,TW,1
NC_037333.1,NC_032655.1,39743608,40994458,40994459,t,ta,1
NC_037333.1,NC_032655.1,39756843,41007659,41007660,t,ta,1
NC_037333.1,NC_032655.1,39855173,41106642,41106643,a,at,1
NC_037333.1,NC_032655.1,39869739,41121234,41121245,t,tggagaatccca,11
NC_037333.1,NC_032655.1,39877296,41128692,41128693,A,AG,1
NC_037333.1,NC_032655.1,39885905,41137305,41137306,T,TC,1
NC_037333.1,NC_032655.1,39887515,41138916,41138917,C,CA,1
NC_037333.1,NC_032655.1,39951771,41202752,41202753,g,ga,1
NC_037333.1,NC_032655.1,40027036,41277983,41277985,a,aac,2
NC_037333.1,NC_032655.1,40158352,41409263,41409264,t,ta,1
NC_037333.1,NC_032655.1,40274297,41523257,41523261,G,GTGTA,4
NC_037333.1,NC_032655.1,40274315,41523279,41523284,A,AAGTTT,5
NC_037333.1,NC_032655.1,40336341,41586196,41586197,T,TA,1
NC_037333.1,NC_032655.1,40357302,41606105,41606106,T,TA,1
NC_037333.1,NC_032655.1,40357550,41606354,41606355,c,ct,1
NC_037333.1,NC_032655.1,40372667,41621474,41621475,A,AT,1
NC_037333.1,NC_032655.1,40372711,41621519,41621521,A,AAC,2
NC_037333.1,NC_032655.1,40404674,41653906,41653907,t,ta,1
NC_037333.1,NC_032655.1,40412895,41662126,41662127,T,TG,1
NC_037333.1,NC_032655.1,40415941,41665190,41665195,C,CGCATA,5
NC_037333.1,NC_032655.1,40418760,41668013,41668018,c,caagag,5
NC_037333.1,NC_032655.1,40444493,41693867,41693874,T,TCATTGTA,7
NC_037333.1,NC_032655.1,40448160,41697538,41697539,T,TC,1
NC_037333.1,NC_032655.1,40448273,41697652,41697653,A,AC,1
NC_037333.1,NC_032655.1,40452895,41702287,41702288,c,ct,1
NC_037333.1,NC_032655.1,40454779,41704172,41704174,c,ctg,2
NC_037333.1,NC_032655.1,40473794,41724182,41724183,G,GA,1
NC_037333.1,NC_032655.1,40503769,41754162,41754163,t,ta,1
NC_037333.1,NC_032655.1,40537150,41787550,41787551,a,ac,1
NC_037333.1,NC_032655.1,40552515,41802914,41802917,g,ggtt,3
NC_037333.1,NC_032655.1,40565884,41816287,41816288,G,GR,1
NC_037333.1,NC_032655.1,40581065,41831470,41831471,T,TG,1
NC_037333.1,NC_032655.1,40589969,41840378,41840379,c,ct,1
NC_037333.1,NC_032655.1,40592000,41842411,41842413,g,gat,2
NC_037333.1,NC_032655.1,40615281,41866392,41866396,g,gaata,4
NC_037333.1,NC_032655.1,40616208,41867323,41867324,g,ga,1
NC_037333.1,NC_032655.1,40626830,41877940,41877942,C,CAT,2
NC_037333.1,NC_032655.1,40680772,41932434,41932436,A,ATT,2
NC_037333.1,NC_032655.1,40698550,41950160,41950161,C,CA,1
NC_037333.1,NC_032655.1,40703835,41955447,41955449,T,TCA,2
NC_037333.1,NC_032655.1,40708988,41960600,41960601,C,CY,1
NC_037333.1,NC_032655.1,40710219,41961834,41961835,g,gY,1
NC_037333.1,NC_032655.1,40713308,41964910,41964911,C,CA,1
NC_037333.1,NC_032655.1,40724145,41975746,41975747,a,at,1
NC_037333.1,NC_032655.1,40753733,42005338,42005339,c,ca,1
NC_037333.1,NC_032655.1,40760222,42011815,42011816,T,TY,1
NC_037333.1,NC_032655.1,40764902,42016499,42016500,C,CY,1
NC_037333.1,NC_032655.1,40780264,42031950,42031951,T,TG,1
NC_037333.1,NC_032655.1,40805803,42056986,42056987,c,ct,1
NC_037333.1,NC_032655.1,40807702,42058887,42058888,c,ca,1
NC_037333.1,NC_032655.1,40810424,42061609,42061610,a,ac,1
NC_037333.1,NC_032655.1,40859420,42110623,42110624,T,TC,1
NC_037333.1,NC_032655.1,40898585,42149818,42149821,T,TCTC,3
NC_037333.1,NC_032655.1,40924370,42176337,42176338,T,TW,1
NC_037333.1,NC_032655.1,40931435,42183404,42183407,t,ttta,3
NC_037333.1,NC_032655.1,40934772,42186744,42186748,a,aNNNN,4
NC_037333.1,NC_032655.1,40951809,42203788,42203789,A,AC,1
NC_037333.1,NC_032655.1,41060673,42312733,42312734,A,AW,1
NC_037333.1,NC_032655.1,41067549,42319612,42319614,G,GCA,2
NC_037333.1,NC_032655.1,41092437,42344500,42344501,C,CG,1
NC_037333.1,NC_032655.1,41116942,42368993,42368994,a,at,1
NC_037333.1,NC_032655.1,41117666,42369718,42369719,t,tc,1
NC_037333.1,NC_032655.1,41123562,42375616,42375618,t,tNN,2
NC_037333.1,NC_032655.1,41156004,42408064,42408065,t,ta,1
NC_037333.1,NC_032655.1,41206561,42458646,42458647,a,ag,1
NC_037333.1,NC_032655.1,41260072,42512159,42512160,A,AC,1
NC_037333.1,NC_032655.1,41661799,42957726,42957727,t,tc,1
NC_037333.1,NC_032655.1,41676918,42972850,42972852,C,CTG,2
NC_037333.1,NC_032655.1,41760283,43056768,43056770,A,AGT,2
NC_037333.1,NC_032655.1,41868290,43164732,43164733,A,AR,1
NC_037333.1,NC_032655.1,41901998,43198452,43198453,T,TA,1
NC_037333.1,NC_032655.1,41927128,43224155,43224156,C,CS,1
NC_037333.1,NC_032655.1,41966933,43263954,43263956,T,TAC,2
NC_037333.1,NC_032655.1,41967181,43264204,43264206,A,ACT,2
NC_037333.1,NC_032655.1,41979688,43276715,43276720,t,tatata,5
NC_037333.1,NC_032655.1,42006966,43303988,43303991,a,aagg,3
NC_037333.1,NC_032655.1,42016691,43313941,43313942,c,cg,1
NC_037333.1,NC_032655.1,42040684,43337926,43337927,G,GR,1
NC_037333.1,NC_032655.1,42159022,43454718,43454719,t,tg,1
NC_037333.1,NC_032655.1,42160326,43456033,43456034,T,TG,1
NC_037333.1,NC_032655.1,42163569,43459277,43459300,A,ACCAGATGGGCCTCAGCATGTATT,23
NC_037333.1,NC_032655.1,42164092,43459823,43459825,g,gca,2
NC_037333.1,NC_032655.1,42189566,43485226,43485234,c,caaaaaaaa,8
NC_037333.1,NC_032655.1,42213637,43511346,43511354,a,agtgtgtgt,8
NC_037333.1,NC_032655.1,42216374,43514150,43514151,C,CA,1
NC_037333.1,NC_032655.1,42216450,43514227,43514230,A,AATG,3
NC_037333.1,NC_032655.1,42224023,43521806,43521807,G,GR,1
NC_037333.1,NC_032655.1,42231059,43528832,43528834,c,cat,2
NC_037333.1,NC_032655.1,42235231,43533008,43533010,C,CTG,2
NC_037333.1,NC_032655.1,42251390,43549173,43549183,a,attcagttcag,10
NC_037333.1,NC_032655.1,42253458,43551251,43551254,t,tagc,3
NC_037333.1,NC_032655.1,42254643,43552439,43552442,A,AAAT,3
NC_037333.1,NC_032655.1,42293992,43591873,43591874,c,ct,1
NC_037333.1,NC_032655.1,42307335,43605220,43605224,a,aNNNN,4
NC_037333.1,NC_032655.1,42327581,43625552,43625553,t,ta,1
NC_037333.1,NC_032655.1,42340605,43638581,43638582,T,TG,1
NC_037333.1,NC_032655.1,42355723,43652263,43652269,a,aNNNNNN,6
NC_037333.1,NC_032655.1,42375635,43672181,43672182,T,TG,1
NC_037333.1,NC_032655.1,42387256,43683795,43683796,c,ct,1
NC_037333.1,NC_032655.1,42399252,43695794,43695796,g,gtt,2
NC_037333.1,NC_032655.1,42427524,43727014,43727016,a,aMt,2
NC_037333.1,NC_032655.1,42434185,43733675,43733676,t,tW,1
NC_037333.1,NC_032655.1,42454855,43876216,43876222,t,ttatgaa,6
NC_037333.1,NC_032655.1,42454955,43876322,43876329,g,gggatcaa,7
NC_037333.1,NC_032655.1,42455099,43876473,43876478,c,caagaa,5
NC_037333.1,NC_032655.1,42465592,43886974,43886977,A,ATGT,3
NC_037333.1,NC_032655.1,42581190,43966222,43966224,t,tta,2
NC_037333.1,NC_032655.1,42582939,43967973,43967974,a,at,1
NC_037333.1,NC_032655.1,42730580,44163438,44163454,t,tatatatatacacaccc,16
NC_037333.1,NC_032655.1,42744815,44177690,44177691,t,tg,1
NC_037333.1,NC_032655.1,42774802,44208246,44208247,G,GK,1
NC_037333.1,NC_032655.1,42810065,44243507,44243508,t,tc,1
NC_037333.1,NC_032655.1,42821046,44254574,44254578,a,atgac,4
NC_037333.1,NC_032655.1,42821945,44255475,44255480,g,gtatgt,5
NC_037333.1,NC_032655.1,42839050,44272590,44272591,t,tY,1
NC_037333.1,NC_032655.1,42843095,44276636,44276642,c,cttcact,6
NC_037333.1,NC_032655.1,42843564,44277111,44277113,t,tNN,2
NC_037333.1,NC_032655.1,42865256,44298805,44298806,t,tc,1
NC_037333.1,NC_032655.1,42889078,44322623,44322627,a,aaaNN,4
NC_037333.1,NC_032655.1,42891779,44325328,44325330,t,tGC,2
NC_037333.1,NC_032655.1,42920825,44354367,44354368,T,TY,1
NC_037333.1,NC_032655.1,42928689,44362229,44362231,c,ctt,2
NC_037333.1,NC_032655.1,42936928,44370475,44370477,T,TTC,2
NC_037333.1,NC_032655.1,42940577,44374370,44374371,A,AT,1
NC_037333.1,NC_032655.1,42943996,44377803,44377804,T,TY,1
NC_037333.1,NC_032655.1,42946152,44379960,44379961,A,AC,1
NC_037333.1,NC_032655.1,42980565,44414388,44414389,C,CT,1
NC_037333.1,NC_032655.1,42994085,44427910,44427912,a,att,2
NC_037333.1,NC_032655.1,42999640,44433468,44433475,t,tttcatgg,7
NC_037333.1,NC_032655.1,43031670,44465516,44465519,c,cttt,3
NC_037333.1,NC_032655.1,43046254,44480112,44480113,t,tg,1
NC_037333.1,NC_032655.1,43081929,44518260,44518278,t,tatatatatatatatataa,18
NC_037333.1,NC_032655.1,43108338,44544788,44544789,T,TC,1
NC_037333.1,NC_032655.1,43117452,44551598,44551600,t,taa,2
NC_037333.1,NC_032655.1,43122645,44556793,44556794,t,tc,1
NC_037333.1,NC_032655.1,43130250,44564405,44564406,t,tc,1
NC_037333.1,NC_032655.1,43282641,44716927,44716928,c,ct,1
NC_037333.1,NC_032655.1,43323777,44758085,44758097,t,tttttaaggaatc,12
NC_037333.1,NC_032655.1,43328488,44761871,44761872,c,cg,1
NC_037333.1,NC_032655.1,43328528,44761912,44761913,a,ac,1
NC_037333.1,NC_032655.1,43336864,44770263,44770268,g,gtgtCT,5
NC_037333.1,NC_032655.1,43481160,44913515,44913525,t,taatagaaaaa,10
NC_037333.1,NC_032655.1,43490216,44922592,44922593,T,TA,1
NC_037333.1,NC_032655.1,43492812,44925190,44925192,a,aNN,2
NC_037333.1,NC_032655.1,43505703,44938091,44938094,a,agag,3
NC_037333.1,NC_032655.1,43618892,45051275,45051277,a,aNN,2
NC_037333.1,NC_032655.1,43746931,45179319,45179320,a,ac,1
NC_037333.1,NC_032655.1,43803376,45235784,45235787,T,TAAC,3
NC_037333.1,NC_032655.1,43806635,45239053,45239054,A,AW,1
NC_037333.1,NC_032655.1,43809547,45241966,45241969,T,TCTG,3
NC_037333.1,NC_032655.1,44066950,45498952,45498953,G,GA,1
NC_037333.1,NC_032655.1,44128504,45560509,45560510,t,tg,1
NC_037333.1,NC_032655.1,44737797,46176420,46176422,t,tta,2
NC_037333.1,NC_032655.1,44888716,46327827,46327828,a,aR,1
NC_037333.1,NC_032655.1,44921752,46360479,46360480,C,CA,1
NC_037333.1,NC_032655.1,44931845,46370573,46370577,C,CTGTT,4
NC_037333.1,NC_032655.1,44973201,46411982,46411983,T,TA,1
NC_037333.1,NC_032655.1,45203075,46601276,46601277,C,CT,1
NC_037333.1,NC_032655.1,45211787,46609889,46609899,t,tNNNNNNNNNN,10
NC_037333.1,NC_032655.1,45328978,46727099,46727100,C,CT,1
NC_037333.1,NC_032655.1,45361175,46761458,46761459,G,GC,1
NC_037333.1,NC_032655.1,45531433,46937693,46937695,C,CTT,2
NC_037333.1,NC_032655.1,45699127,47105398,47105399,C,CY,1
NC_037333.1,NC_032655.1,45812304,47218593,47218597,A,ATTAC,4
NC_037333.1,NC_032655.1,45942937,47349465,47349466,G,GA,1
NC_037333.1,NC_032655.1,45960363,47367806,47367808,T,TAC,2
NC_037333.1,NC_032655.1,46136743,47584222,47584224,A,AAG,2
NC_037333.1,NC_032655.1,46274541,47727929,47727931,g,gaa,2
NC_037333.1,NC_032655.1,46347138,47800243,47800246,a,aaag,3
NC_037333.1,NC_032655.1,46617146,48077324,48077325,t,tc,1
NC_037333.1,NC_032655.1,46652641,48112823,48112824,T,TC,1
NC_037333.1,NC_032655.1,46734412,48194596,48194600,A,AAANN,4
NC_037333.1,NC_032655.1,46838790,48298979,48298980,t,ta,1
NC_037333.1,NC_032655.1,46841424,48301611,48301612,t,ta,1
NC_037333.1,NC_032655.1,46883216,48343392,48343393,T,TK,1
NC_037333.1,NC_032655.1,46900766,48360576,48360581,G,GAACAT,5
NC_037333.1,NC_032655.1,46900956,48360771,48360772,T,TC,1
NC_037333.1,NC_032655.1,46908733,48370745,48370769,T,TTTGGACTATTTTTTTTACAGGATA,24
NC_037333.1,NC_032655.1,46918858,48380886,48380887,G,GA,1
NC_037333.1,NC_032655.1,46919014,48381043,48381048,C,CAAACA,5
NC_037333.1,NC_032655.1,46922193,48383777,48383778,a,ag,1
NC_037333.1,NC_032655.1,46923631,48385206,48385207,A,AT,1
NC_037333.1,NC_032655.1,46923842,48385418,48385419,C,CT,1
NC_037333.1,NC_032655.1,46926979,48388551,48388555,A,ATAGT,4
NC_037333.1,NC_032655.1,46933998,48395563,48395564,G,GC,1
NC_037333.1,NC_032655.1,46938237,48406869,48406870,a,ag,1
NC_037333.1,NC_032655.1,46947100,48415913,48415914,A,AW,1
NC_037333.1,NC_032655.1,46979192,48447996,48448031,A,AGNNNNNNNNNNNNNNNNNNNNNNNNNNNNNNNNNN,35
NC_037333.1,NC_032655.1,47070234,48568437,48568438,C,CA,1
NC_037333.1,NC_032655.1,47078754,48574871,48574872,t,tc,1
NC_037333.1,NC_032655.1,47087724,48583850,48583851,A,AC,1
NC_037333.1,NC_032655.1,47103806,48599700,48599701,T,TC,1
NC_037333.1,NC_032655.1,47118036,48614094,48614095,c,ca,1
NC_037333.1,NC_032655.1,47118056,48614115,48614119,t,taagc,4
NC_037333.1,NC_032655.1,47149364,48645244,48645246,C,CYT,2
NC_037333.1,NC_032655.1,47151268,48647151,48647152,a,at,1
NC_037333.1,NC_032655.1,47152503,48648387,48648388,C,CT,1
NC_037333.1,NC_032655.1,47152639,48648524,48648527,T,TAGA,3
NC_037333.1,NC_032655.1,47154750,48650009,48650010,A,AT,1
NC_037333.1,NC_032655.1,47155059,48650319,48650322,A,ATTC,3
NC_037333.1,NC_032655.1,47178334,48679481,48679483,a,aNN,2
NC_037333.1,NC_032655.1,47206540,48707698,48707700,C,CCT,2
NC_037333.1,NC_032655.1,47234414,48735508,48735509,t,ta,1
NC_037333.1,NC_032655.1,47234417,48735512,48735513,a,at,1
NC_037333.1,NC_032655.1,47251316,48752447,48752463,a,agaggatgagatgtctg,16
NC_037333.1,NC_032655.1,47283773,48784937,48784938,c,ca,1
NC_037333.1,NC_032655.1,47421394,48942234,48942235,t,tY,1
NC_037333.1,NC_032655.1,47458092,48978866,48978867,c,ca,1
NC_037333.1,NC_032655.1,47463691,48984467,48984468,a,aM,1
NC_037333.1,NC_032655.1,47476233,48996766,48996767,c,ct,1
NC_037333.1,NC_032655.1,47548917,49069125,49069126,T,TA,1
NC_037333.1,NC_032655.1,47548920,49069129,49069135,A,AWWCCCC,6
NC_037333.1,NC_032655.1,47550757,49070972,49070974,C,CAA,2
NC_037333.1,NC_032655.1,47551984,49072201,49072206,t,ttaata,5
NC_037333.1,NC_032655.1,47552112,49072334,49072338,A,ATATM,4
NC_037333.1,NC_032655.1,47552144,49072370,49072371,A,AC,1
NC_037333.1,NC_032655.1,47560682,49080897,49080898,a,at,1
NC_037333.1,NC_032655.1,47563748,49083963,49083984,C,CATGGCCAAACTATTTGCCaaa,21
NC_037333.1,NC_032655.1,47572818,49093048,49093049,t,tg,1
NC_037333.1,NC_032655.1,47584545,49104784,49104794,c,ctttgtctttt,10
NC_037333.1,NC_032655.1,47590374,49110621,49110622,G,GA,1
NC_037333.1,NC_032655.1,47591371,49111618,49111619,G,GR,1
NC_037333.1,NC_032655.1,47602948,49123197,49123198,G,GA,1
NC_037333.1,NC_032655.1,47614804,49135055,49135056,a,ac,1
NC_037333.1,NC_032655.1,47639182,49159724,49159726,A,AAC,2
NC_037333.1,NC_032655.1,47643398,49163943,49163944,t,tc,1
NC_037333.1,NC_032655.1,47650200,49170737,49170738,t,tc,1
NC_037333.1,NC_032655.1,47651836,49172377,49172378,a,at,1
NC_037333.1,NC_032655.1,47651851,49172393,49172394,t,ta,1
NC_037333.1,NC_032655.1,47669239,49188861,49188862,t,tc,1
NC_037333.1,NC_032655.1,47676515,49196139,49196141,t,tNN,2
NC_037333.1,NC_032655.1,47685142,49204766,49204770,a,agcct,4
NC_037333.1,NC_032655.1,47716034,49237564,49237565,G,GT,1
NC_037333.1,NC_032655.1,47719503,49240982,49240983,a,at,1
NC_037333.1,NC_032655.1,47721658,49243140,49243141,t,ta,1
NC_037333.1,NC_032655.1,47725173,49246650,49246651,T,TA,1
NC_037333.1,NC_032655.1,47725979,49247457,49247460,A,ATGT,3
NC_037333.1,NC_032655.1,47739281,49260762,49260786,t,ttatattccaactctcacatccata,24
NC_037333.1,NC_032655.1,47779558,49300892,49300893,c,ct,1
NC_037333.1,NC_032655.1,47784628,49305966,49305971,a,aggatg,5
NC_037333.1,NC_032655.1,47790289,49311632,49311633,g,ga,1
NC_037333.1,NC_032655.1,47795845,49317211,49317219,t,ttcttttta,8
NC_037333.1,NC_032655.1,47805956,49327338,49327339,g,gc,1
NC_037333.1,NC_032655.1,47807993,49329375,49329376,G,GT,1
NC_037333.1,NC_032655.1,47866807,49394258,49394260,C,CTM,2
NC_037333.1,NC_032655.1,47892882,49420338,49420343,c,catttt,5
NC_037333.1,NC_032655.1,47941958,49469432,49469433,T,TW,1
NC_037333.1,NC_032655.1,47945500,49473039,49473045,t,tcaaaaa,6
NC_037333.1,NC_032655.1,47948511,49476054,49476055,T,TA,1
NC_037333.1,NC_032655.1,47978441,49506007,49506009,t,ttg,2
NC_037333.1,NC_032655.1,48010568,49538142,49538143,A,AT,1
NC_037333.1,NC_032655.1,48014662,49541551,49541552,A,AG,1
NC_037333.1,NC_032655.1,48014754,49541644,49541646,t,taa,2
NC_037333.1,NC_032655.1,48015045,49541934,49541942,c,cgagataca,8
NC_037333.1,NC_032655.1,48015268,49542159,49542160,T,TA,1
NC_037333.1,NC_032655.1,48015291,49542183,49542185,c,ctt,2
NC_037333.1,NC_032655.1,48018981,49545867,49545868,C,CA,1
NC_037333.1,NC_032655.1,48021223,49548250,49548251,g,gc,1
NC_037333.1,NC_032655.1,48023482,49550502,49550503,t,tc,1
NC_037333.1,NC_032655.1,48027365,49554385,49554386,t,tg,1
NC_037333.1,NC_032655.1,48027403,49554425,49554426,a,ac,1
NC_037333.1,NC_032655.1,48078127,49675192,49675193,c,ct,1
NC_037333.1,NC_032655.1,48078516,49675582,49675583,a,ag,1
NC_037333.1,NC_032655.1,48082374,49679354,49679355,t,tc,1
NC_037333.1,NC_032655.1,48202696,49722109,49722110,A,AC,1
NC_037333.1,NC_032655.1,48218739,49738156,49738157,t,tc,1
NC_037333.1,NC_032655.1,48219630,49739048,49739049,a,at,1
NC_037333.1,NC_032655.1,48223810,49743230,49743231,c,ca,1
NC_037333.1,NC_032655.1,48224587,49744008,49744009,a,at,1
NC_037333.1,NC_032655.1,48227292,49746382,49746383,A,AR,1
NC_037333.1,NC_032655.1,48232211,49750577,49750578,a,ac,1
NC_037333.1,NC_032655.1,48236111,49592520,49592521,t,tc,1
NC_037333.1,NC_032655.1,48284702,49845329,49845330,c,ca,1
NC_037333.1,NC_032655.1,48300813,49861452,49861458,a,aaNNNNN,6
NC_037333.1,NC_032655.1,48431096,50010011,50010012,g,ga,1
NC_037333.1,NC_032655.1,48431118,50010034,50010035,t,tg,1
NC_037333.1,NC_032655.1,48431821,50010738,50010739,A,AT,1
NC_037333.1,NC_032655.1,48460787,50039705,50039708,a,actt,3
NC_037333.1,NC_032655.1,48520345,50102119,50102120,t,tc,1
NC_037333.1,NC_032655.1,48567333,50172439,50172456,G,GTGAAAAAGAAAGTTCTR,17
NC_037333.1,NC_032655.1,48577420,50182544,50182546,t,ttc,2
NC_037333.1,NC_032655.1,48612350,50217352,50217353,a,aM,1
NC_037333.1,NC_032655.1,48664165,50268269,50268270,c,ca,1
NC_037333.1,NC_032655.1,48671126,50275180,50275181,A,AW,1
NC_037333.1,NC_032655.1,48716917,50320969,50320971,t,tta,2
NC_037333.1,NC_032655.1,48736150,50340274,50340275,T,TK,1
NC_037333.1,NC_032655.1,48737560,50341684,50341685,T,TG,1
NC_037333.1,NC_032655.1,48738771,50342896,50342897,T,TK,1
NC_037333.1,NC_032655.1,48741812,50345926,50345927,A,AG,1
NC_037333.1,NC_032655.1,48744635,50348750,50348751,t,tY,1
NC_037333.1,NC_032655.1,48747898,50352014,50352020,t,tcttctg,6
NC_037333.1,NC_032655.1,48749113,50353237,50353238,a,at,1
NC_037333.1,NC_032655.1,48777126,50380926,50380927,t,ta,1
NC_037333.1,NC_032655.1,48789405,50393205,50393206,a,ac,1
NC_037333.1,NC_032655.1,48791672,50395473,50395474,A,AT,1
NC_037333.1,NC_032655.1,48792569,50396372,50396373,g,gc,1
NC_037333.1,NC_032655.1,48806121,50409538,50409540,c,ctg,2
NC_037333.1,NC_032655.1,48848308,50451334,50451335,a,at,1
NC_037333.1,NC_032655.1,48849705,50452731,50452732,T,TK,1
NC_037333.1,NC_032655.1,48850548,50453695,50453697,t,tga,2
NC_037333.1,NC_032655.1,48874704,50477860,50477862,t,taK,2
NC_037333.1,NC_032655.1,48906828,50515641,50515642,a,at,1
NC_037333.1,NC_032655.1,48907461,50510159,50510160,a,at,1
NC_037333.1,NC_032655.1,48907461,50516275,50516276,a,at,1
NC_037333.1,NC_032655.1,48910847,50519659,50519661,c,cta,2
NC_037333.1,NC_032655.1,48911908,50520806,50520807,t,ta,1
NC_037333.1,NC_032655.1,48919385,50528536,50528542,t,tcttctg,6
NC_037333.1,NC_032655.1,48937233,50545832,50545833,G,GT,1
NC_037333.1,NC_032655.1,48956764,50565453,50565454,t,tg,1
NC_037333.1,NC_032655.1,48961307,50569997,50569998,a,aR,1
NC_037333.1,NC_032655.1,48964679,50573370,50573371,A,AG,1
NC_037333.1,NC_032655.1,48969685,50578379,50578380,T,TC,1
NC_037333.1,NC_032655.1,48974370,50583064,50583065,G,GC,1
NC_037333.1,NC_032655.1,48976661,50585355,50585360,c,ccatat,5
NC_037333.1,NC_032655.1,48976686,50585385,50585387,g,gta,2
NC_037333.1,NC_032655.1,48979553,50588253,50588254,a,at,1
NC_037333.1,NC_032655.1,48983035,50591733,50591734,A,AG,1
NC_037333.1,NC_032655.1,48983671,50592373,50592376,a,aaac,3
NC_037333.1,NC_032655.1,48992320,50603318,50603319,T,TW,1
NC_037333.1,NC_032655.1,49070350,50693594,50693595,g,ga,1
NC_037333.1,NC_032655.1,49070437,50693682,50693683,c,ct,1
NC_037333.1,NC_032655.1,49095689,50727939,50727943,a,aNNNN,4
NC_037333.1,NC_032655.1,49134445,50766704,50766705,t,ta,1
NC_037333.1,NC_032655.1,49136868,50769128,50769130,a,aNN,2
NC_037333.1,NC_032655.1,49140796,50773061,50773063,A,AAC,2
NC_037333.1,NC_032655.1,49152995,50796989,50796990,G,GR,1
NC_037333.1,NC_032655.1,49159211,50803206,50803207,T,TA,1
NC_037333.1,NC_032655.1,49161108,50805104,50805108,G,GGTAC,4
NC_037333.1,NC_032655.1,49170031,50814032,50814040,a,atatatatR,8
NC_037333.1,NC_032655.1,49184504,50828506,50828512,t,tNNNNNN,6
NC_037333.1,NC_032655.1,49192906,50837451,50837452,A,AR,1
NC_037333.1,NC_032655.1,49202768,50846818,50846825,t,tcagtcag,7
NC_037333.1,NC_032655.1,49202772,50846829,50846830,g,gt,1
NC_037333.1,NC_032655.1,49220706,50865140,50865141,t,tc,1
NC_037333.1,NC_032655.1,49221379,50865812,50865813,t,tc,1
NC_037333.1,NC_032655.1,49225121,50869557,50869558,C,CS,1
NC_037333.1,NC_032655.1,49270404,50916321,50916324,c,catt,3
NC_037333.1,NC_032655.1,49277187,50923104,50923109,t,taaaag,5
NC_037333.1,NC_032655.1,49277247,50923169,50923170,a,at,1
NC_037333.1,NC_032655.1,49281182,50927105,50927106,A,AR,1
NC_037333.1,NC_032655.1,49309622,50955248,50955249,c,ct,1
NC_037333.1,NC_032655.1,49325657,50971203,50971205,t,tNN,2
NC_037333.1,NC_032655.1,49347308,50992859,50992860,t,tg,1
NC_037333.1,NC_032655.1,49446478,51092322,51092323,a,ag,1
NC_037333.1,NC_032655.1,49451603,51097561,51097564,T,TTTA,3
NC_037333.1,NC_032655.1,49477678,51116914,51116916,a,aat,2
NC_037333.1,NC_032655.1,49497164,51137330,51137331,G,GK,1
NC_037333.1,NC_032655.1,49541207,51181138,51181139,C,CT,1
NC_037333.1,NC_032655.1,49585967,51226037,51226040,A,AAGC,3
NC_037333.1,NC_032655.1,49586028,51226101,51226102,C,CT,1
NC_037333.1,NC_032655.1,49599652,51239731,51239733,A,AAG,2
NC_037333.1,NC_032655.1,49708238,51348292,51348293,c,ca,1
NC_037333.1,NC_032655.1,49708970,51349025,51349026,G,GA,1
NC_037333.1,NC_032655.1,49740623,51379704,51379705,a,at,1
NC_037333.1,NC_032655.1,49767042,51406106,51406113,g,ggtttttt,7
NC_037333.1,NC_032655.1,49782557,51421639,51421641,a,aag,2
NC_037333.1,NC_032655.1,49784458,51423540,51423541,A,AR,1
NC_037333.1,NC_032655.1,49785351,51424434,51424435,g,ga,1
NC_037333.1,NC_032655.1,49785573,51424659,51424660,C,CA,1
NC_037333.1,NC_032655.1,49802993,51442095,51442096,T,TA,1
NC_037333.1,NC_032655.1,49841551,51480654,51480655,a,at,1
NC_037333.1,NC_032655.1,49925510,51564297,51564298,g,gt,1
NC_037333.1,NC_032655.1,50030582,51669218,51669219,T,TY,1
NC_037333.1,NC_032655.1,50050499,51689171,51689174,C,CCAT,3
NC_037333.1,NC_032655.1,50051921,51690592,51690594,t,tNN,2
NC_037333.1,NC_032655.1,50052286,51690959,51690960,G,GT,1
NC_037333.1,NC_032655.1,50069825,51708497,51708500,T,TCTG,3
NC_037333.1,NC_032655.1,50097179,51735858,51735871,t,ttttttttaagaac,13
NC_037333.1,NC_032655.1,50104000,51742689,51742690,c,ca,1
NC_037333.1,NC_032655.1,50163999,51804300,51804309,a,aNNNNNNNNN,9
NC_037333.1,NC_032655.1,50187759,51828068,51828069,A,AT,1
NC_037333.1,NC_032655.1,50200555,51840871,51840872,C,CA,1
NC_037333.1,NC_032655.1,50217640,51857962,51857963,G,GT,1
NC_037333.1,NC_032655.1,50231538,51871880,51871881,g,ga,1
NC_037333.1,NC_032655.1,50236468,51876813,51876817,C,CTCAG,4
NC_037333.1,NC_032655.1,50238642,51878995,51878996,a,at,1
NC_037333.1,NC_032655.1,50244948,51885301,51885302,A,AT,1
NC_037333.1,NC_032655.1,50303264,51955817,51955818,T,TA,1
NC_037333.1,NC_032655.1,50313118,51967064,51967068,A,ACTGT,4
NC_037333.1,NC_032655.1,50314481,51968431,51968434,A,AAAC,3
NC_037333.1,NC_032655.1,50316395,51970351,51970352,a,ac,1
NC_037333.1,NC_032655.1,50350362,52004340,52004341,A,AW,1
NC_037333.1,NC_032655.1,50355225,52009205,52009209,A,ACTGT,4
NC_037333.1,NC_032655.1,50387479,52041469,52041470,g,ga,1
NC_037333.1,NC_032655.1,50387484,52041475,52041476,G,GA,1
NC_037333.1,NC_032655.1,50387493,52041485,52041486,c,ct,1
NC_037333.1,NC_032655.1,50387521,52041514,52041517,g,gcta,3
NC_037333.1,NC_032655.1,50387565,52041561,52041563,c,caa,2
NC_037333.1,NC_032655.1,50387567,52041565,52041566,g,ga,1
NC_037333.1,NC_032655.1,50420015,52073794,52073806,a,agaactggacatg,12
NC_037333.1,NC_032655.1,50478491,52132299,52132301,t,tcg,2
NC_037333.1,NC_032655.1,50507315,52160464,52160466,g,gtR,2
NC_037333.1,NC_032655.1,50520275,52173307,52173309,A,AAT,2
NC_037333.1,NC_032655.1,50523365,52179440,52179443,t,tcta,3
NC_037333.1,NC_032655.1,50524201,52180281,52180282,C,CY,1
NC_037333.1,NC_032655.1,50566528,52222619,52222620,g,ga,1
NC_037333.1,NC_032655.1,50624448,52280569,52280570,c,ca,1
NC_037333.1,NC_032655.1,50677546,52333657,52333658,A,AR,1
NC_037333.1,NC_032655.1,50691246,52347366,52347372,t,tagcagc,6
NC_037333.1,NC_032655.1,50700842,52356973,52356974,c,ct,1
NC_037333.1,NC_032655.1,50788756,52393438,52393439,t,tc,1
NC_037333.1,NC_032655.1,50809170,52413857,52413858,g,ga,1
NC_037333.1,NC_032655.1,50815921,52420524,52420525,T,TG,1
NC_037333.1,NC_032655.1,50827251,52431856,52431858,t,tca,2
NC_037333.1,NC_032655.1,50838764,52443370,52443371,t,ta,1
NC_037333.1,NC_032655.1,50845704,52450312,52450313,t,ta,1
NC_037333.1,NC_032655.1,50906983,52496226,52496227,t,tc,1
NC_037333.1,NC_032655.1,50929089,52518334,52518335,A,AW,1
NC_037333.1,NC_032655.1,50964398,52553654,52553656,c,caa,2
NC_037333.1,NC_032655.1,51110315,52700469,52700473,a,aatat,4
NC_037333.1,NC_032655.1,51125473,52715761,52715775,t,tNNNNNNNNNNNNNN,14
NC_037333.1,NC_032655.1,51175088,52764556,52764558,C,CAT,2
NC_037333.1,NC_032655.1,51187912,52777382,52777383,C,CT,1
NC_037333.1,NC_032655.1,51199403,52788877,52788881,C,CATTT,4
NC_037333.1,NC_032655.1,51201663,52791140,52791141,c,ct,1
NC_037333.1,NC_032655.1,51222658,52812129,52812130,c,ct,1
NC_037333.1,NC_032655.1,51223196,52812667,52812668,c,ct,1
NC_037333.1,NC_032655.1,51223203,52812675,52812676,c,ct,1
NC_037333.1,NC_032655.1,51223444,52812917,52812918,c,ct,1
NC_037333.1,NC_032655.1,51223522,52812996,52812997,t,tc,1
NC_037333.1,NC_032655.1,51224176,52813649,52813650,c,ct,1
NC_037333.1,NC_032655.1,51224390,52813862,52813863,a,at,1
NC_037333.1,NC_032655.1,51277300,52844914,52844915,A,AC,1
NC_037333.1,NC_032655.1,51498538,53050378,53050379,t,ta,1
NC_037333.1,NC_032655.1,51514003,53065842,53065843,c,ct,1
NC_037333.1,NC_032655.1,51527371,53079236,53079238,a,aat,2
NC_037333.1,NC_032655.1,51527386,53079253,53079254,a,aR,1
NC_037333.1,NC_032655.1,51528593,53080460,53080461,t,tc,1
NC_037333.1,NC_032655.1,51535787,53087643,53087644,a,at,1
NC_037333.1,NC_032655.1,51537435,53089443,53089444,C,CT,1
NC_037333.1,NC_032655.1,51539699,53091693,53091694,t,tg,1
NC_037333.1,NC_032655.1,51539943,53091938,53091939,t,tg,1
NC_037333.1,NC_032655.1,51541280,53093275,53093276,T,TC,1
NC_037333.1,NC_032655.1,51550233,53102220,53102221,A,AC,1
NC_037333.1,NC_032655.1,51550806,53102794,53102795,G,GT,1
NC_037333.1,NC_032655.1,51554791,53106853,53106855,c,cat,2
NC_037333.1,NC_032655.1,51561259,53113820,53113822,a,aag,2
NC_037333.1,NC_032655.1,51580421,53132981,53132982,t,tN,1
NC_037333.1,NC_032655.1,51580677,53133238,53133241,t,tata,3
NC_037333.1,NC_032655.1,51587370,53139933,53139934,C,CT,1
NC_037333.1,NC_032655.1,51587370,53176320,53176321,C,CT,1
NC_037333.1,NC_032655.1,51590941,53143506,53143507,g,gc,1
NC_037333.1,NC_032655.1,51641750,53222090,53222091,t,tN,1
NC_037333.1,NC_032655.1,51642960,53223295,53223296,a,ag,1
NC_037333.1,NC_032655.1,51677310,53257468,53257469,t,ta,1
NC_037333.1,NC_032655.1,51677311,53355746,53355748,t,tta,2
NC_037333.1,NC_032655.1,51696025,53276198,53276199,A,AN,1
NC_037333.1,NC_032655.1,51713780,53384022,53384028,t,tNNNNNN,6
NC_037333.1,NC_032655.1,51715119,53385367,53385368,c,ct,1
NC_037333.1,NC_032655.1,51716077,53386327,53386328,a,at,1
NC_037333.1,NC_032655.1,51742548,53412536,53412537,A,AC,1
NC_037333.1,NC_032655.1,51757945,53427938,53427940,a,aNN,2
NC_037333.1,NC_032655.1,51790210,53460204,53460206,t,tta,2
NC_037333.1,NC_032655.1,51812831,53482825,53482826,a,aN,1
NC_037333.1,NC_032655.1,51832931,53502964,53502973,a,acactgtttc,9
NC_037333.1,NC_032655.1,51837512,53507557,53507562,c,caataa,5
NC_037333.1,NC_032655.1,51838142,53508195,53508200,t,taggaa,5
NC_037333.1,NC_032655.1,51859693,53529493,53529501,A,AGTGGAGGC,8
NC_037333.1,NC_032655.1,51862057,53531858,53531862,A,AATAT,4
NC_037333.1,NC_032655.1,51867670,53537461,53537463,g,gta,2
NC_037333.1,NC_032655.1,51869620,53539703,53539704,T,TC,1
NC_037333.1,NC_032655.1,51873846,53543932,53543933,t,ta,1
NC_037333.1,NC_032655.1,51875742,53545829,53545845,A,ATCAAATNNNNNNNNNN,16
NC_037333.1,NC_032655.1,51875857,53545960,53545965,T,TAGAAG,5
NC_037333.1,NC_032655.1,51884369,53554488,53554496,t,ttaaaaaaa,8
NC_037333.1,NC_032655.1,51887178,53557303,53557304,g,gc,1
NC_037333.1,NC_032655.1,51888210,53558338,53558340,a,aaR,2
NC_037333.1,NC_032655.1,51888597,53558727,53558728,G,GR,1
NC_037333.1,NC_032655.1,51893897,53582846,53582848,t,taa,2
NC_037333.1,NC_032655.1,51905087,53594039,53594040,a,aM,1
NC_037333.1,NC_032655.1,51919259,53608213,53608214,c,ct,1
NC_037333.1,NC_032655.1,51922444,53611402,53611403,A,AG,1
NC_037333.1,NC_032655.1,51930488,53619448,53619449,t,tc,1
NC_037333.1,NC_032655.1,51930762,53619723,53619724,a,ag,1
NC_037333.1,NC_032655.1,51937032,53626320,53626328,g,gtttttttt,8
NC_037333.1,NC_032655.1,51986663,53685700,53685701,c,ct,1
NC_037333.1,NC_032655.1,52022190,53721217,53721219,t,tga,2
NC_037333.1,NC_032655.1,52023987,53723016,53723025,g,gggaaacagt,9
NC_037333.1,NC_032655.1,52030472,53730162,53730164,a,atc,2
NC_037333.1,NC_032655.1,52030555,53730247,53730248,a,ag,1
NC_037333.1,NC_032655.1,52061963,53765014,53765015,A,AG,1
NC_037333.1,NC_032655.1,52062902,53765953,53765954,t,ta,1
NC_037333.1,NC_032655.1,52136240,53839680,53839681,g,gc,1
NC_037333.1,NC_032655.1,52172151,53875597,53875598,c,ct,1
NC_037333.1,NC_032655.1,52261489,53965382,53965383,T,TC,1
NC_037333.1,NC_032655.1,52263044,53966938,53966939,t,ta,1
NC_037333.1,NC_032655.1,52282340,53986331,53986332,C,CA,1
NC_037333.1,NC_032655.1,52285222,53989212,53989219,a,agtattct,7
NC_037333.1,NC_032655.1,52285724,53989720,53989723,A,AAAT,3
NC_037333.1,NC_032655.1,52288883,53992457,53992464,t,ttaaaaaa,7
NC_037333.1,NC_032655.1,52289805,53993385,53993386,A,AC,1
NC_037333.1,NC_032655.1,52289807,53993388,53993389,T,TA,1
NC_037333.1,NC_032655.1,52291296,53994873,53994874,c,ca,1
NC_037333.1,NC_032655.1,52297120,54000962,54000963,c,ca,1
NC_037333.1,NC_032655.1,52300381,54004220,54004234,t,taacagaaaaaaaaa,14
NC_037333.1,NC_032655.1,52318393,54022253,54022255,C,CCA,2
NC_037333.1,NC_032655.1,52333254,54037116,54037117,C,CA,1
NC_037333.1,NC_032655.1,52336146,54040012,54040013,T,TA,1
NC_037333.1,NC_032655.1,52336151,54040018,54040019,G,GA,1
NC_037333.1,NC_032655.1,52386515,54152894,54152895,a,ag,1
NC_037333.1,NC_032655.1,52409924,54176305,54176306,g,ga,1
NC_037333.1,NC_032655.1,52518821,54283682,54283683,C,CA,1
NC_037333.1,NC_032655.1,52609663,54373413,54373414,C,CG,1
NC_037333.1,NC_032655.1,52732848,54497076,54497077,T,TA,1
NC_037333.1,NC_032655.1,52743975,54508077,54508078,t,tc,1
NC_037333.1,NC_032655.1,52811413,54575313,54575314,t,tW,1
NC_037333.1,NC_032655.1,52852575,54619525,54619547,a,atgcagagtacatcatgagaaat,22
NC_037333.1,NC_032655.1,52870563,54637526,54637528,a,aag,2
NC_037333.1,NC_032655.1,52880780,54647750,54647757,a,accctcct,7
NC_037333.1,NC_032655.1,52885276,54652250,54652251,C,CY,1
NC_037333.1,NC_032655.1,52889223,54656205,54656206,C,CY,1
NC_037333.1,NC_032655.1,52891174,54658160,54658161,G,GT,1
NC_037333.1,NC_032655.1,52891485,54658472,54658473,C,CY,1
NC_037333.1,NC_032655.1,52891969,54659005,54659006,C,CS,1
NC_037333.1,NC_032655.1,52902457,54673103,54673108,T,TTATAA,5
NC_037333.1,NC_032655.1,52931761,54702148,54702152,c,ccttt,4
NC_037333.1,NC_032655.1,52961405,54731792,54731793,a,at,1
NC_037333.1,NC_032655.1,52963808,54734196,54734197,a,at,1
NC_037333.1,NC_032655.1,52994889,54793077,54793099,A,ATTTTTACCCGTCTCTGCTTTTT,22
NC_037333.1,NC_032655.1,53020694,54818793,54818795,t,tNN,2
NC_037333.1,NC_032655.1,53034321,54831902,54831903,a,ac,1
NC_037333.1,NC_032655.1,53275103,55080067,55080069,a,aNN,2
NC_037333.1,NC_032655.1,53301986,55106973,55106975,c,cct,2
NC_037333.1,NC_032655.1,53301989,55106978,55106980,c,caa,2
NC_037333.1,NC_032655.1,53394683,55199718,55199719,G,GA,1
NC_037333.1,NC_032655.1,53398927,55203964,55203966,c,caa,2
NC_037333.1,NC_032655.1,53424226,55229270,55229271,t,ta,1
NC_037333.1,NC_032655.1,53465556,55270612,55270613,A,AT,1
NC_037333.1,NC_032655.1,53477898,55282963,55282964,g,gt,1
NC_037333.1,NC_032655.1,53488869,55293938,55293944,t,tacatga,6
NC_037333.1,NC_032655.1,53492628,55297678,55297679,c,ct,1
NC_037333.1,NC_032655.1,53512048,55317115,55317116,a,ag,1
NC_037333.1,NC_032655.1,53525231,55330305,55330306,c,ct,1
NC_037333.1,NC_032655.1,53584737,55389957,55389962,t,taaaaa,5
NC_037333.1,NC_032655.1,53585228,55390453,55390454,a,ac,1
NC_037333.1,NC_032655.1,53654764,55460024,55460028,a,acagt,4
NC_037333.1,NC_032655.1,53658473,55463737,55463738,a,at,1
NC_037333.1,NC_032655.1,53658850,55464115,55464116,t,ta,1
NC_037333.1,NC_032655.1,53695569,55500828,55500829,A,AC,1
NC_037333.1,NC_032655.1,53696647,55501907,55501909,c,cat,2
NC_037333.1,NC_032655.1,53702911,55508181,55508182,C,CY,1
NC_037333.1,NC_032655.1,53715405,55520679,55520680,g,ga,1
NC_037333.1,NC_032655.1,53717113,55522389,55522390,a,at,1
NC_037333.1,NC_032655.1,53734549,55539835,55539836,A,AR,1
NC_037333.1,NC_032655.1,53747422,55552711,55552716,a,atatat,5
NC_037333.1,NC_032655.1,53754963,55560159,55560160,c,ca,1
NC_037333.1,NC_032655.1,53762931,55568128,55568129,G,GS,1
NC_037333.1,NC_032655.1,53776553,55587378,55587387,A,ATCAAAAGTT,9
NC_037333.1,NC_032655.1,53779480,55590294,55590295,T,TW,1
NC_037333.1,NC_032655.1,53886090,55696502,55696503,g,ga,1
NC_037333.1,NC_032655.1,53946101,55756512,55756517,A,AACACC,5
NC_037333.1,NC_032655.1,53983570,55797774,55797775,a,at,1
NC_037333.1,NC_032655.1,54031730,55845935,55845937,t,taa,2
NC_037333.1,NC_032655.1,54141409,55993322,55993323,A,AC,1
NC_037333.1,NC_032655.1,54151308,56003223,56003226,C,CAAY,3
NC_037333.1,NC_032655.1,54167109,56019031,56019032,a,at,1
NC_037333.1,NC_032655.1,54181323,56033248,56033250,t,tta,2
NC_037333.1,NC_032655.1,54191834,56043771,56043772,t,tc,1
NC_037333.1,NC_032655.1,54202369,56054307,56054308,t,tg,1
NC_037333.1,NC_032655.1,54208238,56060181,56060182,t,ta,1
NC_037333.1,NC_032655.1,54213001,56064946,56064947,A,AG,1
NC_037333.1,NC_032655.1,54220005,56071956,56071957,A,AT,1
NC_037333.1,NC_032655.1,54279607,56127989,56127991,t,tNN,2
NC_037333.1,NC_032655.1,54377942,56366544,56366545,A,AG,1
NC_037333.1,NC_032655.1,54380008,56368606,56368612,g,gtgtgtt,6
NC_037333.1,NC_032655.1,54384895,56373501,56373502,t,tg,1
NC_037333.1,NC_032655.1,54387205,56375816,56375817,a,aM,1
NC_037333.1,NC_032655.1,54397760,56386376,56386377,t,tc,1
NC_037333.1,NC_032655.1,54397787,56386404,56386405,c,ct,1
NC_037333.1,NC_032655.1,54397809,56386427,56386428,a,ac,1
NC_037333.1,NC_032655.1,54397841,56386460,56386461,a,ag,1
NC_037333.1,NC_032655.1,54397876,56386496,56386497,t,tg,1
NC_037333.1,NC_032655.1,54427458,56246667,56246668,A,AG,1
NC_037333.1,NC_032655.1,54427458,56422542,56422543,A,AG,1
NC_037333.1,NC_032655.1,54487263,56482904,56482905,a,ag,1
NC_037333.1,NC_032655.1,54579694,56576290,56576300,a,aNNNNNNNNNN,10
NC_037333.1,NC_032655.1,54621070,56618254,56618255,c,ca,1
NC_037333.1,NC_032655.1,54623066,56620252,56620253,A,AC,1
NC_037333.1,NC_032655.1,54625268,56622456,56622458,a,aag,2
NC_037333.1,NC_032655.1,54629012,56626204,56626208,A,AAAGT,4
NC_037333.1,NC_032655.1,54638509,56635703,56635704,t,tg,1
NC_037333.1,NC_032655.1,54692314,56701736,56701737,T,TK,1
NC_037333.1,NC_032655.1,54723330,56729823,56729825,A,AGT,2
NC_037333.1,NC_032655.1,54723613,56730108,56730109,t,tc,1
NC_037333.1,NC_032655.1,54727275,56733767,56733768,t,tc,1
NC_037333.1,NC_032655.1,54768649,56775796,56775798,g,gtc,2
NC_037333.1,NC_032655.1,54777037,56785241,56785266,C,CTCTTCTGTGCCCCTTCTTAGGGGCA,25
NC_037333.1,NC_032655.1,54796101,56804320,56804321,a,aR,1
NC_037333.1,NC_032655.1,54802267,56810488,56810491,A,ACAT,3
NC_037333.1,NC_032655.1,54802789,56811013,56811017,C,CTGAT,4
NC_037333.1,NC_032655.1,54823902,56832147,56832151,t,ttaaa,4
NC_037333.1,NC_032655.1,54859232,56867496,56867499,t,tttg,3
NC_037333.1,NC_032655.1,54887635,57116891,57116892,t,tg,1
NC_037333.1,NC_032655.1,54888371,57117628,57117629,A,AC,1
NC_037333.1,NC_032655.1,54923313,57153845,57153846,C,CT,1
NC_037333.1,NC_032655.1,54923717,57154250,57154251,A,AC,1
NC_037333.1,NC_032655.1,54928012,57158551,57158563,g,gagagggagagga,12
NC_037333.1,NC_032655.1,54949587,57039027,57039029,c,ctt,2
NC_037333.1,NC_032655.1,54978703,57068137,57068139,a,att,2
NC_037333.1,NC_032655.1,54979407,57068845,57068846,c,cY,1
NC_037333.1,NC_032655.1,54979435,57068874,57068875,g,ga,1
NC_037333.1,NC_032655.1,54979757,57069211,57069212,c,ct,1
NC_037333.1,NC_032655.1,54979771,57069226,57069227,c,ct,1
NC_037333.1,NC_032655.1,54980523,57069979,57069980,C,CY,1
NC_037333.1,NC_032655.1,55018606,57187628,57187629,t,tg,1
NC_037333.1,NC_032655.1,55040863,57209888,57209889,A,AG,1
NC_037333.1,NC_032655.1,55041207,57210233,57210235,t,ttc,2
NC_037333.1,NC_032655.1,55193278,57362346,57362347,A,AT,1
NC_037333.1,NC_032655.1,55225776,57397343,57397344,g,gt,1
NC_037333.1,NC_032655.1,55285691,57456892,57456893,T,TG,1
NC_037333.1,NC_032655.1,55294295,57464021,57464022,G,GA,1
NC_037333.1,NC_032655.1,55295062,57464788,57464810,C,CTTTACTCCTTGACTCACATTAT,22
NC_037333.1,NC_032655.1,55336341,57506082,57506084,C,CAG,2
NC_037333.1,NC_032655.1,55374873,57553851,57553852,g,ga,1
NC_037333.1,NC_032655.1,55411520,57536451,57536452,t,tc,1
NC_037333.1,NC_032655.1,55411520,57590736,57590737,t,tc,1
NC_037333.1,NC_032655.1,55411615,57536547,57536549,t,tga,2
NC_037333.1,NC_032655.1,55411615,57590832,57590834,t,tga,2
NC_037333.1,NC_032655.1,55411926,57536860,57536861,t,tg,1
NC_037333.1,NC_032655.1,55416262,57595481,57595482,t,tN,1
NC_037333.1,NC_032655.1,55437431,57616644,57616645,T,TA,1
NC_037333.1,NC_032655.1,55437434,57616648,57616649,T,TG,1
NC_037333.1,NC_032655.1,55678886,57760718,57760719,A,AC,1
NC_037333.1,NC_032655.1,55683914,57765747,57765751,T,TTGAC,4
NC_037333.1,NC_032655.1,55688551,57770382,57770383,t,tc,1
NC_037333.1,NC_032655.1,55694340,57947666,57947668,t,tNN,2
NC_037333.1,NC_032655.1,55694344,57776176,57776178,t,tNN,2
NC_037333.1,NC_032655.1,55711848,57965176,57965177,a,aW,1
NC_037333.1,NC_032655.1,55785884,58039048,58039049,c,cW,1
NC_037333.1,NC_032655.1,55890835,58144004,58144006,t,tta,2
NC_037333.1,NC_032655.1,56203109,58496950,58496951,t,tg,1
NC_037333.1,NC_032655.1,56350893,58643362,58643363,g,gt,1
NC_037333.1,NC_032655.1,56366847,58659317,58659318,c,ct,1
NC_037333.1,NC_032655.1,56388916,58681376,58681378,c,cta,2
NC_037333.1,NC_032655.1,56621968,58923158,58923159,A,AR,1
NC_037333.1,NC_032655.1,56932029,59230913,59230915,A,AGT,2
NC_037333.1,NC_032655.1,57013312,59311844,59311845,T,TC,1
NC_037333.1,NC_032655.1,57042954,59341397,59341399,c,cat,2
NC_037333.1,NC_032655.1,57045989,59344434,59344450,A,ANNNNNNNNNNNNNNNN,16
NC_037333.1,NC_032655.1,57486966,59864089,59864091,g,gga,2
NC_037333.1,NC_032655.1,57487003,59864129,59864130,g,gt,1
NC_037333.1,NC_032655.1,57513582,59890694,59890709,c,cctggaaattctcgag,15
NC_037333.1,NC_032655.1,57513650,59890777,59890778,c,cg,1
NC_037333.1,NC_032655.1,57520324,59897451,59897453,c,cta,2
NC_037333.1,NC_032655.1,57521039,59898173,59898179,t,tcacatA,6
NC_037333.1,NC_032655.1,57661218,60037653,60037654,T,TA,1
NC_037333.1,NC_032655.1,57790105,60166979,60166980,T,TA,1
NC_037333.1,NC_032655.1,58067777,60453337,60453338,A,AR,1
NC_037333.1,NC_032655.1,58081742,60467438,60467443,T,TAGTTG,5
NC_037333.1,NC_032655.1,58082014,60467714,60467715,C,CA,1
NC_037333.1,NC_032655.1,58082022,60467723,60467724,T,TW,1
NC_037333.1,NC_032655.1,58115267,60499831,60499832,C,CT,1
NC_037333.1,NC_032655.1,58259380,60643942,60643943,T,TA,1
NC_037333.1,NC_032655.1,58440878,60892521,60892522,a,at,1
NC_037333.1,NC_032655.1,58538328,60995388,60995389,a,at,1
NC_037333.1,NC_032655.1,58548563,61005624,61005625,C,CM,1
NC_037333.1,NC_032655.1,58604971,61066111,61066112,a,ag,1
NC_037333.1,NC_032655.1,58622107,61083249,61083250,t,tg,1
NC_037333.1,NC_032655.1,58681468,61142613,61142614,g,gK,1
NC_037333.1,NC_032655.1,58871124,61332750,61332751,a,ag,1
NC_037333.1,NC_032655.1,59103490,61560559,61560560,C,CS,1
NC_037333.1,NC_032655.1,59220580,61678945,61678946,T,TA,1
NC_037333.1,NC_032655.1,59281112,61739475,61739476,t,ta,1
NC_037333.1,NC_032655.1,59339670,61798322,61798329,a,accctcct,7
NC_037333.1,NC_032655.1,59445204,61905602,61905605,a,atat,3
NC_037333.1,NC_032655.1,59826587,62298098,62298100,A,AAG,2
NC_037333.1,NC_032655.1,59831232,62302885,62302891,G,GRTCACR,6
NC_037333.1,NC_032655.1,59831273,62302932,62302933,C,CT,1
NC_037333.1,NC_032655.1,59836673,62308333,62308336,g,gtgt,3
NC_037333.1,NC_032655.1,59850599,62322257,62322258,c,ct,1
NC_037333.1,NC_032655.1,59853304,62324962,62324992,A,AGCAATGTTTNNNNNNNNNNNNNNNNNTTGT,30
NC_037333.1,NC_032655.1,59861315,62333002,62333003,C,CT,1
NC_037333.1,NC_032655.1,59867497,62339188,62339196,T,TTCATTTAG,8
NC_037333.1,NC_032655.1,59867509,62339208,62339209,T,TA,1
NC_037333.1,NC_032655.1,59868818,62340519,62340520,t,tY,1
NC_037333.1,NC_032655.1,59869590,62341278,62341279,A,AG,1
NC_037333.1,NC_032655.1,59931779,62403469,62403470,t,ta,1
NC_037333.1,NC_032655.1,60040562,62512034,62512036,T,TTA,2
NC_037333.1,NC_032655.1,60083022,62554520,62554521,G,GR,1
NC_037333.1,NC_032655.1,60189390,62660905,62660917,G,GGTctggtaatat,12
NC_037333.1,NC_032655.1,60219768,62691268,62691269,T,TY,1
NC_037333.1,NC_032655.1,60251935,62737795,62737801,g,gactatc,6
NC_037333.1,NC_032655.1,60254554,62740425,62740426,A,AG,1
NC_037333.1,NC_032655.1,60278502,62764450,62764452,G,GAA,2
NC_037333.1,NC_032655.1,60308065,62794015,62794019,C,CTGAA,4
NC_037333.1,NC_032655.1,60327834,62813792,62813793,a,at,1
NC_037333.1,NC_032655.1,60339704,62825658,62825660,c,cat,2
NC_037333.1,NC_032655.1,60431226,62917196,62917217,T,TTGGGGAGTGGCCTTTGAACTG,21
NC_037333.1,NC_032655.1,60450703,62936732,62936735,A,AGTW,3
NC_037333.1,NC_032655.1,60524010,63010088,63010111,T,TACACTCAGCACTCACTAAATGTC,23
NC_037333.1,NC_032655.1,60547842,63033954,63033956,t,tac,2
NC_037333.1,NC_032655.1,60625451,63111570,63111571,a,ac,1
NC_037333.1,NC_032655.1,60748580,63235557,63235558,A,AR,1
NC_037333.1,NC_032655.1,60772772,63259730,63259743,G,GTATCCAACTCGGK,13
NC_037333.1,NC_032655.1,60786884,63273874,63273875,a,ag,1
NC_037333.1,NC_032655.1,60794904,63281925,63281932,c,ctttcact,7
NC_037333.1,NC_032655.1,60825548,63519726,63519728,C,CTG,2
NC_037333.1,NC_032655.1,60825548,63312274,63312276,C,CTG,2
NC_037333.1,NC_032655.1,60901288,63595488,63595489,C,CT,1
NC_037333.1,NC_032655.1,60909783,63603985,63603986,a,ag,1
NC_037333.1,NC_032655.1,60909783,63369738,63369739,a,ag,1
NC_037333.1,NC_032655.1,60934672,63394944,63394947,c,cctg,3
NC_037333.1,NC_032655.1,60974566,63434833,63434834,c,ca,1
NC_037333.1,NC_032655.1,60978301,63438572,63438573,T,TK,1
NC_037333.1,NC_032655.1,60981536,63441808,63441810,A,AAC,2
NC_037333.1,NC_032655.1,61052676,63701143,63701144,t,tc,1
NC_037333.1,NC_032655.1,61064859,63713330,63713331,G,GR,1
NC_037333.1,NC_032655.1,61086186,63734663,63734664,A,AK,1
NC_037333.1,NC_032655.1,61241135,63906739,63906740,A,AG,1
NC_037333.1,NC_032655.1,61241720,63907327,63907328,t,ta,1
NC_037333.1,NC_032655.1,61527399,64116915,64116917,a,agt,2
NC_037333.1,NC_032655.1,61566153,64155690,64155694,c,ctttt,4
NC_037333.1,NC_032655.1,61578010,64167545,64167546,t,tc,1
NC_037333.1,NC_032655.1,61579723,64169260,64169261,a,ag,1
NC_037333.1,NC_032655.1,61582172,64171710,64171711,A,AG,1
NC_037333.1,NC_032655.1,61594307,64183709,64183710,a,at,1
NC_037333.1,NC_032655.1,61645717,64235132,64235137,g,gttttt,5
NC_037333.1,NC_032655.1,61657706,64246595,64246597,c,cat,2
NC_037333.1,NC_032655.1,61794885,64383742,64383743,a,aM,1
NC_037333.1,NC_032655.1,61966165,64557499,64557503,c,cYata,4
NC_037333.1,NC_032655.1,62265873,64854255,64854256,a,ag,1
NC_037333.1,NC_032655.1,62389661,64979065,64979101,t,tNNNNNNNNNNNNNNNNNNNNNNNNNNNNNNNNNNNN,36
NC_037333.1,NC_032655.1,62494130,65109636,65109647,g,gttttttttttt,11
NC_037333.1,NC_032655.1,62600773,65216290,65216291,G,GT,1
NC_037333.1,NC_032655.1,62840136,65703444,65703445,g,gt,1
NC_037333.1,NC_032655.1,62873657,65736977,65736979,A,AAT,2
NC_037333.1,NC_032655.1,62874238,65737560,65737561,T,TA,1
NC_037333.1,NC_032655.1,62878829,65742151,65742153,a,aat,2
NC_037333.1,NC_032655.1,62884216,65747538,65747545,c,cagcagca,7
NC_037333.1,NC_032655.1,62889681,65753028,65753029,t,tg,1
NC_037333.1,NC_032655.1,62890910,65754259,65754260,T,TC,1
NC_037333.1,NC_032655.1,62892235,65755585,65755586,g,gc,1
NC_037333.1,NC_032655.1,62892972,65756343,65756344,T,TC,1
NC_037333.1,NC_032655.1,62902450,65765809,65765810,A,AT,1
NC_037333.1,NC_032655.1,62917950,65781304,65781328,C,CTTAGTGAAACTTAAGGAAATTCAG,24
NC_037333.1,NC_032655.1,62940794,65804176,65804194,T,TATCAATACCCAGGTATTG,18
NC_037333.1,NC_032655.1,62946435,65809832,65809835,C,CAAT,3
NC_037333.1,NC_032655.1,62949961,65813360,65813361,t,ta,1
NC_037333.1,NC_032655.1,63017187,65880601,65880602,G,GA,1
NC_037333.1,NC_032655.1,63105325,65968842,65968843,C,CT,1
NC_037333.1,NC_032655.1,63115195,65978717,65978745,g,gcattactgacaaaatggaggcacggtcc,28
NC_037333.1,NC_032655.1,63146327,66000770,66000771,T,TC,1
NC_037333.1,NC_032655.1,63147292,66001736,66001737,A,AR,1
NC_037333.1,NC_032655.1,63168454,66018534,66018535,a,ag,1
NC_037333.1,NC_032655.1,63173331,66023412,66023426,C,CTTTTGAACCTAAAA,14
NC_037333.1,NC_032655.1,63251557,66101872,66101873,g,gt,1
NC_037333.1,NC_032655.1,63255693,66106006,66106008,a,aNN,2
NC_037333.1,NC_032655.1,63298257,66148590,66148595,T,TTAAGA,5
NC_037333.1,NC_032655.1,63365099,66214816,66214818,a,acg,2
NC_037333.1,NC_032655.1,63401402,66251736,66251737,c,ca,1
NC_037333.1,NC_032655.1,64040547,66492653,66492654,G,GA,1
NC_037333.1,NC_032655.1,64044544,66496518,66496519,a,aN,1
NC_037333.1,NC_032655.1,64047040,66499015,66499016,A,AW,1
NC_037333.1,NC_032655.1,64057749,66509730,66509731,t,tg,1
NC_037333.1,NC_032655.1,64070733,66522947,66522948,t,tc,1
NC_037333.1,NC_032655.1,64070855,66523070,66523071,c,ct,1
NC_037333.1,NC_032655.1,64075100,66527315,66527319,t,tggag,4
NC_037333.1,NC_032655.1,64093166,66545388,66545389,C,CT,1
NC_037333.1,NC_032655.1,64176838,66632398,66632401,A,AAAT,3
NC_037333.1,NC_032655.1,64201470,66657046,66657047,T,TA,1
NC_037333.1,NC_032655.1,64245991,66702263,66702264,C,CY,1
NC_037333.1,NC_032655.1,64255088,66711374,66711375,t,tc,1
NC_037333.1,NC_032655.1,64303395,66759242,66759243,a,at,1
NC_037333.1,NC_032655.1,64323775,66779638,66779639,c,ca,1
NC_037333.1,NC_032655.1,64359168,66815046,66815047,c,ct,1
NC_037333.1,NC_032655.1,64419213,66867185,66867186,g,ga,1
NC_037333.1,NC_032655.1,64422195,66870170,66870171,A,AG,1
NC_037333.1,NC_032655.1,64479747,66927859,66927860,A,AC,1
NC_037333.1,NC_032655.1,64495839,66943953,66943954,g,gt,1
NC_037333.1,NC_032655.1,64516714,66964825,66964826,a,at,1
NC_037333.1,NC_032655.1,64538151,66986260,66986270,T,TATTAGTTATA,10
NC_037333.1,NC_032655.1,64552629,67000748,67000758,c,cgtacaccggg,10
NC_037333.1,NC_032655.1,64570987,67019104,67019105,A,AC,1
NC_037333.1,NC_032655.1,64578974,67027094,67027095,t,tg,1
NC_037333.1,NC_032655.1,64578976,67027097,67027098,c,cg,1
NC_037333.1,NC_032655.1,64579077,67027199,67027202,a,aagc,3
NC_037333.1,NC_032655.1,64581870,67029986,67029992,c,cctattt,6
NC_037333.1,NC_032655.1,64582920,67031042,67031043,A,AC,1
NC_037333.1,NC_032655.1,64584831,67032956,67032957,T,TC,1
NC_037333.1,NC_032655.1,64592062,67040490,67040491,c,ct,1
NC_037333.1,NC_032655.1,64653045,67102012,67102014,t,tNN,2
NC_037333.1,NC_032655.1,64662316,67111286,67111287,T,TW,1
NC_037333.1,NC_032655.1,64729943,67189280,67189281,c,ct,1
NC_037333.1,NC_032655.1,64730395,67189734,67189735,a,at,1
NC_037333.1,NC_032655.1,64735958,67195296,67195297,g,gc,1
NC_037333.1,NC_032655.1,64757424,67216768,67216782,t,tNNNNNNNNNNNNNN,14
NC_037333.1,NC_032655.1,64787070,67246431,67246443,g,gattttttttaat,12
NC_037333.1,NC_032655.1,64853067,67312644,67312662,c,ctctttgcgaccccatgaa,18
NC_037333.1,NC_032655.1,64860308,67319903,67319904,a,ag,1
NC_037333.1,NC_032655.1,64861030,67320627,67320628,c,ct,1
NC_037333.1,NC_032655.1,64953470,67413706,67413716,T,TGAGATCAACG,10
NC_037333.1,NC_032655.1,65079910,67539457,67539459,C,CCA,2
NC_037333.1,NC_032655.1,65111118,67570672,67570673,c,ca,1
NC_037333.1,NC_032655.1,65112633,67572190,67572191,g,ga,1
NC_037333.1,NC_032655.1,65112785,67572343,67572345,g,gcc,2
NC_037333.1,NC_032655.1,65127589,67587175,67587176,T,TA,1
NC_037333.1,NC_032655.1,65299993,67763837,67763838,c,ca,1
NC_037333.1,NC_032655.1,65344656,67814112,67814114,A,AAM,2
NC_037333.1,NC_032655.1,65367772,67837055,67837056,C,CM,1
NC_037333.1,NC_032655.1,65385084,67854368,67854369,G,GA,1
NC_037333.1,NC_032655.1,65387267,67856553,67856555,t,taa,2
NC_037333.1,NC_032655.1,65393816,67863086,67863087,g,ga,1
NC_037333.1,NC_032655.1,65422106,67891374,67891375,a,at,1
NC_037333.1,NC_032655.1,65447757,67916279,67916280,c,ct,1
NC_037333.1,NC_032655.1,65449301,67917826,67917827,c,ct,1
NC_037333.1,NC_032655.1,65455920,67924026,67924027,g,gc,1
NC_037333.1,NC_032655.1,65460794,67928899,67928911,t,tgcgggggggggg,12
NC_037333.1,NC_032655.1,65480120,67948238,67948239,g,gt,1
NC_037333.1,NC_032655.1,65565476,68033676,68033677,A,AG,1
NC_037333.1,NC_032655.1,65616679,68084762,68084765,a,aaac,3
NC_037333.1,NC_032655.1,65616679,68132891,68132894,a,aaac,3
NC_037333.1,NC_032655.1,65617095,68085181,68085243,g,gaaggaaatggNNNNNNNNNNNNNNNNNNNNNNNNNNNNNNNNNNNNNNTTTTCAAAGaactt,62
NC_037333.1,NC_032655.1,65654081,68158141,68158145,A,ANNNN,4
NC_037333.1,NC_032655.1,65758356,68262521,68262523,c,ctt,2
NC_037333.1,NC_032655.1,65804300,68307366,68307370,t,tNNNN,4
NC_037333.1,NC_032655.1,65906221,68460799,68460801,t,tNN,2
NC_037333.1,NC_032655.1,65991173,68545771,68545772,t,tc,1
NC_037333.1,NC_032655.1,66001013,68555612,68555613,A,AR,1
NC_037333.1,NC_032655.1,66052989,68629888,68629890,t,tNN,2
NC_037333.1,NC_032655.1,66123688,68700643,68700646,C,CCTG,3
NC_037333.1,NC_032655.1,66126951,68703937,68703938,A,AG,1
NC_037333.1,NC_032655.1,66127690,68704687,68704688,T,TA,1
NC_037333.1,NC_032655.1,66269049,68872431,68872432,t,tg,1
NC_037333.1,NC_032655.1,66280784,68884167,68884168,t,tc,1
NC_037333.1,NC_032655.1,66367553,68971093,68971101,T,TNNNNNNNN,8
NC_037333.1,NC_032655.1,66430273,69036583,69036584,g,gc,1
NC_037333.1,NC_032655.1,66430500,69036811,69036812,a,ac,1
NC_037333.1,NC_032655.1,66600284,69208301,69208302,c,ct,1
NC_037333.1,NC_032655.1,66619674,69228647,69228648,t,tc,1
NC_037333.1,NC_032655.1,67289144,69948907,69948908,A,AT,1
NC_037333.1,NC_032655.1,67398403,70059663,70059665,c,caa,2
NC_037333.1,NC_032655.1,67470993,70830328,70830329,A,AR,1
NC_037333.1,NC_032655.1,67941015,70589439,70589440,T,TC,1
NC_037333.1,NC_032655.1,68021230,70669827,70669829,t,tNN,2
NC_037333.1,NC_032655.1,68073342,70722681,70722682,C,CY,1
NC_037333.1,NC_032655.1,68120680,70770027,70770028,t,tg,1
NC_037333.1,NC_032655.1,68658091,71368709,71368744,G,GNNNNNNNNNNNNNNNNNNNNNNNNNNNNNNNNNNN,35
NC_037333.1,NC_032655.1,68695136,71405393,71405394,a,aN,1
NC_037333.1,NC_032655.1,68772390,71483997,71483998,G,GA,1
NC_037333.1,NC_032655.1,68772407,71484015,71484016,G,GA,1
NC_037333.1,NC_032655.1,68772551,71484160,71484161,T,TA,1
NC_037333.1,NC_032655.1,68788371,71499848,71499849,G,GR,1
NC_037333.1,NC_032655.1,68805350,71516829,71516830,t,tc,1
NC_037333.1,NC_032655.1,68874709,71585850,71585851,C,CG,1
NC_037333.1,NC_032655.1,68925866,71637009,71637010,c,ca,1
NC_037333.1,NC_032655.1,69658765,72303164,72303167,C,CTCT,3
NC_037333.1,NC_032655.1,69696823,72352896,72352898,t,ttc,2
NC_037333.1,NC_032655.1,69965087,72625429,72625430,C,CG,1
NC_037333.1,NC_032655.1,70347550,73002852,73002853,T,TK,1
NC_037333.1,NC_032655.1,70373272,73029160,73029178,C,CATNNNNNNNNNNNNNNNN,18
NC_037333.1,NC_032655.1,70446170,73102077,73102078,c,ct,1
NC_037333.1,NC_032655.1,70460524,73122155,73122156,A,AC,1
NC_037333.1,NC_032655.1,70551453,73212854,73212855,c,ca,1
NC_037333.1,NC_032655.1,70621864,73284072,73284073,g,ga,1
NC_037333.1,NC_032655.1,70727344,73389503,73389504,t,tc,1
NC_037333.1,NC_032655.1,70729669,73391829,73391830,G,GA,1
NC_037333.1,NC_032655.1,70746783,73408940,73408941,T,TC,1
NC_037333.1,NC_032655.1,70746830,73408988,73408990,C,CGA,2
NC_037333.1,NC_032655.1,70760399,73422557,73422558,a,ac,1
NC_037333.1,NC_032655.1,70767718,73429878,73429879,A,AG,1
NC_037333.1,NC_032655.1,70808314,73470135,73470136,a,ag,1
NC_037333.1,NC_032655.1,70899472,73561539,73561540,T,TG,1
NC_037333.1,NC_032655.1,71121134,73765732,73765733,A,AR,1
NC_037333.1,NC_032655.1,71129922,73774519,73774520,c,ct,1
NC_037333.1,NC_032655.1,71133026,73777623,73777624,c,ct,1
NC_037333.1,NC_032655.1,71136314,73780910,73780916,c,ccatgga,6
NC_037333.1,NC_032655.1,71141484,73786101,73786102,T,TA,1
NC_037333.1,NC_032655.1,71315817,73959555,73959565,t,ttaaaaaaaaa,10
NC_037333.1,NC_032655.1,71319003,73962751,73962756,t,ttatac,5
NC_037333.1,NC_032655.1,71324977,73968729,73968730,T,TY,1
NC_037333.1,NC_032655.1,71345987,73989728,73989729,G,GC,1
NC_037333.1,NC_032655.1,71357605,74001352,74001353,T,TN,1
NC_037333.1,NC_032655.1,71370287,74014041,74014043,T,TTA,2
NC_037333.1,NC_032655.1,71373428,74017185,74017199,t,tacacacacacacac,14
NC_037333.1,NC_032655.1,71394021,74037760,74037761,G,GT,1
NC_037333.1,NC_032655.1,71446769,74090543,74090544,c,ca,1
NC_037333.1,NC_032655.1,71448486,74092261,74092262,t,tg,1
NC_037333.1,NC_032655.1,71497436,74141239,74141240,G,GR,1
NC_037333.1,NC_032655.1,71498666,74142468,74142471,A,AACC,3
NC_037333.1,NC_032655.1,71502193,74145996,74145997,g,ga,1
NC_037333.1,NC_032655.1,71511413,74155258,74155260,a,agt,2
NC_037333.1,NC_032655.1,71545949,74189801,74189802,G,GA,1
NC_037333.1,NC_032655.1,71563460,74207332,74207333,t,tg,1
NC_037333.1,NC_032655.1,71566774,74210649,74210650,T,TC,1
NC_037333.1,NC_032655.1,71569674,74213550,74213552,t,ttg,2
NC_037333.1,NC_032655.1,71580702,74224577,74224580,C,CTGA,3
NC_037333.1,NC_032655.1,71603610,74247487,74247490,t,taaa,3
NC_037333.1,NC_032655.1,71614364,74258234,74258235,c,ct,1
NC_037333.1,NC_032655.1,71616991,74260861,74260862,A,AR,1
NC_037333.1,NC_032655.1,71646122,74289979,74289980,c,ct,1
NC_037333.1,NC_032655.1,71661360,74305210,74305211,t,tg,1
NC_037333.1,NC_032655.1,71674845,74318696,74318700,A,AATAG,4
NC_037333.1,NC_032655.1,71756467,74407198,74407226,A,ACAYAGTTTTAAANNNNNNNNNNNNNNNN,28
NC_037333.1,NC_032655.1,71809220,74459980,74459982,t,ttc,2
NC_037333.1,NC_032655.1,71915922,74566617,74566618,G,GT,1
NC_037333.1,NC_032655.1,71940149,74590853,74590854,A,AG,1
NC_037333.1,NC_032655.1,71979300,74630001,74630003,c,caa,2
NC_037333.1,NC_032655.1,72001761,74652465,74652467,c,cat,2
NC_037333.1,NC_032655.1,72079458,74730118,74730119,T,TC,1
NC_037333.1,NC_032655.1,72158329,74887861,74887864,t,tctc,3
NC_037333.1,NC_032655.1,72173063,74902658,74902659,A,AC,1
NC_037333.1,NC_032655.1,72177238,74906834,74906841,G,GACCCACC,7
NC_037333.1,NC_032655.1,72196041,74925643,74925644,T,TA,1
NC_037333.1,NC_032655.1,72217927,74947534,74947558,c,cgtgtttgtttgtgtgtgtgtgtgt,24
NC_037333.1,NC_032655.1,72293261,75022944,75022945,g,ga,1
NC_037333.1,NC_032655.1,72301461,75031132,75031138,c,cacacat,6
NC_037333.1,NC_032655.1,72338634,75068328,75068329,G,GK,1
NC_037333.1,NC_032655.1,72339951,75069645,75069648,T,TGTC,3
NC_037333.1,NC_032655.1,72346344,75076047,75076048,c,ca,1
NC_037333.1,NC_032655.1,72346413,75076117,75076119,a,act,2
NC_037333.1,NC_032655.1,72346608,75076314,75076323,a,acactgtttc,9
NC_037333.1,NC_032655.1,72373870,75103598,75103601,a,aaat,3
NC_037333.1,NC_032655.1,72385169,75114903,75114908,G,GTTTAC,5
NC_037333.1,NC_032655.1,72400546,75130321,75130323,c,cct,2
NC_037333.1,NC_032655.1,72419841,75149630,75149631,t,ta,1
NC_037333.1,NC_032655.1,72487684,75218356,75218358,g,gta,2
NC_037333.1,NC_032655.1,72543090,75273773,75273774,C,CY,1
NC_037333.1,NC_032655.1,72551684,75282368,75282369,G,GT,1
NC_037333.1,NC_032655.1,72557792,75288477,75288478,A,AC,1
NC_037333.1,NC_032655.1,72579843,75310531,75310543,t,tagcatattcaaa,12
NC_037333.1,NC_032655.1,72610134,75340841,75340844,t,tagc,3
NC_037333.1,NC_032655.1,72678126,75409290,75409291,G,GA,1
NC_037333.1,NC_032655.1,72945873,75731964,75731965,c,ct,1
NC_037333.1,NC_032655.1,72950716,75736809,75736812,g,gctT,3
NC_037333.1,NC_032655.1,73033948,75818716,75818717,T,TC,1
NC_037333.1,NC_032655.1,73038261,75823029,75823031,T,TTG,2
NC_037333.1,NC_032655.1,73062160,76056297,76056300,A,ATTG,3
NC_037333.1,NC_032655.1,73105900,76001797,76001804,a,aCTTATTT,7
NC_037333.1,NC_032655.1,73111327,76007243,76007244,G,GC,1
NC_037333.1,NC_032655.1,73111455,76007372,76007373,A,AR,1
NC_037333.1,NC_032655.1,73142280,76042395,76042406,A,ACATTGTAAGGT,11
NC_037333.1,NC_032655.1,73179817,75899409,75899410,c,ct,1
NC_037333.1,NC_032655.1,73185928,75905520,75905521,A,AG,1
NC_037333.1,NC_032655.1,73224908,75944492,75944493,g,ga,1
NC_037333.1,NC_032655.1,73225429,75945014,75945015,g,ga,1
NC_037333.1,NC_032655.1,73237434,75957745,75957749,C,CTCTY,4
NC_037333.1,NC_032655.1,73313284,76237598,76237599,g,ga,1
NC_037333.1,NC_032655.1,73410697,76335396,76335397,t,ta,1
NC_037333.1,NC_032655.1,73484087,76408697,76408700,t,tgga,3
NC_037333.1,NC_032655.1,73524464,76449081,76449082,G,GA,1
NC_037333.1,NC_032655.1,73817540,76758421,76758423,c,cct,2
NC_037333.1,NC_032655.1,73824565,76765338,76765339,C,CT,1
NC_037333.1,NC_032655.1,74003054,76943630,76943631,t,ta,1
NC_037333.1,NC_032655.1,74043446,76984026,76984027,a,at,1
NC_037333.1,NC_032655.1,74059406,76999986,76999987,g,ga,1
NC_037333.1,NC_032655.1,74213138,77154828,77154829,c,ca,1
NC_037333.1,NC_032655.1,74223183,77164874,77164875,a,at,1
NC_037333.1,NC_032655.1,74343027,77293762,77293763,A,AG,1
NC_037333.1,NC_032655.1,74471536,77422598,77422599,C,CT,1
NC_037333.1,NC_032655.1,74471581,77422643,77422644,T,TA,1
NC_037333.1,NC_032655.1,74488390,77439314,77439315,c,ct,1
NC_037333.1,NC_032655.1,74488390,77453868,77453869,c,ct,1
NC_037333.1,NC_032655.1,74721255,77698717,77698718,a,at,1
NC_037333.1,NC_032655.1,74721951,77699414,77699417,g,gaat,3
NC_037333.1,NC_032655.1,74893097,77871739,77871742,t,tctc,3
NC_037333.1,NC_032655.1,75093921,78054052,78054054,a,aNN,2
NC_037333.1,NC_032655.1,75310312,78271094,78271096,a,aNN,2
NC_037333.1,NC_032655.1,75332628,78293413,78293414,c,ca,1
NC_037333.1,NC_032655.1,75484908,78481477,78481478,t,tc,1
NC_037333.1,NC_032655.1,75510254,78506826,78506827,t,ta,1
NC_037333.1,NC_032655.1,75549697,78554217,78554218,c,ca,1
NC_037333.1,NC_032655.1,75587319,78591223,78591224,t,tg,1
NC_037333.1,NC_032655.1,75629923,78633798,78633799,t,tg,1
NC_037333.1,NC_032655.1,75630075,78633951,78633952,t,ta,1
NC_037333.1,NC_032655.1,75673983,78677692,78677693,t,tg,1
NC_037333.1,NC_032655.1,75936446,78939401,78939402,t,tg,1
NC_037333.1,NC_032655.1,76004453,79006698,79006699,c,ca,1
NC_037333.1,NC_032655.1,76183442,79201419,79201420,T,TG,1
NC_037333.1,NC_032655.1,76375841,79395686,79395687,t,tc,1
NC_037333.1,NC_032655.1,76382742,79402588,79402589,t,ta,1
NC_037333.1,NC_032655.1,76382852,79402699,79402703,g,gttgt,4
NC_037333.1,NC_032655.1,76428217,79520303,79520306,t,tatc,3
NC_037333.1,NC_032655.1,76442438,79534527,79534535,g,ggggatgac,8
NC_037333.1,NC_032655.1,76444932,79537030,79537031,t,tc,1
NC_037333.1,NC_032655.1,76569565,79661419,79661420,A,AC,1
NC_037333.1,NC_032655.1,76628646,79720504,79720505,a,at,1
NC_037333.1,NC_032655.1,76851316,79942484,79942485,C,CT,1
NC_037333.1,NC_032655.1,76953907,80045108,80045109,a,at,1
NC_037333.1,NC_032655.1,77242319,80356541,80356542,A,AG,1
NC_037333.1,NC_032655.1,77348205,80462332,80462334,A,ATT,2
NC_037333.1,NC_032655.1,77499783,80613909,80613910,C,CG,1
NC_037333.1,NC_032655.1,77573593,80686882,80686883,c,ca,1
NC_037333.1,NC_032655.1,77605534,80718639,80718641,t,taa,2
NC_037333.1,NC_032655.1,77747508,80859827,80859831,t,tNNNN,4
NC_037333.1,NC_032655.1,77787165,80899342,80899343,A,AT,1
NC_037333.1,NC_032655.1,77790764,80902937,80902938,C,CM,1
NC_037333.1,NC_032655.1,77792885,80905053,80905054,A,AG,1
NC_037333.1,NC_032655.1,77799554,80911713,80911714,t,tg,1
NC_037333.1,NC_032655.1,77820799,80921780,80921803,a,aatNNNNNNNNNNNNaaaaaaaat,23
NC_037333.1,NC_032655.1,77820818,80921822,80921824,t,taa,2
NC_037333.1,NC_032655.1,77826345,80938755,80938756,t,ta,1
NC_037333.1,NC_032655.1,77848905,80961310,80961311,C,CY,1
NC_037333.1,NC_032655.1,77856125,80968512,80968516,a,aaaac,4
NC_037333.1,NC_032655.1,77856378,80968768,80968769,t,ta,1
NC_037333.1,NC_032655.1,77856485,80968876,80968877,a,ac,1
NC_037333.1,NC_032655.1,77936944,81168334,81168335,c,ca,1
NC_037333.1,NC_032655.1,78039296,81243653,81243654,c,ct,1
NC_037333.1,NC_032655.1,78118536,81326639,81326641,C,CTT,2
NC_037333.1,NC_032655.1,78151900,81360010,81360011,c,ca,1
NC_037333.1,NC_032655.1,78164102,81372211,81372212,a,ac,1
NC_037333.1,NC_032655.1,78217020,81425154,81425171,C,CAGCAGCACTCAGCAGCM,17
NC_037333.1,NC_032655.1,78239508,81448969,81448970,a,at,1
NC_037333.1,NC_032655.1,78306179,81574441,81574442,T,TC,1
NC_037333.1,NC_032655.1,78331855,81709686,81709697,a,atacatatacat,11
NC_037333.1,NC_032655.1,78339148,81584159,81584173,T,TGGTTACTGGGGTTA,14
NC_037333.1,NC_032655.1,78488852,81765772,81765774,C,CAT,2
NC_037333.1,NC_032655.1,78490093,81767015,81767016,c,ct,1
NC_037333.1,NC_032655.1,78502050,81778977,81778979,t,taa,2
NC_037333.1,NC_032655.1,78509169,81787250,81787251,G,GT,1
NC_037333.1,NC_032655.1,78511051,81789132,81789133,T,TG,1
NC_037333.1,NC_032655.1,78511349,81789431,81789433,C,CTT,2
NC_037333.1,NC_032655.1,78514147,81790942,81790946,T,TAAAG,4
NC_037333.1,NC_032655.1,78518596,81795399,81795400,T,TY,1
NC_037333.1,NC_032655.1,78538317,81815388,81815389,G,GT,1
NC_037333.1,NC_032655.1,78542922,81822021,81822022,a,at,1
NC_037333.1,NC_032655.1,78543274,81822375,81822376,t,ta,1
NC_037333.1,NC_032655.1,78545343,81824445,81824446,T,TY,1
NC_037333.1,NC_032655.1,78551723,81830949,81830950,C,CS,1
NC_037333.1,NC_032655.1,78574752,81853538,81853539,C,CY,1
NC_037333.1,NC_032655.1,78584635,81863431,81863435,t,ttttc,4
NC_037333.1,NC_032655.1,78585484,81864289,81864293,G,GTGTT,4
NC_037333.1,NC_032655.1,78588165,81866974,81866977,A,ACTC,3
NC_037333.1,NC_032655.1,78589147,81867958,81867959,t,ta,1
NC_037333.1,NC_032655.1,78589165,81867977,81867987,a,atgtatgtatg,10
NC_037333.1,NC_032655.1,78589489,81868658,81868661,a,aatt,3
NC_037333.1,NC_032655.1,78590890,81870065,81870066,a,ac,1
NC_037333.1,NC_032655.1,78613950,81892509,81892512,c,ccaa,3
NC_037333.1,NC_032655.1,78662352,81942488,81942489,g,ga,1
NC_037333.1,NC_032655.1,78691269,81971419,81971420,t,tc,1
NC_037333.1,NC_032655.1,78742680,82024657,82024658,A,AC,1
NC_037333.1,NC_032655.1,78747203,82029176,82029177,A,AR,1
NC_037333.1,NC_032655.1,78750387,82032440,82032444,c,caaat,4
NC_037333.1,NC_032655.1,78752799,82034861,82034871,a,aaaaaaaaaat,10
NC_037333.1,NC_032655.1,78752802,82034874,82034880,t,tacaaaa,6
NC_037333.1,NC_032655.1,78754464,82036542,82036545,a,atct,3
NC_037333.1,NC_032655.1,78756447,82038945,82038946,t,tY,1
NC_037333.1,NC_032655.1,78758817,82041319,82041320,c,ct,1
NC_037333.1,NC_032655.1,78773872,82056422,82056423,t,tc,1
NC_037333.1,NC_032655.1,78778313,82060852,82060853,g,ga,1
NC_037333.1,NC_032655.1,78788433,82070976,82070977,t,tc,1
NC_037333.1,NC_032655.1,78788435,82070979,82070980,c,ct,1
NC_037333.1,NC_032655.1,78861020,82090957,82090958,c,ca,1
NC_037333.1,NC_032655.1,78864499,82179981,82179982,t,ta,1
NC_037333.1,NC_032655.1,78900657,82217413,82217414,a,aM,1
NC_037333.1,NC_032655.1,78919489,82266652,82266653,G,GA,1
NC_037333.1,NC_032655.1,78919526,82266690,82266691,T,TA,1
NC_037333.1,NC_032655.1,78919595,82266760,82266761,t,tg,1
NC_037333.1,NC_032655.1,78929401,82276564,82276566,c,cca,2
NC_037333.1,NC_032655.1,78936837,82284004,82284006,A,ACT,2
NC_037333.1,NC_032655.1,78942624,82289792,82289795,g,ggaa,3
NC_037333.1,NC_032655.1,78946614,82294802,82294803,g,gt,1
NC_037333.1,NC_032655.1,78955940,82304125,82304126,t,tg,1
NC_037333.1,NC_032655.1,78956512,82304698,82304701,g,gcga,3
NC_037333.1,NC_032655.1,78958718,82306907,82306921,g,gatataagcatctga,14
NC_037333.1,NC_032655.1,78966942,82315244,82315245,a,aR,1
NC_037333.1,NC_032655.1,78968741,82317041,82317055,a,aaataaaataaaatt,14
NC_037333.1,NC_032655.1,78969496,82317810,82317811,c,ca,1
NC_037333.1,NC_032655.1,78970135,82318450,82318454,t,ttaaa,4
NC_037333.1,NC_032655.1,78978382,82326575,82326595,a,agatgaactaaacaGACTCTT,20
NC_037333.1,NC_032655.1,78983086,82331310,82331311,c,ca,1
NC_037333.1,NC_032655.1,78983122,82331347,82331349,t,tca,2
NC_037333.1,NC_032655.1,78984715,82332945,82332946,A,AC,1
NC_037333.1,NC_032655.1,78989088,82337413,82337415,A,AAT,2
NC_037333.1,NC_032655.1,78989772,82338121,82338122,T,TA,1
NC_037333.1,NC_032655.1,78990093,82338443,82338444,t,ta,1
NC_037333.1,NC_032655.1,78990722,82339075,82339087,T,TAATACTTTCATA,12
NC_037333.1,NC_032655.1,78991028,82339393,82339395,g,gaa,2
NC_037333.1,NC_032655.1,78993032,82341399,82341400,t,tg,1
NC_037333.1,NC_032655.1,78998067,82346449,82346451,a,aag,2
NC_037333.1,NC_032655.1,79006841,82355081,82355082,G,GA,1
NC_037333.1,NC_032655.1,79013325,82361567,82361568,t,tc,1
NC_037333.1,NC_032655.1,79087710,82445121,82445122,A,AG,1
NC_037333.1,NC_032655.1,79134318,82491752,82491753,a,ac,1
NC_037333.1,NC_032655.1,79138461,82495902,82495903,T,Tc,1
NC_037333.1,NC_032655.1,79139049,82496491,82496493,c,ctg,2
NC_037333.1,NC_032655.1,79139408,82496852,82496854,a,aat,2
NC_037333.1,NC_032655.1,79139507,82496953,82496955,a,aag,2
NC_037333.1,NC_032655.1,79156044,82418753,82418754,c,ca,1
NC_037333.1,NC_032655.1,79156063,82418773,82418774,c,ca,1
NC_037333.1,NC_032655.1,79156300,82419011,82419012,A,AC,1
NC_037333.1,NC_032655.1,79185643,82551949,82551952,a,aatt,3
NC_037333.1,NC_032655.1,79186719,82553028,82553029,A,AG,1
NC_037333.1,NC_032655.1,79187027,82553337,82553340,C,CATA,3
NC_037333.1,NC_032655.1,79199904,82566745,82566746,C,CT,1
NC_037333.1,NC_032655.1,79209594,82577347,82577348,T,TA,1
NC_037333.1,NC_032655.1,79215882,82583634,82583635,t,tg,1
NC_037333.1,NC_032655.1,79222745,82590563,82590567,g,ggaaa,4
NC_037333.1,NC_032655.1,79223064,82590886,82590887,g,gt,1
NC_037333.1,NC_032655.1,79235208,82603044,82603045,c,ct,1
NC_037333.1,NC_032655.1,79243835,82611674,82611675,t,tc,1
NC_037333.1,NC_032655.1,79244629,82612469,82612471,a,aat,2
NC_037333.1,NC_032655.1,79255000,82624216,82624217,a,ag,1
NC_037333.1,NC_032655.1,79256203,82625421,82625422,C,CS,1
NC_037333.1,NC_032655.1,79258451,82627659,82627677,g,gaaacaATTCCTNNNNNNN,18
NC_037333.1,NC_032655.1,79267960,82637285,82637287,C,CTA,2
NC_037333.1,NC_032655.1,79268675,82638001,82638003,A,AAT,2
NC_037333.1,NC_032655.1,79290692,82657956,82657962,T,TTAAGTA,6
NC_037333.1,NC_032655.1,79291771,82659041,82659042,A,AG,1
NC_037333.1,NC_032655.1,79302607,82669884,82669885,t,ta,1
NC_037333.1,NC_032655.1,79315828,82683110,82683111,T,TC,1
NC_037333.1,NC_032655.1,79319387,82686676,82686677,A,AT,1
NC_037333.1,NC_032655.1,79319757,82687047,82687051,A,ATAGT,4
NC_037333.1,NC_032655.1,79342087,82708815,82708816,T,TC,1
NC_037333.1,NC_032655.1,79381660,82747359,82747360,g,ga,1
NC_037333.1,NC_032655.1,79418614,82784468,82784470,t,tta,2
NC_037333.1,NC_032655.1,79427695,82793553,82793557,t,ttttg,4
NC_037333.1,NC_032655.1,79439991,82805854,82805856,c,ctt,2
NC_037333.1,NC_032655.1,79461766,82827650,82827651,c,ca,1
NC_037333.1,NC_032655.1,79477572,82843345,82843347,t,ttc,2
NC_037333.1,NC_032655.1,79498229,82863181,82863183,a,aac,2
NC_037333.1,NC_032655.1,79503175,82868131,82868132,c,ct,1
NC_037333.1,NC_032655.1,79506188,82871158,82871162,G,GCAAT,4
NC_037333.1,NC_032655.1,79515243,82880220,82880224,T,TATTA,4
NC_037333.1,NC_032655.1,79521094,82886081,82886099,t,tatatatatatNNatacac,18
NC_037333.1,NC_032655.1,79535557,82900553,82900556,T,TGTC,3
NC_037333.1,NC_032655.1,79536894,82901893,82901894,T,TY,1
NC_037333.1,NC_032655.1,79537509,82902516,82902517,t,ta,1
NC_037333.1,NC_032655.1,79539142,82904152,82904162,G,GCCCTCACTAT,10
NC_037333.1,NC_032655.1,79578086,82943142,82943143,C,CG,1
NC_037333.1,NC_032655.1,79696499,83061719,83061720,g,ga,1
NC_037333.1,NC_032655.1,79775723,83140281,83140282,g,gt,1
NC_037333.1,NC_032655.1,79838202,83202823,83202824,G,GK,1
NC_037333.1,NC_032655.1,79864158,83270025,83270026,g,gc,1
NC_037333.1,NC_032655.1,79924214,83331438,83331442,t,tatag,4
NC_037333.1,NC_032655.1,79924962,83332190,83332201,a,aacggaTCACCG,11
NC_037333.1,NC_032655.1,79990281,83397765,83397766,c,ca,1
NC_037333.1,NC_032655.1,80016060,83423544,83423545,t,tc,1
NC_037333.1,NC_032655.1,80022931,83430416,83430417,G,GS,1
NC_037333.1,NC_032655.1,80101036,83509336,83509340,c,cttct,4
NC_037333.1,NC_032655.1,80101574,83509878,83509879,c,ct,1
NC_037333.1,NC_032655.1,80148263,83557175,83557176,T,TA,1
NC_037333.1,NC_032655.1,80351129,83761085,83761086,G,GA,1
NC_037333.1,NC_032655.1,80351312,83761269,83761271,g,gcc,2
NC_037333.1,NC_032655.1,80351540,83761499,83761500,A,AY,1
NC_037333.1,NC_032655.1,80379463,83789434,83789435,t,tc,1
NC_037333.1,NC_032655.1,80379594,83789563,83789564,t,ta,1
NC_037333.1,NC_032655.1,80432214,83842189,83842209,a,aacacacacacacacacacac,20
NC_037333.1,NC_032655.1,80521193,83937614,83937615,g,gc,1
NC_037333.1,NC_032655.1,80775298,84194519,84194528,g,gacactgttt,9
NC_037333.1,NC_032655.1,80851034,84272718,84272719,g,ga,1
NC_037333.1,NC_032655.1,80851037,84272722,84272723,a,ag,1
NC_037333.1,NC_032655.1,81085532,84558769,84558770,a,ag,1
NC_037333.1,NC_032655.1,81135924,84609456,84609460,a,aNNNN,4
NC_037333.1,NC_032655.1,81223803,84697310,84697312,c,ctg,2
NC_037333.1,NC_032655.1,81285271,84758779,84758780,t,tN,1
NC_037333.1,NC_032655.1,81350203,84823715,84823717,a,aac,2
NC_037333.1,NC_032655.1,81350620,84824132,84824133,a,at,1
NC_037333.1,NC_032655.1,81606250,85080122,85080123,t,ta,1
NC_037333.1,NC_032655.1,81608358,85082232,85082240,a,aggtcaggt,8
NC_037333.1,NC_032655.1,81657605,85131387,85131388,a,at,1
NC_037333.1,NC_032655.1,82609485,85355790,85355791,a,at,1
NC_037333.1,NC_032655.1,82658177,85404139,85404140,c,cg,1
NC_037333.1,NC_032655.1,82710877,85457301,85457302,g,gt,1
NC_037333.1,NC_032655.1,82711213,85457638,85457639,t,tg,1
NC_037333.1,NC_032655.1,82791671,85548665,85548666,a,ac,1
NC_037333.1,NC_032655.1,82813387,85570402,85570403,T,TA,1
NC_037333.1,NC_032655.1,82814701,85571716,85571717,G,GT,1
NC_037333.1,NC_032655.1,82903168,85660008,85660009,A,AG,1
NC_037333.1,NC_032655.1,82958771,85715611,85715612,t,ta,1
NC_037333.1,NC_032655.1,83175617,85932358,85932359,t,tc,1
NC_037333.1,NC_032655.1,83249947,86006941,86006942,a,ag,1
NC_037333.1,NC_032655.1,83250023,86007018,86007019,c,ct,1
NC_037333.1,NC_032655.1,83250073,86007069,86007070,a,ag,1
NC_037333.1,NC_032655.1,83278055,86035038,86035039,T,TK,1
NC_037333.1,NC_032655.1,83334650,86091523,86091525,G,GAT,2
NC_037333.1,NC_032655.1,83412295,86169076,86169079,g,gatc,3
NC_037333.1,NC_032655.1,83441366,86198165,86198167,T,TCA,2
NC_037333.1,NC_032655.1,83443753,86200554,86200557,T,TAAC,3
NC_037333.1,NC_032655.1,83490272,86247080,86247081,t,tc,1
NC_037333.1,NC_032655.1,83506524,86263335,86263336,g,ga,1
NC_037333.1,NC_032655.1,83615942,86365307,86365308,C,CA,1
NC_037333.1,NC_032655.1,83816202,86565600,86565601,a,ac,1
NC_037333.1,NC_032655.1,83907582,86682126,86682127,C,CG,1
NC_037333.1,NC_032655.1,83951307,86728788,86728789,G,GA,1
NC_037333.1,NC_032655.1,83959358,86736840,86736842,t,tNN,2
NC_037333.1,NC_032655.1,84038969,86815901,86815903,c,cag,2
NC_037333.1,NC_032655.1,84070985,86847913,86847914,t,tc,1
NC_037333.1,NC_032655.1,84070994,86847923,86847924,a,at,1
NC_037333.1,NC_032655.1,84133121,86910049,86910050,A,AG,1
NC_037333.1,NC_032655.1,84144448,86921377,86921391,a,acaAACATTAANNNN,14
NC_037333.1,NC_032655.1,84290775,87067716,87067740,T,TCACGTGGTTCCAGTCTTATGGTGA,24
NC_037333.1,NC_032655.1,84299856,87076820,87076821,a,ag,1
NC_037333.1,NC_032655.1,84307476,87084441,87084467,a,acacTATNNNNNNNNNNNNNNNNNNNN,26
NC_037333.1,NC_032655.1,84421977,87198778,87198779,c,ca,1
NC_037333.1,NC_032655.1,84447073,87276611,87276612,g,gt,1
NC_037333.1,NC_032655.1,84516846,87346389,87346391,g,gct,2
NC_037333.1,NC_032655.1,84524635,87354180,87354181,C,CG,1
NC_037333.1,NC_032655.1,84590757,87420970,87420972,a,aNN,2
NC_037333.1,NC_032655.1,84611136,87438463,87438466,G,GAAA,3
NC_037333.1,NC_032655.1,84737953,87569423,87569424,t,tg,1
NC_037333.1,NC_032655.1,84795546,87627021,87627022,t,tg,1
NC_037333.1,NC_032655.1,84795618,87627093,87627094,g,ga,1
NC_037333.1,NC_032655.1,84795625,87627101,87627102,c,cg,1
NC_037333.1,NC_032655.1,84804674,87636151,87636159,a,acaaaaaac,8
NC_037333.1,NC_032655.1,84809954,87641438,87641454,g,gtatatatatatatata,16
NC_037333.1,NC_032655.1,85103754,88000897,88000898,c,ct,1
NC_037333.1,NC_032655.1,85103930,88001074,88001091,T,TCTTCAGAGCGTTGAGCG,17
NC_037333.1,NC_032655.1,85211290,88108576,88108577,t,tc,1
NC_037333.1,NC_032655.1,85305214,88255625,88255626,a,ac,1
NC_037333.1,NC_032655.1,85432330,88397773,88397774,g,ga,1
NC_037333.1,NC_032655.1,85478292,88444779,88444781,a,att,2
NC_037333.1,NC_032655.1,85655416,88616556,88616557,t,ta,1
NC_037333.1,NC_032655.1,85659090,88620240,88620241,a,ag,1
NC_037333.1,NC_032655.1,85749968,88711658,88711659,c,ct,1
NC_037333.1,NC_032655.1,85794719,88756407,88756408,g,gt,1
NC_037333.1,NC_032655.1,85795117,88756806,88756807,A,AT,1
NC_037333.1,NC_032655.1,85900741,88897131,88897132,c,ct,1
NC_037333.1,NC_032655.1,85922610,88918907,88918910,c,caga,3
NC_037333.1,NC_032655.1,86188167,89152012,89152013,t,ta,1
NC_037333.1,NC_032655.1,86314241,89274549,89274550,g,ga,1
NC_037333.1,NC_032655.1,86314275,89274584,89274585,a,at,1
NC_037333.1,NC_032655.1,86320109,89280418,89280432,t,tttttttttttKTTK,14
NC_037333.1,NC_032655.1,86329673,89290000,89290001,c,ct,1
NC_037333.1,NC_032655.1,86340111,89300439,89300440,C,CT,1
NC_037333.1,NC_032655.1,86406090,89366577,89366579,t,tgg,2
NC_037333.1,NC_032655.1,86406528,89367017,89367018,C,CT,1
NC_037333.1,NC_032655.1,86452119,89412613,89412616,T,TTAA,3
NC_037333.1,NC_032655.1,86473862,89435936,89435937,T,TC,1
NC_037333.1,NC_032655.1,86499823,89461901,89461912,G,GAGCCTCTCAGT,11
NC_037333.1,NC_032655.1,86500821,89462910,89462914,c,cctta,4
NC_037333.1,NC_032655.1,86673363,89672672,89672673,C,CY,1
NC_037333.1,NC_032655.1,86674485,89673794,89673795,T,TY,1
NC_037333.1,NC_032655.1,86680562,89679874,89679887,g,gccaccagggagtt,13
NC_037333.1,NC_032655.1,86705522,89704851,89704854,t,ttNN,3
NC_037333.1,NC_032655.1,86885213,89885453,89885454,A,AW,1
NC_037333.1,NC_032655.1,86887124,89887365,89887366,t,ta,1
NC_037333.1,NC_032655.1,86902904,89903150,89903151,A,AR,1
NC_037333.1,NC_032655.1,86905954,89906200,89906201,c,ca,1
NC_037333.1,NC_032655.1,86923029,89923271,89923272,c,ca,1
NC_037333.1,NC_032655.1,87036184,90036490,90036493,t,tcac,3
NC_037333.1,NC_032655.1,87036526,90036835,90036836,t,ta,1
NC_037333.1,NC_032655.1,87081388,90084246,90084269,A,ATCTGAAATAATCCCTTTAAAATC,23
NC_037333.1,NC_032655.1,87085443,90088325,90088379,t,tgaNNNNNNNNNNNNNNNNNNNNNNNNNNNNNNNNNNNNNNNNNNNNNNNNNNNN,54
NC_037333.1,NC_032655.1,87086223,90089160,90089163,g,gtga,3
NC_037333.1,NC_032655.1,87086664,90089604,90089607,c,cgtt,3
NC_037333.1,NC_032655.1,87090254,90093206,90093207,a,at,1
NC_037333.1,NC_032655.1,87091809,90094755,90094759,T,TCTAA,4
NC_037333.1,NC_032655.1,87092605,90095511,90095514,c,ctct,3
NC_037333.1,NC_032655.1,87104831,90108842,90108843,G,GA,1
NC_037333.1,NC_032655.1,87105402,90109414,90109418,c,ccggg,4
NC_037333.1,NC_032655.1,87121972,90126064,90126065,g,gc,1
NC_037333.1,NC_032655.1,87123111,90127202,90127203,A,AT,1
NC_037333.1,NC_032655.1,87127921,90132011,90132013,t,ttc,2
NC_037333.1,NC_032655.1,87142929,90147048,90147056,G,GAAAGGGAT,8
NC_037333.1,NC_032655.1,87439405,90443291,90443292,T,TM,1
NC_037333.1,NC_032655.1,87504037,90507925,90507926,T,TC,1
NC_037333.1,NC_032655.1,87584632,90588562,90588563,T,TC,1
NC_037333.1,NC_032655.1,87617979,90621914,90621915,G,GC,1
NC_037333.1,NC_032655.1,87692758,90697415,90697416,A,AT,1
NC_037333.1,NC_032655.1,87808194,90812705,90812707,t,ttc,2
NC_037333.1,NC_032655.1,87808206,90812719,90812720,c,ct,1
NC_037333.1,NC_032655.1,87874372,90878884,90878887,g,ggaa,3
NC_037333.1,NC_032655.1,87875633,90880149,90880150,t,ta,1
NC_037333.1,NC_032655.1,87883920,90888441,90888450,T,TTTGTCTGTA,9
NC_037333.1,NC_032655.1,87892884,90896987,90896988,t,tc,1
NC_037333.1,NC_032655.1,87893276,90897380,90897386,T,TGAATAG,6
NC_037333.1,NC_032655.1,87899681,90903792,90903794,c,cgt,2
NC_037333.1,NC_032655.1,87938147,90988437,90988441,T,TACTA,4
NC_037333.1,NC_032655.1,87988671,91038851,91038854,a,agtg,3
NC_037333.1,NC_032655.1,88043643,91094951,91094952,a,ag,1
NC_037333.1,NC_032655.1,88107775,91169173,91169174,T,TY,1
NC_037333.1,NC_032655.1,88137018,91198416,91198418,c,cag,2
NC_037333.1,NC_032655.1,88176876,91238290,91238291,A,AT,1
NC_037333.1,NC_032655.1,88316779,91378251,91378253,T,TAG,2
NC_037333.1,NC_032655.1,88327573,91389049,91389050,C,CA,1
NC_037333.1,NC_032655.1,88385312,91447099,91447100,t,tg,1
NC_037333.1,NC_032655.1,88471917,91533710,91533711,t,tg,1
NC_037333.1,NC_032655.1,88894591,91961069,91961070,c,cg,1
NC_037333.1,NC_032655.1,89112864,92197290,92197291,A,AC,1
NC_037333.1,NC_032655.1,89115561,92199987,92199988,A,AT,1
NC_037333.1,NC_032655.1,89226638,92310142,92310146,t,tNNNN,4
NC_037333.1,NC_032655.1,89230158,92313665,92313666,A,AC,1
NC_037333.1,NC_032655.1,89261279,92344795,92344797,c,cag,2
NC_037333.1,NC_032655.1,89355946,92517105,92517109,T,TTGTC,4
NC_037333.1,NC_032655.1,89393775,92554938,92554939,G,GR,1
NC_037333.1,NC_032655.1,89411455,92581920,92581921,T,TC,1
NC_037333.1,NC_032655.1,89412849,92583313,92583314,C,CT,1
NC_037333.1,NC_032655.1,89422877,92593358,92593360,a,aaN,2
NC_037333.1,NC_032655.1,89555416,92721555,92721556,A,AT,1
NC_037333.1,NC_032655.1,89580183,92746234,92746235,g,gt,1
NC_037333.1,NC_032655.1,89676459,92865179,92865180,t,tN,1
NC_037333.1,NC_032655.1,89716746,92905556,92905557,A,AT,1
NC_037333.1,NC_032655.1,89732558,92921369,92921375,t,tNNNNNN,6
NC_037333.1,NC_032655.1,89736262,92939287,92939288,g,gc,1
NC_037333.1,NC_032655.1,89740253,92943283,92943284,g,ga,1
NC_037333.1,NC_032655.1,89748176,92951211,92951213,a,aag,2
NC_037333.1,NC_032655.1,89772239,92975500,92975501,c,cY,1
NC_037333.1,NC_032655.1,89792300,92998240,92998241,a,at,1
NC_037333.1,NC_032655.1,89865137,93071094,93071095,A,AR,1
NC_037333.1,NC_032655.1,89868491,93074448,93074449,C,CA,1
NC_037333.1,NC_032655.1,89945733,93151619,93151620,t,tW,1
NC_037333.1,NC_032655.1,90005974,93214542,93214543,c,ca,1
NC_037333.1,NC_032655.1,90020447,93227829,93227830,t,tg,1
NC_037333.1,NC_032655.1,90032602,93239987,93239988,T,TK,1
NC_037333.1,NC_032655.1,90034615,93242001,93242009,c,ctccgtcca,8
NC_037333.1,NC_032655.1,90125846,93413847,93413848,c,ct,1
NC_037333.1,NC_032655.1,90126570,93414572,93414574,c,caa,2
NC_037333.1,NC_032655.1,90174041,93462065,93462066,c,ca,1
NC_037333.1,NC_032655.1,90197157,93485185,93485187,a,aNN,2
NC_037333.1,NC_032655.1,90205269,93493299,93493300,t,tc,1
NC_037333.1,NC_032655.1,90276296,93564243,93564244,G,GT,1
NC_037333.1,NC_032655.1,90322255,93636357,93636358,A,AR,1
NC_037333.1,NC_032655.1,90323761,93637854,93637855,g,ga,1
NC_037333.1,NC_032655.1,90332030,93646124,93646125,A,AR,1
NC_037333.1,NC_032655.1,90456222,93765704,93765708,t,tNNNN,4
NC_037333.1,NC_032655.1,90527754,93837300,93837301,T,TA,1
NC_037333.1,NC_032655.1,90632905,93942376,93942387,c,cgaccccatgga,11
NC_037333.1,NC_032655.1,90640754,93950238,93950243,C,CTAGAG,5
NC_037333.1,NC_032655.1,90642599,93952089,93952097,C,CTGATGGAG,8
NC_037333.1,NC_032655.1,90645784,93955278,93955288,T,TAATACCTTGA,10
NC_037333.1,NC_032655.1,90655561,93965063,93965065,c,ctt,2
NC_037333.1,NC_032655.1,90655735,93965239,93965240,c,ca,1
NC_037333.1,NC_032655.1,90664786,93974292,93974293,A,AW,1
NC_037333.1,NC_032655.1,90666099,93975605,93975606,t,ta,1
NC_037333.1,NC_032655.1,90666785,93976292,93976299,g,gaaaaaaa,7
NC_037333.1,NC_032655.1,90676939,93995003,93995004,C,CT,1
NC_037333.1,NC_032655.1,90686587,94004669,94004670,G,GT,1
NC_037333.1,NC_032655.1,90694166,94012248,94012249,a,at,1
NC_037333.1,NC_032655.1,90719068,94037151,94037153,a,agc,2
NC_037333.1,NC_032655.1,90782546,94101861,94101862,t,ta,1
NC_037333.1,NC_032655.1,90802431,94124730,94124731,G,GR,1
NC_037333.1,NC_032655.1,90802849,94125150,94125151,a,ac,1
NC_037333.1,NC_032655.1,90802874,94125176,94125177,c,ca,1
NC_037333.1,NC_032655.1,90804105,94126512,94126514,c,ctt,2
NC_037333.1,NC_032655.1,90806690,94132351,94132383,c,cctgtatttttttgcANNNNNNNNNNATGAAAT,32
NC_037333.1,NC_032655.1,90807162,94132830,94132835,g,gtccat,5
NC_037333.1,NC_032655.1,90809761,94135435,94135436,C,CA,1
NC_037333.1,NC_032655.1,90809923,94135598,94135600,t,tta,2
NC_037333.1,NC_032655.1,90811358,94137036,94137038,c,cag,2
NC_037333.1,NC_032655.1,90832625,94163464,94163465,C,CY,1
NC_037333.1,NC_032655.1,90837084,94167905,94167908,T,TCTA,3
NC_037333.1,NC_032655.1,90855398,94187855,94187856,G,GS,1
NC_037333.1,NC_032655.1,90937463,94278647,94278649,t,tta,2
NC_037333.1,NC_032655.1,90968857,94310061,94310064,T,TACA,3
NC_037333.1,NC_032655.1,91066505,94362313,94362314,T,TA,1
NC_037333.1,NC_032655.1,91084532,94380444,94380450,t,tatNNNN,6
NC_037333.1,NC_032655.1,91194591,94490523,94490524,g,gt,1
NC_037333.1,NC_032655.1,91196922,94492859,94492860,A,AW,1
NC_037333.1,NC_032655.1,91205553,94501496,94501497,g,gR,1
NC_037333.1,NC_032655.1,91205716,94501659,94501660,A,AR,1
NC_037333.1,NC_032655.1,91219729,94515682,94515683,C,CA,1
NC_037333.1,NC_032655.1,91257172,94553117,94553119,C,CAT,2
NC_037333.1,NC_032655.1,91258427,94556659,94556660,t,tc,1
NC_037333.1,NC_032655.1,91258501,94556734,94556735,G,GT,1
NC_037333.1,NC_032655.1,91270701,94568936,94568937,a,ac,1
NC_037333.1,NC_032655.1,91305749,94603982,94603983,A,AG,1
NC_037333.1,NC_032655.1,91306524,94604758,94604759,t,tY,1
NC_037333.1,NC_032655.1,91318283,94616506,94616507,A,AT,1
NC_037333.1,NC_032655.1,91324462,94622688,94622689,C,CG,1
NC_037333.1,NC_032655.1,91325189,94623416,94623417,A,AR,1
NC_037333.1,NC_032655.1,91326284,94624512,94624513,A,AG,1
NC_037333.1,NC_032655.1,91327267,94625496,94625497,T,TY,1
NC_037333.1,NC_032655.1,91331083,94629313,94629315,t,tca,2
NC_037333.1,NC_032655.1,91335029,94633287,94633288,t,tc,1
NC_037333.1,NC_032655.1,91335648,94633907,94633908,t,tc,1
NC_037333.1,NC_032655.1,91341958,94640124,94640125,a,at,1
NC_037333.1,NC_032655.1,91345376,94643545,94643549,T,TTAAC,4
NC_037333.1,NC_032655.1,91350568,94648749,94648750,c,ct,1
NC_037333.1,NC_032655.1,91350568,94651279,94651280,c,ct,1
NC_037333.1,NC_032655.1,91378880,94679594,94679596,t,ttc,2
NC_037333.1,NC_032655.1,91381071,94681787,94681788,G,GS,1
NC_037333.1,NC_032655.1,91430662,94731389,94731391,c,cca,2
NC_037333.1,NC_032655.1,91443850,94744440,94744441,t,ta,1
NC_037333.1,NC_032655.1,91443912,94744503,94744504,a,ag,1
NC_037333.1,NC_032655.1,91462698,94765311,94765312,A,AR,1
NC_037333.1,NC_032655.1,91473728,94776348,94776349,C,CS,1
NC_037333.1,NC_032655.1,91491364,94793981,94793982,A,AR,1
NC_037333.1,NC_032655.1,91493077,94795696,94795702,a,aNNNNNN,6
NC_037333.1,NC_032655.1,91512246,94814880,94814881,T,TW,1
NC_037333.1,NC_032655.1,91516170,94818475,94818476,A,AG,1
NC_037333.1,NC_032655.1,91522848,94825109,94825118,A,AGTACAGAAW,9
NC_037333.1,NC_032655.1,91554684,94882910,94882911,T,TG,1
NC_037333.1,NC_032655.1,91680997,95009301,95009302,t,tc,1
NC_037333.1,NC_032655.1,91740913,95069044,95069048,G,GAGAS,4
NC_037333.1,NC_032655.1,91788185,95116324,95116325,T,TY,1
NC_037333.1,NC_032655.1,91809473,95137617,95137618,C,CY,1
NC_037333.1,NC_032655.1,91840516,95169456,95169460,A,AATTG,4
NC_037333.1,NC_032655.1,91858137,95187085,95187088,A,AGCT,3
NC_037333.1,NC_032655.1,91863921,95192868,95192869,G,GC,1
NC_037333.1,NC_032655.1,91865682,95194630,95194631,t,tc,1
NC_037333.1,NC_032655.1,91865696,95194645,95194646,t,ta,1
NC_037333.1,NC_032655.1,91937054,95267343,95267348,t,tcacag,5
NC_037333.1,NC_032655.1,91946767,95277592,95277595,c,cgat,3
NC_037333.1,NC_032655.1,91952632,95283459,95283460,C,CT,1
NC_037333.1,NC_032655.1,91991280,95351006,95351008,G,GGA,2
NC_037333.1,NC_032655.1,92052876,95455918,95455927,c,cacgactgaa,9
NC_037333.1,NC_032655.1,92066556,95469646,95469647,T,TA,1
NC_037333.1,NC_032655.1,92079650,95485358,95485359,C,CT,1
NC_037333.1,NC_032655.1,92081025,95486733,95486735,T,TCA,2
NC_037333.1,NC_032655.1,92081285,95486994,95486996,a,act,2
NC_037333.1,NC_032655.1,92121906,95525564,95525565,t,ta,1
NC_037333.1,NC_032655.1,92121910,95525569,95525570,c,ct,1
NC_037333.1,NC_032655.1,92124244,95527903,95527904,C,CT,1
NC_037333.1,NC_032655.1,92172816,95580304,95580318,g,gaagctacaggcaat,14
NC_037333.1,NC_032655.1,92201291,95608797,95608798,a,at,1
NC_037333.1,NC_032655.1,92222915,95630428,95630430,A,AAT,2
NC_037333.1,NC_032655.1,92240674,95687998,95687999,G,GK,1
NC_037333.1,NC_032655.1,92295781,95743289,95743290,g,ga,1
NC_037333.1,NC_032655.1,92323954,95769741,95769743,C,CAT,2
NC_037333.1,NC_032655.1,92356246,95802272,95802275,g,gcca,3
NC_037333.1,NC_032655.1,92356785,95802812,95802815,a,aaag,3
NC_037333.1,NC_032655.1,92356798,95802828,95802832,t,tctca,4
NC_037333.1,NC_032655.1,92480762,95938384,95938385,a,ag,1
NC_037333.1,NC_032655.1,92483927,95941551,95941552,C,CY,1
NC_037333.1,NC_032655.1,92485981,95943606,95943607,g,gc,1
NC_037333.1,NC_032655.1,92490266,95948546,95948547,g,ga,1
NC_037333.1,NC_032655.1,92504676,95962954,95962956,A,ARR,2
NC_037333.1,NC_032655.1,92539383,96007306,96007333,c,cctgccaatgcaggagacataagagatg,27
NC_037333.1,NC_032655.1,92564773,96032734,96032735,g,ga,1
NC_037333.1,NC_032655.1,92566868,96034829,96034835,A,ACACAGC,6
NC_037333.1,NC_032655.1,92569922,96037890,96037891,C,CY,1
NC_037333.1,NC_032655.1,92631636,96099612,96099613,G,GA,1
NC_037333.1,NC_032655.1,92676392,96144271,96144272,T,TA,1
NC_037333.1,NC_032655.1,92684508,96152389,96152392,C,CCTT,3
NC_037333.1,NC_032655.1,92837519,96311407,96311409,A,AAT,2
NC_037333.1,NC_032655.1,92847335,96321222,96321223,t,tg,1
NC_037333.1,NC_032655.1,92847693,96321581,96321582,t,ta,1
NC_037333.1,NC_032655.1,92848345,96322234,96322235,t,tg,1
NC_037333.1,NC_032655.1,92879932,96353825,96353828,T,TTAG,3
NC_037333.1,NC_032655.1,92890069,96363970,96363971,A,AR,1
NC_037333.1,NC_032655.1,92890747,96364654,96364657,t,tagc,3
NC_037333.1,NC_032655.1,92913063,96386970,96386972,C,CTT,2
NC_037333.1,NC_032655.1,92923618,96397528,96397529,a,at,1
NC_037333.1,NC_032655.1,92952407,96426852,96426855,A,ACGT,3
NC_037333.1,NC_032655.1,92975137,96449592,96449593,A,AT,1
NC_037333.1,NC_032655.1,92980443,96455008,96455009,G,GR,1
NC_037333.1,NC_032655.1,92983483,96475513,96475514,A,AG,1
NC_037333.1,NC_032655.1,93002611,96494627,96494628,a,at,1
NC_037333.1,NC_032655.1,93007326,96499343,96499346,g,gaaa,3
NC_037333.1,NC_032655.1,93018752,96510772,96510773,c,ct,1
NC_037333.1,NC_032655.1,93049667,96541970,96541972,a,aag,2
NC_037333.1,NC_032655.1,93049756,96542061,96542073,g,gaagaaatcaaaa,12
NC_037333.1,NC_032655.1,93051026,96543343,96543346,a,aaag,3
NC_037333.1,NC_032655.1,93051039,96543359,96543363,t,tctca,4
NC_037333.1,NC_032655.1,93062686,96555009,96555010,C,CA,1
NC_037333.1,NC_032655.1,93062689,96555013,96555016,T,TAGA,3
NC_037333.1,NC_032655.1,93182485,96674951,96674953,T,TTA,2
NC_037333.1,NC_032655.1,93249321,96743015,96743016,T,TG,1
NC_037333.1,NC_032655.1,93249489,96743184,96743185,C,CT,1
NC_037333.1,NC_032655.1,93294096,96787694,96787702,C,CTTTCTAAS,8
NC_037333.1,NC_032655.1,93388705,96881222,96881223,T,TA,1
NC_037333.1,NC_032655.1,93452174,96945220,96945221,t,tg,1
NC_037333.1,NC_032655.1,93569785,97063969,97063973,T,TWATC,4
NC_037333.1,NC_032655.1,93583873,97078067,97078068,C,CM,1
NC_037333.1,NC_032655.1,93619364,97113183,97113193,A,ATACACTTCTC,10
NC_037333.1,NC_032655.1,93639702,97133534,97133535,T,TY,1
NC_037333.1,NC_032655.1,93648756,97142620,97142621,C,CY,1
NC_037333.1,NC_032655.1,93669540,97162806,97162808,A,AGT,2
NC_037333.1,NC_032655.1,93673948,97167218,97167219,a,ag,1
NC_037333.1,NC_032655.1,93674181,97167452,97167453,t,tc,1
NC_037333.1,NC_032655.1,93674548,97167821,97167822,g,gc,1
NC_037333.1,NC_032655.1,93686436,97182403,97182404,A,AM,1
NC_037333.1,NC_032655.1,93691239,97187214,97187222,G,GTGACTTCA,8
NC_037333.1,NC_032655.1,93736863,97232840,97232841,t,ta,1
NC_037333.1,NC_032655.1,93802916,97298882,97298884,a,act,2
NC_037333.1,NC_032655.1,93847240,97342457,97342458,T,TG,1
NC_037333.1,NC_032655.1,93847828,97343046,97343050,G,GCTAA,4
NC_037333.1,NC_032655.1,93856373,97351613,97351616,t,taag,3
NC_037333.1,NC_032655.1,93868910,97364150,97364158,G,GAAAAAGTT,8
NC_037333.1,NC_032655.1,93944995,97445259,97445260,G,GA,1
NC_037333.1,NC_032655.1,93967544,97467817,97467832,c,cagcagcagcagcagt,15
NC_037333.1,NC_032655.1,94012345,97518846,97518848,t,tga,2
NC_037333.1,NC_032655.1,94060499,97567018,97567019,g,gc,1
NC_037333.1,NC_032655.1,94141894,97649939,97649940,G,GK,1
NC_037333.1,NC_032655.1,94159494,97667536,97667538,G,GGA,2
NC_037333.1,NC_032655.1,94175343,97683381,97683384,G,GGRT,3
NC_037333.1,NC_032655.1,94201168,97709212,97709213,G,GR,1
NC_037333.1,NC_032655.1,94242874,97750727,97750728,a,ac,1
NC_037333.1,NC_032655.1,94248768,97756617,97756620,c,catg,3
NC_037333.1,NC_032655.1,94258010,97765802,97765803,c,cg,1
NC_037333.1,NC_032655.1,94261090,97768882,97768885,g,gagt,3
NC_037333.1,NC_032655.1,94287311,97795029,97795030,a,ac,1
NC_037333.1,NC_032655.1,94288071,97795790,97795794,C,CATTA,4
NC_037333.1,NC_032655.1,94291478,97799199,97799200,C,CY,1
NC_037333.1,NC_032655.1,94319353,97827125,97827132,A,ATCTATTM,7
NC_037333.1,NC_032655.1,94416473,97923864,97923865,T,TG,1
NC_037333.1,NC_032655.1,94479085,97985184,97985186,t,tNN,2
NC_037333.1,NC_032655.1,94512825,98018925,98018926,C,CT,1
NC_037333.1,NC_032655.1,94531799,98037902,98037903,a,at,1
NC_037333.1,NC_032655.1,94738557,98244096,98244099,t,ttaa,3
NC_037333.1,NC_032655.1,94738661,98244203,98244204,T,TM,1
NC_037333.1,NC_032655.1,94742602,98248156,98248167,A,AGCCCTAGCTAT,11
NC_037333.1,NC_032655.1,95163921,98608044,98608046,a,aaN,2
NC_037333.1,NC_032655.1,95193723,98637778,98637779,T,TC,1
NC_037333.1,NC_032655.1,95259177,98705835,98705836,A,AR,1
NC_037333.1,NC_032655.1,95363190,98809868,98809869,g,ga,1
NC_037333.1,NC_032655.1,95372692,98819375,98819376,g,gN,1
NC_037333.1,NC_032655.1,95415380,98862047,98862049,a,atR,2
NC_037333.1,NC_032655.1,95512531,98957542,98957543,t,ta,1
NC_037333.1,NC_032655.1,95532456,98977235,98977236,g,gt,1
NC_037333.1,NC_032655.1,95532465,98977245,98977249,t,tatac,4
NC_037333.1,NC_032655.1,95542647,98987214,98987215,t,tg,1
NC_037333.1,NC_032655.1,95555603,99001076,99001079,c,cttt,3
NC_037333.1,NC_032655.1,95563861,99009337,99009338,c,ct,1
NC_037333.1,NC_032655.1,95575284,99020731,99020732,t,tg,1
NC_037333.1,NC_032655.1,95594581,99040077,99040078,a,at,1
NC_037333.1,NC_032655.1,95597140,99042633,99042666,c,cttctccatctttggctgcaaagaatataatcag,33
NC_037333.1,NC_032655.1,95599263,99044780,99044781,C,CT,1
NC_037333.1,NC_032655.1,95605077,99050594,99050596,t,tac,2
NC_037333.1,NC_032655.1,95769496,99258302,99258303,g,gc,1
NC_037333.1,NC_032655.1,95898957,99387313,99387314,a,aW,1
NC_037333.1,NC_032655.1,95901419,99389776,99389782,t,tNNNNNN,6
NC_037333.1,NC_032655.1,96042691,99531207,99531208,T,TA,1
NC_037333.1,NC_032655.1,96051837,99540355,99540356,t,ta,1
NC_037333.1,NC_032655.1,96051857,99540376,99540377,g,ga,1
NC_037333.1,NC_032655.1,96131184,99619086,99619087,c,ct,1
NC_037333.1,NC_032655.1,96203083,99717181,99717182,G,GR,1
NC_037333.1,NC_032655.1,96221256,99735363,99735368,T,TAATAG,5
NC_037333.1,NC_032655.1,96224816,99738947,99738948,A,AM,1
NC_037333.1,NC_032655.1,96226780,99740912,99740913,G,GC,1
NC_037333.1,NC_032655.1,96229732,99743867,99743874,c,caggggat,7
NC_037333.1,NC_032655.1,96241004,99755147,99755148,a,ag,1
NC_037333.1,NC_032655.1,96241043,99755187,99755189,c,cat,2
NC_037333.1,NC_032655.1,96352373,99985031,99985033,c,ctt,2
NC_037333.1,NC_032655.1,96378301,100029609,100029610,a,at,1
NC_037333.1,NC_032655.1,96426763,100078068,100078069,g,ga,1
NC_037333.1,NC_032655.1,96456580,100107892,100107893,a,ac,1
NC_037333.1,NC_032655.1,96465489,100116802,100116803,A,AM,1
NC_037333.1,NC_032655.1,96530028,100181693,100181695,T,TCA,2
NC_037333.1,NC_032655.1,96561520,100213135,100213136,T,TA,1
NC_037333.1,NC_032655.1,96581069,100287517,100287518,A,AT,1
NC_037333.1,NC_032655.1,96596623,100303040,100303041,T,TC,1
NC_037333.1,NC_032655.1,96623505,100323167,100323168,C,CA,1
NC_037333.1,NC_032655.1,96670097,100253938,100253939,t,ta,1
NC_037333.1,NC_032655.1,96675171,100259061,100259062,A,AM,1
NC_037333.1,NC_032655.1,96756020,100508631,100508632,c,ct,1
NC_037333.1,NC_032655.1,96833538,100585801,100585802,C,CT,1
NC_037333.1,NC_032655.1,96934795,100688253,100688254,c,ca,1
NC_037333.1,NC_032655.1,97065740,100819184,100819185,t,ta,1
NC_037333.1,NC_032655.1,97067673,100821151,100821153,a,aag,2
NC_037333.1,NC_032655.1,97067682,100821162,100821165,t,ttta,3
NC_037333.1,NC_032655.1,97073765,100827141,100827142,C,CT,1
NC_037333.1,NC_032655.1,97081964,100835353,100835354,c,ca,1
NC_037333.1,NC_032655.1,97083925,100837282,100837286,G,GACCA,4
NC_037333.1,NC_032655.1,97084391,100837752,100837753,A,AG,1
NC_037333.1,NC_032655.1,97096971,100850102,100850103,G,GT,1
NC_037333.1,NC_032655.1,97127737,100880940,100880941,a,ag,1
NC_037333.1,NC_032655.1,97138488,100891691,100891693,C,CTT,2
NC_037333.1,NC_032655.1,97315500,101068745,101068747,t,tNN,2
NC_037333.1,NC_032655.1,97352607,101105844,101105845,a,ag,1
NC_037333.1,NC_032655.1,97359733,101112976,101112977,a,at,1
NC_037333.1,NC_032655.1,97359746,101112990,101112993,t,tgga,3
NC_037333.1,NC_032655.1,97384229,101151587,101151588,G,GA,1
NC_037333.1,NC_032655.1,97385007,101152366,101152368,c,cta,2
NC_037333.1,NC_032655.1,97401366,101168601,101168602,T,TG,1
NC_037333.1,NC_032655.1,97411408,101178649,101178653,G,GACAC,4
NC_037333.1,NC_032655.1,97413703,101180942,101180946,T,TAAAK,4
NC_037333.1,NC_032655.1,97428527,101288022,101288023,T,TC,1
NC_037333.1,NC_032655.1,97431997,101291493,101291494,A,AT,1
NC_037333.1,NC_032655.1,97444010,101303543,101303556,T,TATAAGGGCATGAC,13
NC_037333.1,NC_032655.1,97449399,101308939,101308940,a,ac,1
NC_037333.1,NC_032655.1,97449453,101308994,101309000,c,cttcact,6
NC_037333.1,NC_032655.1,97449599,101309146,101309158,t,tagcagcagcagc,12
NC_037333.1,NC_032655.1,97449723,101309276,101309278,t,tac,2
NC_037333.1,NC_032655.1,97461379,101320001,101320002,A,AC,1
NC_037333.1,NC_032655.1,97461394,101320017,101320018,A,AC,1
NC_037333.1,NC_032655.1,97477923,101336577,101336592,T,TCATAGTTCATAAACC,15
NC_037333.1,NC_032655.1,97494891,101353560,101353561,t,ta,1
NC_037333.1,NC_032655.1,97510419,101369089,101369103,c,ctgcttCTNNNNNNN,14
NC_037333.1,NC_032655.1,97576175,101433597,101433599,T,TAG,2
NC_037333.1,NC_032655.1,97614427,101471885,101471894,C,CTTGCTTCAG,9
NC_037333.1,NC_032655.1,97622413,101479879,101479880,c,ca,1
NC_037333.1,NC_032655.1,97701116,101563655,101563657,T,TTC,2
NC_037333.1,NC_032655.1,97708430,101570971,101570973,T,TAA,2
NC_037333.1,NC_032655.1,98165608,102037615,102037619,c,ctgta,4
NC_037333.1,NC_032655.1,98169155,102041558,102041559,A,AG,1
NC_037333.1,NC_032655.1,98169851,102042255,102042268,t,tccatgcatgacta,13
NC_037333.1,NC_032655.1,98202992,102075384,102075386,A,ATT,2
NC_037333.1,NC_032655.1,98205737,102078132,102078133,a,ac,1
NC_037333.1,NC_032655.1,98206421,102078804,102078805,g,ga,1
NC_037333.1,NC_032655.1,98210298,102082659,102082660,A,AT,1
NC_037333.1,NC_032655.1,98210434,102082796,102082799,T,TACG,3
NC_037333.1,NC_032655.1,98235577,102107804,102107806,t,ttg,2
NC_037333.1,NC_032655.1,98253498,102125697,102125699,A,AAG,2
NC_037333.1,NC_032655.1,98255989,102128191,102128192,T,TA,1
NC_037333.1,NC_032655.1,98336393,102312546,102312547,A,AR,1
NC_037333.1,NC_032655.1,98338582,102314730,102314733,g,ggaa,3
NC_037333.1,NC_032655.1,98404514,102380802,102380803,T,TA,1
NC_037333.1,NC_032655.1,98412971,102389269,102389270,A,AT,1
NC_037333.1,NC_032655.1,98483471,102459852,102459853,G,GC,1
NC_037333.1,NC_032655.1,98491785,102467764,102467770,c,cttatgt,6
NC_037333.1,NC_032655.1,98587289,102562511,102562512,a,at,1
NC_037333.1,NC_032655.1,98643290,102725890,102725891,t,ta,1
NC_037333.1,NC_032655.1,98654944,102737305,102737311,A,ACTTAGC,6
NC_037333.1,NC_032655.1,98676823,102759191,102759193,t,tta,2
NC_037333.1,NC_032655.1,98726860,102807289,102807290,C,CG,1
NC_037333.1,NC_032655.1,98749395,102830149,102830157,t,tgacttagc,8
NC_037333.1,NC_032655.1,98749823,102830585,102830586,C,CT,1
NC_037333.1,NC_032655.1,98803985,102888566,102888567,a,ag,1
NC_037333.1,NC_032655.1,99035270,103107142,103107158,g,gcctggcgggctacagt,16
NC_037333.1,NC_032655.1,99041986,103113874,103113884,a,aNNNNNNNNNN,10
NC_037333.1,NC_032655.1,99096540,103168010,103168011,a,at,1
NC_037333.1,NC_032655.1,99099625,103171095,103171099,G,GTATC,4
NC_037333.1,NC_032655.1,99109156,103180636,103180637,t,tc,1
NC_037333.1,NC_032655.1,99109184,103180665,103180666,c,ct,1
NC_037333.1,NC_032655.1,99228313,103302984,103302986,c,cct,2
NC_037333.1,NC_032655.1,99262727,103337400,103337404,t,tNNNN,4
NC_037333.1,NC_032655.1,99326082,103400816,103400817,t,tc,1
NC_037333.1,NC_032655.1,99335548,103410283,103410284,t,ta,1
NC_037333.1,NC_032655.1,99335554,103410290,103410291,a,at,1
NC_037333.1,NC_032655.1,99349485,103424224,103424225,A,AG,1
NC_037333.1,NC_032655.1,99353149,103427891,103427892,a,ac,1
NC_037333.1,NC_032655.1,99388911,103463577,103463581,c,ctgtg,4
NC_037333.1,NC_032655.1,99436703,103511360,103511363,a,aaat,3
NC_037333.1,NC_032655.1,99436737,103511397,103511401,g,gagaa,4
NC_037333.1,NC_032655.1,99445962,103520630,103520631,T,TC,1
NC_037333.1,NC_032655.1,99449428,103524100,103524101,T,TY,1
NC_037333.1,NC_032655.1,99462398,103557431,103557433,t,ttg,2
NC_037333.1,NC_032655.1,99485902,103564187,103564188,c,ct,1
NC_037333.1,NC_032655.1,99486025,103564311,103564313,t,ttg,2
NC_037333.1,NC_032655.1,99486963,103565251,103565258,A,ATCATAAG,7
NC_037333.1,NC_032655.1,99521893,103600191,103600192,t,tg,1
NC_037333.1,NC_032655.1,99539496,103617802,103617803,A,AC,1
NC_037333.1,NC_032655.1,99613427,103693811,103693812,t,tc,1
NC_037333.1,NC_032655.1,99613493,103693878,103693879,c,ct,1
NC_037333.1,NC_032655.1,99697260,103756641,103756642,C,CM,1
NC_037333.1,NC_032655.1,99699106,103758487,103758491,G,GTAAC,4
NC_037333.1,NC_032655.1,99755893,103815352,103815353,c,ca,1
NC_037333.1,NC_032655.1,99765766,103825346,103825347,T,TC,1
NC_037333.1,NC_032655.1,99765769,103825350,103825351,A,AT,1
NC_037333.1,NC_032655.1,99861592,103921488,103921489,G,GC,1
NC_037333.1,NC_032655.1,99906691,103972014,103972054,G,GANNNNNNNNNNNNNNNNNNNNNNNNNNNNNNNNNNNNNNN,40
NC_037333.1,NC_032655.1,99935530,104000879,104000881,a,aNN,2
NC_037333.1,NC_032655.1,99939292,104004671,104004672,g,ga,1
NC_037333.1,NC_032655.1,99996515,104061848,104061849,a,ac,1
NC_037333.1,NC_032655.1,100018429,104083658,104083659,a,ac,1
NC_037333.1,NC_032655.1,100089310,104155624,104155625,a,at,1
NC_037333.1,NC_032655.1,100188873,104301639,104301640,A,AC,1
NC_037333.1,NC_032655.1,100224606,104337395,104337396,A,AC,1
NC_037333.1,NC_032655.1,100226145,104338935,104338937,g,gKK,2
NC_037333.1,NC_032655.1,100232932,104345725,104345726,A,AR,1
NC_037333.1,NC_032655.1,100237218,104350015,104350020,c,cagcag,5
NC_037333.1,NC_032655.1,100237588,104350390,104350391,g,ga,1
NC_037333.1,NC_032655.1,100237975,104350778,104350779,t,tN,1
NC_037333.1,NC_032655.1,100241628,104354437,104354441,C,CAGTT,4
NC_037333.1,NC_032655.1,100252197,104365007,104365008,g,gc,1
NC_037333.1,NC_032655.1,100269340,104382153,104382161,G,GWAAACAAA,8
NC_037333.1,NC_032655.1,100292542,104405370,104405371,t,tg,1
NC_037333.1,NC_032655.1,100297173,104410002,104410003,t,ta,1
NC_037333.1,NC_032655.1,100297680,104410510,104410511,C,CT,1
NC_037333.1,NC_032655.1,100341003,104454131,104454132,G,GA,1
NC_037333.1,NC_032655.1,100375553,104488677,104488683,a,aNNNNNN,6
NC_037333.1,NC_032655.1,100471696,104584438,104584439,G,GA,1
NC_037333.1,NC_032655.1,100488049,104600791,104600792,a,ag,1
NC_037333.1,NC_032655.1,100488861,104601605,104601606,A,AT,1
NC_037333.1,NC_032655.1,100490820,104603566,104603568,t,ttK,2
NC_037333.1,NC_032655.1,100508859,104621617,104621618,G,GT,1
NC_037333.1,NC_032655.1,100511023,104623782,104623785,T,TAAC,3
NC_037333.1,NC_032655.1,100511308,104624070,104624072,G,GAA,2
NC_037333.1,NC_032655.1,100551783,104664553,104664558,t,tttttg,5
NC_037333.1,NC_032655.1,100553126,104665901,104665902,t,ta,1
NC_037333.1,NC_032655.1,100582821,104695278,104695279,t,ta,1
NC_037333.1,NC_032655.1,100635756,104748227,104748229,T,TAA,2
NC_037333.1,NC_032655.1,100898820,105011501,105011502,C,CT,1
NC_037333.1,NC_032655.1,100924820,105037503,105037504,t,ta,1
NC_037333.1,NC_032655.1,100926327,105039036,105039037,a,ac,1
NC_037333.1,NC_032655.1,100988343,105127904,105127905,a,at,1
NC_037333.1,NC_032655.1,101183003,105321766,105321767,G,GC,1
NC_037333.1,NC_032655.1,101189350,105328114,105328115,g,ga,1
NC_037333.1,NC_032655.1,101271880,105410859,105410862,T,TTGA,3
NC_037333.1,NC_032655.1,101276362,105415346,105415349,a,aaac,3
NC_037333.1,NC_032655.1,101291787,105430774,105430775,T,TC,1
NC_037333.1,NC_032655.1,101292819,105431805,105431808,t,taaa,3
NC_037333.1,NC_032655.1,101292874,105431863,105431865,C,CTY,2
NC_037333.1,NC_032655.1,101317060,105456054,105456056,C,CAG,2
NC_037333.1,NC_032655.1,101397349,105538023,105538025,a,aNN,2
NC_037333.1,NC_032655.1,101446123,105586801,105586803,t,ttg,2
NC_037333.1,NC_032655.1,101457354,105598058,105598061,T,TTGA,3
NC_037333.1,NC_032655.1,101458734,105599441,105599443,c,cca,2
NC_037333.1,NC_032655.1,101461444,105602152,105602153,C,CG,1
NC_037333.1,NC_032655.1,101465916,105606624,105606625,G,GA,1
NC_037333.1,NC_032655.1,101469265,105609978,105609979,T,TW,1
NC_037333.1,NC_032655.1,101478063,105618775,105618776,g,ga,1
NC_037333.1,NC_032655.1,101529627,105672830,105672831,t,tW,1
NC_037333.1,NC_032655.1,101550249,105693484,105693488,T,TCAAC,4
NC_037333.1,NC_032655.1,101567327,105710568,105710569,C,CA,1
NC_037333.1,NC_032655.1,101588487,105731812,105731813,t,tc,1
NC_037333.1,NC_032655.1,101598654,105741980,105741981,a,at,1
NC_037333.1,NC_032655.1,101617795,105761121,105761122,A,AG,1
NC_037333.1,NC_032655.1,101680327,105823636,105823638,t,ttg,2
NC_037333.1,NC_032655.1,101721372,105864679,105864680,A,AC,1
NC_037333.1,NC_032655.1,101721431,105864739,105864740,T,TA,1
NC_037333.1,NC_032655.1,101724676,105913046,105913047,g,gt,1
NC_037333.1,NC_032655.1,101738271,105926639,105926641,C,CAT,2
NC_037333.1,NC_032655.1,101749135,105937505,105937507,G,GTT,2
NC_037333.1,NC_032655.1,101889361,106046748,106046749,g,ga,1
NC_037333.1,NC_032655.1,101903072,106060467,106060469,a,aag,2
NC_037333.1,NC_032655.1,101917552,106074954,106074955,g,ga,1
NC_037333.1,NC_032655.1,101918884,106076289,106076300,T,TATCTTATGTAC,11
NC_037333.1,NC_032655.1,101939054,106096482,106096483,T,TY,1
NC_037333.1,NC_032655.1,101990802,106148235,106148236,g,gc,1
NC_037333.1,NC_032655.1,102016061,106173502,106173506,t,tNNNN,4
NC_037333.1,NC_032655.1,102026328,106183766,106183767,t,tc,1
NC_037333.1,NC_032655.1,102028940,106186351,106186352,T,TG,1
NC_037333.1,NC_032655.1,102030723,106188134,106188137,T,TTAA,3
NC_037333.1,NC_032655.1,102038933,106196347,106196348,G,GR,1
NC_037333.1,NC_032655.1,102043087,106200502,106200503,c,ct,1
NC_037333.1,NC_032655.1,102050054,106207470,106207476,G,GTCGCTT,6
NC_037333.1,NC_032655.1,102140224,106296492,106296493,c,cY,1
NC_037333.1,NC_032655.1,102140784,106297053,106297054,A,AR,1
NC_037333.1,NC_032655.1,102196840,106353447,106353452,g,gactga,5
NC_037333.1,NC_032655.1,102198163,106354775,106354776,A,AT,1
NC_037333.1,NC_032655.1,102199491,106356100,106356101,g,ga,1
NC_037333.1,NC_032655.1,102202223,106358785,106358786,g,gt,1
NC_037333.1,NC_032655.1,102204218,106360677,106360678,C,CA,1
NC_037333.1,NC_032655.1,102215012,106371474,106371480,t,ttcagtc,6
NC_037333.1,NC_032655.1,102296771,106453118,106453119,T,TA,1
NC_037333.1,NC_032655.1,102490077,106646365,106646366,G,GC,1
NC_037333.1,NC_032655.1,102528748,106665182,106665183,a,ac,1
NC_037333.1,NC_032655.1,102536707,106673114,106673115,C,CY,1
NC_037333.1,NC_032655.1,102575323,106764924,106764926,c,caa,2
NC_037333.1,NC_032655.1,102577901,106767504,106767505,G,GK,1
NC_037333.1,NC_032655.1,102578450,106768054,106768055,c,ct,1
NC_037333.1,NC_032655.1,102606609,106793783,106793784,C,CM,1
NC_037333.1,NC_032655.1,102610939,106798107,106798109,c,ctt,2
NC_037333.1,NC_032655.1,102612695,106799865,106799866,c,ca,1
NC_037333.1,NC_032655.1,102623792,106810969,106810970,c,ct,1
NC_037333.1,NC_032655.1,102625559,106812737,106812738,G,GR,1
NC_037333.1,NC_032655.1,102642155,106829335,106829336,T,TC,1
NC_037333.1,NC_032655.1,102645680,106832863,106832864,C,CM,1
NC_037333.1,NC_032655.1,102652644,106839830,106839831,c,ct,1
NC_037333.1,NC_032655.1,102659008,106846199,106846201,t,tac,2
NC_037333.1,NC_032655.1,102674101,106861306,106861313,C,CCCAGACT,7
NC_037333.1,NC_032655.1,102674679,106861891,106861892,A,AG,1
NC_037333.1,NC_032655.1,102677800,106865001,106865024,c,cactcactcagtttGCTSTGTgaa,23
NC_037333.1,NC_032655.1,102706806,106894080,106894082,a,aNN,2
NC_037333.1,NC_032655.1,102792241,107009949,107009950,A,AR,1
NC_037333.1,NC_032655.1,102856187,107073774,107073775,T,TC,1
NC_037333.1,NC_032655.1,102949666,107151409,107151412,g,gttc,3
NC_037333.1,NC_032655.1,103062116,107270003,107270005,T,TTC,2
NC_037333.1,NC_032655.1,103062293,107270182,107270183,T,TC,1
NC_037333.1,NC_032655.1,103097852,107305784,107305791,G,GTCTTCTT,7
NC_037333.1,NC_032655.1,103172023,107430234,107430235,A,AC,1
NC_037333.1,NC_032655.1,103208247,107465900,107465901,G,GY,1
NC_037333.1,NC_032655.1,103208252,107465906,107465907,G,GA,1
NC_037333.1,NC_032655.1,103210962,107468615,107468616,C,CT,1
NC_037333.1,NC_032655.1,103214234,107471926,107471930,a,atgtg,4
NC_037333.1,NC_032655.1,103216624,107474320,107474321,t,ta,1
NC_037333.1,NC_032655.1,103218123,107475817,107475818,t,tc,1
NC_037333.1,NC_032655.1,103223249,107480943,107480945,A,AGC,2
NC_037333.1,NC_032655.1,103233037,107490729,107490733,G,GTCAA,4
NC_037333.1,NC_032655.1,103264110,107521806,107521807,a,ag,1
NC_037333.1,NC_032655.1,103270622,107528313,107528322,c,ctaattttca,9
NC_037333.1,NC_032655.1,103270962,107528662,107528663,A,AT,1
NC_037333.1,NC_032655.1,103273309,107531008,107531049,T,TGCANNNNNNNNNNNNNNNNNNNNNNNNNNNNNNNNNNNNNN,41
NC_037333.1,NC_032655.1,103278542,107536283,107536284,T,TG,1
NC_037333.1,NC_032655.1,103289255,107546994,107546995,C,CR,1
NC_037333.1,NC_032655.1,103289271,107547011,107547012,G,GA,1
NC_037333.1,NC_032655.1,103305190,107562929,107562930,C,CG,1
NC_037333.1,NC_032655.1,103364361,107621885,107621894,C,CCCACCCCCY,9
NC_037333.1,NC_032655.1,103392619,107650534,107650536,A,AAG,2
NC_037333.1,NC_032655.1,103403121,107661038,107661039,A,AG,1
NC_037333.1,NC_032655.1,103406607,107664524,107664527,G,GNNN,3
NC_037333.1,NC_032655.1,103424512,107682450,107682451,c,ca,1
NC_037333.1,NC_032655.1,103456526,107714466,107714486,A,ATTNNNNNNNNNNNNNNNNNN,20
NC_037333.1,NC_032655.1,103479615,107737581,107737582,T,TG,1
NC_037333.1,NC_032655.1,103480208,107738175,107738210,G,GACTGGGCACTTCGGCAATTTAGAGCGTGGACTGCT,35
NC_037333.1,NC_032655.1,103485299,107743301,107743307,c,ctttttt,6
NC_037333.1,NC_032655.1,103508871,107766885,107766886,A,AW,1
NC_037333.1,NC_032655.1,103509376,107767391,107767392,G,GT,1
NC_037333.1,NC_032655.1,103520823,107778839,107778840,a,at,1
NC_037333.1,NC_032655.1,103561061,108001727,108001728,g,gt,1
NC_037333.1,NC_032655.1,103572290,107900602,107900708,g,gNNNNNNNNNNNNNNNNNNNNNNNNNNNNNNNNNNNNNNNNNNNNNNNNNNNNNNNNNNNNNNNNNNNNNNNNNNNNNNNNNNNNNNNNNNNNNNNNNNNNNNNNNN,106
NC_037333.1,NC_032655.1,103722246,108219884,108219885,g,gc,1
NC_037333.1,NC_032655.1,103794101,108299193,108299197,c,ccagt,4
NC_037333.1,NC_032655.1,103801451,108306547,108306548,T,TC,1
NC_037333.1,NC_032655.1,103834933,108340197,108340198,G,GT,1
NC_037333.1,NC_032655.1,103846338,108351603,108351605,a,aNN,2
NC_037333.1,NC_032655.1,104590551,109175361,109175362,C,CT,1
NC_037333.1,NC_032655.1,104598253,109183065,109183066,t,tc,1
NC_037333.1,NC_032655.1,104680583,109076323,109076324,t,ta,1
NC_037333.1,NC_032655.1,104692197,109087933,109087947,t,tcacacacacacaca,14
NC_037333.1,NC_032655.1,104709321,109105077,109105078,G,GR,1
NC_037333.1,NC_032655.1,104761199,109384996,109384997,C,CT,1
NC_037333.1,NC_032655.1,104764806,109388604,109388605,c,cM,1
NC_037333.1,NC_032655.1,104801829,109425443,109425444,T,TW,1
NC_037333.1,NC_032655.1,105068926,109523067,109523068,t,tc,1
NC_037333.1,NC_032655.1,105091729,109545773,109545774,t,tg,1
NC_037333.1,NC_032655.1,105101348,109555388,109555389,A,AW,1
NC_037333.1,NC_032655.1,105139825,109593549,109593550,C,CT,1
NC_037333.1,NC_032655.1,105145888,109599700,109599703,C,CCTT,3
NC_037333.1,NC_032655.1,105190379,109660888,109660890,C,CCA,2
NC_037333.1,NC_032655.1,105218888,109689434,109689435,g,gT,1
NC_037333.1,NC_032655.1,105288283,109759928,109759934,G,GGAACCA,6
NC_037333.1,NC_032655.1,105310277,109781928,109781929,A,AR,1
NC_037333.1,NC_032655.1,105336326,109808363,109808364,T,TC,1
NC_037333.1,NC_032655.1,105406079,109888808,109888811,T,TCTG,3
NC_037333.1,NC_032655.1,105406133,109888865,109888867,C,CTT,2
NC_037333.1,NC_032655.1,105432305,109915043,109915045,C,CAG,2
NC_037333.1,NC_032655.1,105452554,109935295,109935296,g,ga,1
NC_037333.1,NC_032655.1,105454945,109937649,109937669,C,CTCTAGGTTTTCTCAAGTTTA,20
NC_037333.1,NC_032655.1,105503136,109986097,109986098,C,CG,1
NC_037333.1,NC_032655.1,105503921,109986883,109986884,C,CG,1
NC_037333.1,NC_032655.1,105504903,109993775,109993776,T,TK,1
NC_037333.1,NC_032655.1,105506095,109994968,109994969,G,GR,1
NC_037333.1,NC_032655.1,105510963,109999837,109999839,c,ccg,2
NC_037333.1,NC_032655.1,105527089,110015962,110015963,G,GA,1
NC_037333.1,NC_032655.1,105527693,110016567,110016570,t,tctc,3
NC_037333.1,NC_032655.1,105534303,110023180,110023182,g,gga,2
NC_037333.1,NC_032655.1,105537042,110025925,110025926,T,TC,1
NC_037333.1,NC_032655.1,105574604,110063391,110063393,g,gtR,2
NC_037333.1,NC_032655.1,105606384,110095153,110095154,g,ga,1
NC_037333.1,NC_032655.1,105616125,110104502,110104503,t,ta,1
NC_037333.1,NC_032655.1,105629048,110117431,110117440,C,CAGTACAGTT,9
NC_037333.1,NC_032655.1,105633275,110121587,110121588,A,AR,1
NC_037333.1,NC_032655.1,105636533,110124846,110124848,A,AAR,2
NC_037333.1,NC_032655.1,105675011,110209645,110209646,A,AT,1
NC_037333.1,NC_032655.1,105700970,110235611,110235612,G,GR,1
NC_037333.1,NC_032655.1,105717501,110252150,110252152,T,TTC,2
NC_037333.1,NC_032655.1,105848162,110381531,110381532,T,TG,1
NC_037333.1,NC_032655.1,105848180,110381550,110381551,C,CT,1
NC_037333.1,NC_032655.1,106011683,110542867,110542871,a,aaaat,4
NC_037333.1,NC_032655.1,106023464,110581714,110581716,c,ctt,2
NC_037333.1,NC_032655.1,106027472,110585720,110585721,T,TC,1
NC_037333.1,NC_032655.1,106027994,110586241,110586242,G,GA,1
NC_037333.1,NC_032655.1,106028669,110586917,110586918,t,tK,1
NC_037333.1,NC_032655.1,106055428,110611798,110611805,a,acaaagtg,7
NC_037333.1,NC_032655.1,106089950,110646768,110646770,A,ATC,2
NC_037333.1,NC_032655.1,106091474,110648297,110648300,t,tccc,3
NC_037333.1,NC_032655.1,106092420,110649851,110649852,c,cY,1
NC_037333.1,NC_032655.1,106104815,110662246,110662247,a,ag,1
NC_037333.1,NC_032655.1,106123603,110681050,110681064,t,tcgtgtctgactctg,14
NC_037333.1,NC_032655.1,106173297,110730732,110730733,t,tg,1
NC_037333.1,NC_032655.1,106190334,110747780,110747781,A,AG,1
NC_037333.1,NC_032655.1,106265649,110824759,110824760,g,gt,1
NC_037333.1,NC_032655.1,106286732,110845847,110845849,a,agt,2
NC_037333.1,NC_032655.1,106323614,110882734,110882735,A,AT,1
NC_037333.1,NC_032655.1,106373339,110932468,110932472,C,CCAAA,4
NC_037333.1,NC_032655.1,106387423,110946561,110946562,C,CT,1
NC_037333.1,NC_032655.1,106577475,111136745,111136746,a,at,1
NC_037333.1,NC_032655.1,106595045,111153171,111153172,G,GK,1
NC_037333.1,NC_032655.1,106632185,111190244,111190245,t,ta,1
NC_037333.1,NC_032655.1,106657686,111215570,111215571,G,GR,1
NC_037333.1,NC_032655.1,106666758,111224644,111224645,A,AW,1
NC_037333.1,NC_032655.1,106726170,111284522,111284530,A,AGATTGAAT,8
NC_037333.1,NC_032655.1,106749345,111307531,111307532,a,at,1
NC_037333.1,NC_032655.1,106753485,111311525,111311526,A,AC,1
NC_037333.1,NC_032655.1,106770108,111328147,111328148,t,tg,1
NC_037333.1,NC_032655.1,106770108,111452180,111452181,t,tg,1
NC_037333.1,NC_032655.1,106774413,111332495,111332498,g,gaga,3
NC_037333.1,NC_032655.1,106774413,111447830,111447833,g,gaga,3
NC_037333.1,NC_032655.1,106790363,111348410,111348411,T,TN,1
NC_037333.1,NC_032655.1,106816860,111374949,111374950,t,tg,1
NC_037333.1,NC_032655.1,106848655,111469918,111469920,t,ttg,2
NC_037333.1,NC_032655.1,106863930,111485192,111485193,G,GR,1
NC_037333.1,NC_032655.1,106886268,111507548,111507549,a,ac,1
NC_037333.1,NC_032655.1,106961556,111582855,111582856,a,ac,1
NC_037333.1,NC_032655.1,106964459,111585758,111585759,T,TK,1
NC_037333.1,NC_032655.1,106971877,111593180,111593181,T,TK,1
NC_037333.1,NC_032655.1,106972366,111593670,111593672,a,aag,2
NC_037333.1,NC_032655.1,106978339,111599648,111599649,a,at,1
NC_037333.1,NC_032655.1,107065354,111687328,111687329,C,CA,1
NC_037333.1,NC_032655.1,107100491,111722468,111722470,c,ctt,2
NC_037333.1,NC_032655.1,107104745,111726725,111726726,G,GR,1
NC_037333.1,NC_032655.1,107143896,111765632,111765633,A,AW,1
NC_037333.1,NC_032655.1,107147423,111769156,111769158,a,aat,2
NC_037333.1,NC_032655.1,107161843,111783583,111783584,g,ga,1
NC_037333.1,NC_032655.1,107161899,111783640,111783641,t,ta,1
NC_037333.1,NC_032655.1,107199885,111821875,111821876,T,TC,1
NC_037333.1,NC_032655.1,107214620,111836605,111836606,A,AW,1
NC_037333.1,NC_032655.1,107274790,111896610,111896611,G,GR,1
NC_037333.1,NC_032655.1,107319405,111940816,111940818,A,ATC,2
NC_037333.1,NC_032655.1,107334957,111957633,111957635,A,AAR,2
NC_037333.1,NC_032655.1,107352925,111975603,111975604,A,AR,1
NC_037333.1,NC_032655.1,107377587,112000275,112000279,A,ACTST,4
NC_037333.1,NC_032655.1,107385283,112007978,112007979,t,ta,1
NC_037333.1,NC_032655.1,107419689,112042397,112042398,a,ac,1
NC_037333.1,NC_032655.1,107428108,112050817,112050819,a,agg,2
NC_037333.1,NC_032655.1,107438181,112060606,112060616,a,aaaaaaaaaac,10
NC_037333.1,NC_032655.1,107442234,112064666,112064667,c,ca,1
NC_037333.1,NC_032655.1,107498026,112127566,112127567,A,AG,1
NC_037333.1,NC_032655.1,107518407,112147955,112147965,t,tNNNNNNNNNN,10
NC_037333.1,NC_032655.1,107537472,112167026,112167045,t,tatatatatatatatatata,19
NC_037333.1,NC_032655.1,107549942,112178561,112178562,t,tc,1
NC_037333.1,NC_032655.1,107581373,112210000,112210003,g,gaaa,3
NC_037333.1,NC_032655.1,107581700,112210425,112210427,A,ACT,2
NC_037333.1,NC_032655.1,107600732,112229435,112229438,a,aaac,3
NC_037333.1,NC_032655.1,107611134,112240191,112240192,C,CA,1
NC_037333.1,NC_032655.1,107614504,112243592,112243599,g,gtgtgtgt,7
NC_037333.1,NC_032655.1,107616683,112245777,112245779,T,TAA,2
NC_037333.1,NC_032655.1,107620172,112249268,112249270,c,ctg,2
NC_037333.1,NC_032655.1,107724979,112373468,112373469,G,GC,1
NC_037333.1,NC_032655.1,107757337,112405827,112405828,t,ta,1
NC_037333.1,NC_032655.1,107815702,112470020,112470021,c,ct,1
NC_037333.1,NC_032655.1,107889764,112543971,112543972,c,ct,1
NC_037333.1,NC_032655.1,107889834,112544042,112544043,t,tc,1
NC_037333.1,NC_032655.1,107889844,112544053,112544054,t,tc,1
NC_037333.1,NC_032655.1,107928419,112582491,112582492,A,AC,1
NC_037333.1,NC_032655.1,107969204,112623683,112623689,t,tNNNNNN,6
NC_037333.1,NC_032655.1,107978405,112632969,112632970,c,ct,1
NC_037333.1,NC_032655.1,107983877,112638440,112638448,g,gtttttttt,8
NC_037333.1,NC_032655.1,107988582,112643047,112643055,t,ttatatata,8
NC_037333.1,NC_032655.1,108018638,112673554,112673560,t,ttagtag,6
NC_037333.1,NC_032655.1,108085497,112735543,112735551,a,aatatatat,8
NC_037333.1,NC_032655.1,108093784,112743839,112743847,t,taaaaagac,8
NC_037333.1,NC_032655.1,108105918,112755982,112755991,g,gggaaacagt,9
NC_037333.1,NC_032655.1,108108040,112758109,112758110,T,TA,1
NC_037333.1,NC_032655.1,108165008,112814741,112814742,T,TC,1
NC_037333.1,NC_032655.1,108174655,112824385,112824386,g,gt,1
NC_037333.1,NC_032655.1,108241268,112891001,112891003,a,aag,2
NC_037333.1,NC_032655.1,108241916,112891640,112891642,T,TTC,2
NC_037333.1,NC_032655.1,108242575,112892301,112892302,g,gt,1
NC_037333.1,NC_032655.1,108242606,112892333,112892357,g,gttggagaagactcttgagagtccc,24
NC_037333.1,NC_032655.1,108243518,112893271,112893273,A,AGT,2
NC_037333.1,NC_032655.1,108272773,112922175,112922176,a,ag,1
NC_037333.1,NC_032655.1,108336067,113098837,113098838,T,TC,1
NC_037333.1,NC_032655.1,108433739,113060109,113060110,c,ca,1
NC_037333.1,NC_032655.1,108456547,113075672,113075673,A,AM,1
NC_037333.1,NC_032655.1,108466867,113154293,113154294,T,TA,1
NC_037333.1,NC_032655.1,108466930,113154357,113154358,T,TA,1
NC_037333.1,NC_032655.1,108482777,113170207,113170215,t,tNNNNNNNN,8
NC_037333.1,NC_032655.1,108501766,113189206,113189207,A,AC,1
NC_037333.1,NC_032655.1,108554110,113266562,113266563,t,tg,1
NC_037333.1,NC_032655.1,108554118,113266571,113266572,g,gt,1
NC_037333.1,NC_032655.1,108604487,113318629,113318630,a,aN,1
NC_037333.1,NC_032655.1,108729377,113442221,113442222,T,TA,1
NC_037333.1,NC_032655.1,108766196,113479048,113479049,t,ta,1
NC_037333.1,NC_032655.1,108836526,113549432,113549438,c,caaaaaa,6
NC_037333.1,NC_032655.1,108867625,113581358,113581359,t,tc,1
NC_037333.1,NC_032655.1,108905759,113622268,113622269,T,TY,1
NC_037333.1,NC_032655.1,108917903,113634412,113634436,T,TTCTGTGCAAAAGTTACCAAAATAA,24
NC_037333.1,NC_032655.1,108926645,113643178,113643179,t,ta,1
NC_037333.1,NC_032655.1,108934591,113651125,113651126,G,GA,1
NC_037333.1,NC_032655.1,109067977,113784011,113784013,C,CTA,2
NC_037333.1,NC_032655.1,109128379,113844521,113844522,A,AR,1
NC_037333.1,NC_032655.1,109138448,113854925,113854926,t,tg,1
NC_037333.1,NC_032655.1,109138491,113854969,113854970,T,TA,1
NC_037333.1,NC_032655.1,109139498,113855977,113855978,t,ta,1
NC_037333.1,NC_032655.1,109167935,113884386,113884387,t,tc,1
NC_037333.1,NC_032655.1,109199049,113915552,113915554,a,aaM,2
NC_037333.1,NC_032655.1,109208804,113925334,113925337,T,TTTA,3
NC_037333.1,NC_032655.1,109216991,113933546,113933547,a,at,1
NC_037333.1,NC_032655.1,109217704,113934260,113934261,a,ag,1
NC_037333.1,NC_032655.1,109217853,113934410,113934411,c,ct,1
NC_037333.1,NC_032655.1,109220900,113937444,113937446,T,TTC,2
NC_037333.1,NC_032655.1,109234311,113950860,113950861,T,TK,1
NC_037333.1,NC_032655.1,109234529,113951079,113951080,T,TA,1
NC_037333.1,NC_032655.1,109240110,113956662,113956663,t,tc,1
NC_037333.1,NC_032655.1,109258807,113977473,113977474,A,AR,1
NC_037333.1,NC_032655.1,109258867,113977534,113977535,C,CA,1
NC_037333.1,NC_032655.1,109262533,113981194,113981197,c,cctg,3
NC_037333.1,NC_032655.1,109263278,113981919,113981920,T,TY,1
NC_037333.1,NC_032655.1,109277327,113995971,113995972,T,TC,1
NC_037333.1,NC_032655.1,109282679,114001317,114001318,T,TA,1
NC_037333.1,NC_032655.1,109284968,114003609,114003635,t,tctgcctcttgagaaatctgtatgcag,26
NC_037333.1,NC_032655.1,109448784,114179423,114179425,C,CAA,2
NC_037333.1,NC_032655.1,109464089,114194726,114194729,a,atat,3
NC_037333.1,NC_032655.1,109550465,114281690,114281691,g,gt,1
NC_037333.1,NC_032655.1,109629470,114360600,114360604,t,tacac,4
NC_037333.1,NC_032655.1,109633082,114364215,114364216,A,AW,1
NC_037333.1,NC_032655.1,109663722,114394515,114394518,G,GGAA,3
NC_037333.1,NC_032655.1,109671560,114402540,114402541,a,ag,1
NC_037333.1,NC_032655.1,109683570,114414548,114414549,T,TC,1
NC_037333.1,NC_032655.1,109683590,114414569,114414570,A,AG,1
NC_037333.1,NC_032655.1,109700300,114431315,114431316,A,AW,1
NC_037333.1,NC_032655.1,109707054,114438056,114438059,a,aagg,3
NC_037333.1,NC_032655.1,109787778,114516583,114516584,T,TG,1
NC_037333.1,NC_032655.1,109821392,114548706,114548714,G,GTGATCCAT,8
NC_037333.1,NC_032655.1,109850020,114577337,114577338,c,ct,1
NC_037333.1,NC_032655.1,109868068,114595422,114595424,T,TAC,2
NC_037333.1,NC_032655.1,109884737,114612204,114612205,c,ca,1
NC_037333.1,NC_032655.1,110078152,114793119,114793120,G,GC,1
NC_037333.1,NC_032655.1,110086819,114801788,114801789,c,ct,1
NC_037333.1,NC_032655.1,110105591,114820553,114820554,A,AT,1
NC_037333.1,NC_032655.1,110106950,114821878,114821879,c,ca,1
NC_037333.1,NC_032655.1,110156419,114869929,114869931,g,gtt,2
NC_037333.1,NC_032655.1,110166135,114879648,114879649,C,CA,1
NC_037333.1,NC_032655.1,110243070,114956611,114956612,C,CS,1
NC_037333.1,NC_032655.1,110251174,114964717,114964718,a,aN,1
NC_037333.1,NC_032655.1,110251484,114965036,114965037,c,ct,1
NC_037333.1,NC_032655.1,110255302,114968854,114968864,C,CYCTTCCTCTG,10
NC_037333.1,NC_032655.1,110283956,114997520,114997521,t,tg,1
NC_037333.1,NC_032655.1,110283993,114997558,114997559,c,ct,1
NC_037333.1,NC_032655.1,110302266,115015841,115015842,C,CT,1
NC_037333.1,NC_032655.1,110405620,115110786,115110787,t,tg,1
NC_037333.1,NC_032655.1,110419657,115124825,115124826,C,CT,1
NC_037333.1,NC_032655.1,110425930,115131384,115131385,t,tY,1
NC_037333.1,NC_032655.1,110425952,115131407,115131408,a,ac,1
NC_037333.1,NC_032655.1,110449503,115154921,115154922,A,AT,1
NC_037333.1,NC_032655.1,110601277,115306356,115306383,C,CCAACACACAGCTCTAAAACTGGGGATM,27
NC_037333.1,NC_032655.1,110650286,115355059,115355060,g,gt,1
NC_037333.1,NC_032655.1,110716605,115420857,115420858,T,TY,1
NC_037333.1,NC_032655.1,110729069,115433323,115433324,A,AW,1
NC_037333.1,NC_032655.1,110749167,115447395,115447396,g,gt,1
NC_037333.1,NC_032655.1,110756043,115454274,115454275,a,at,1
NC_037333.1,NC_032655.1,110794830,115493125,115493126,T,TY,1
NC_037333.1,NC_032655.1,110794890,115493186,115493187,C,CM,1
NC_037333.1,NC_032655.1,110807433,115506066,115506076,a,aatgtgtgtgt,10
NC_037333.1,NC_032655.1,110832015,115530661,115530662,t,tg,1
NC_037333.1,NC_032655.1,110832190,115530837,115530838,t,tg,1
NC_037333.1,NC_032655.1,110848559,115547295,115547296,a,aR,1
NC_037333.1,NC_032655.1,110896667,115595406,115595411,G,GAGACA,5
NC_037333.1,NC_032655.1,110937241,115635990,115635991,c,ct,1
NC_037333.1,NC_032655.1,110939748,115638498,115638499,a,ac,1
NC_037333.1,NC_032655.1,110986149,115687044,115687045,t,tg,1
NC_037333.1,NC_032655.1,110990779,115691662,115691664,g,gtc,2
NC_037333.1,NC_032655.1,111014864,115715751,115715754,t,tcag,3
NC_037333.1,NC_032655.1,111019208,115720331,115720332,A,AT,1
NC_037333.1,NC_032655.1,111130687,115832529,115832531,C,CAT,2
NC_037333.1,NC_032655.1,111153354,115855217,115855218,a,ac,1
NC_037333.1,NC_032655.1,111168658,115870533,115870535,g,gaa,2
NC_037333.1,NC_032655.1,111168669,115870546,115870550,t,taaaa,4
NC_037333.1,NC_032655.1,111174510,115876390,115876391,G,GT,1
NC_037333.1,NC_032655.1,111178435,115880305,115880306,G,GR,1
NC_037333.1,NC_032655.1,111178442,115880313,115880314,A,AG,1
NC_037333.1,NC_032655.1,111180395,115882265,115882266,t,ta,1
NC_037333.1,NC_032655.1,111198319,115900199,115900200,a,ac,1
NC_037333.1,NC_032655.1,111200760,115902643,115902645,g,gga,2
NC_037333.1,NC_032655.1,111209919,115911803,115911804,t,ta,1
NC_037333.1,NC_032655.1,111225902,115927802,115927804,t,tta,2
NC_037333.1,NC_032655.1,111227810,115929713,115929714,G,GR,1
NC_037333.1,NC_032655.1,111266777,115968694,115968695,T,TC,1
NC_037333.1,NC_032655.1,111275209,115977127,115977128,c,ct,1
NC_037333.1,NC_032655.1,111305436,116007368,116007373,C,CTAAAA,5
NC_037333.1,NC_032655.1,111319011,116020949,116020950,G,GA,1
NC_037333.1,NC_032655.1,111360558,116062379,116062390,g,gcccccgcctca,11
NC_037333.1,NC_032655.1,111366018,116067853,116067854,c,ct,1
NC_037333.1,NC_032655.1,111367566,116069402,116069403,T,TK,1
NC_037333.1,NC_032655.1,111399033,116100698,116100699,C,CT,1
NC_037333.1,NC_032655.1,111563296,116266307,116266308,c,ca,1
NC_037333.1,NC_032655.1,111599897,116302906,116302922,G,GGTAAAGAGTTGTTGKK,16
NC_037333.1,NC_032655.1,111604183,116307209,116307210,G,GT,1
NC_037333.1,NC_032655.1,111606159,116309519,116309520,G,GC,1
NC_037333.1,NC_032655.1,111623582,116326702,116326703,g,gc,1
NC_037333.1,NC_032655.1,111630856,116333515,116333516,G,GC,1
NC_037333.1,NC_032655.1,111639401,116342062,116342066,T,TTCTC,4
NC_037333.1,NC_032655.1,111640149,116342814,116342815,t,tg,1
NC_037333.1,NC_032655.1,111650968,116353789,116353790,c,ct,1
NC_037333.1,NC_032655.1,111658254,116360918,116360919,a,at,1
NC_037333.1,NC_032655.1,111669322,116371983,116371987,G,GAGAC,4
NC_037333.1,NC_032655.1,111691893,116394559,116394560,T,TA,1
NC_037333.1,NC_032655.1,111749215,116452497,116452498,G,GA,1
NC_037333.1,NC_032655.1,111752250,116455535,116455539,A,ANNNN,4
NC_037333.1,NC_032655.1,111754371,116457655,116457656,G,GC,1
NC_037333.1,NC_032655.1,111760479,116463763,116463764,G,GR,1
NC_037333.1,NC_032655.1,111822725,116526039,116526040,g,gt,1
NC_037333.1,NC_032655.1,111824217,116527532,116527533,a,at,1
NC_037333.1,NC_032655.1,111916198,116618474,116618475,G,GA,1
NC_037333.1,NC_032655.1,111946724,116647965,116647967,A,ATR,2
NC_037333.1,NC_032655.1,111948647,116649898,116649904,G,GATTCCA,6
NC_037333.1,NC_032655.1,111982150,116683407,116683408,c,ct,1
NC_037333.1,NC_032655.1,111985716,116686975,116686978,g,gctc,3
NC_037333.1,NC_032655.1,112140492,116905433,116905434,c,cg,1
NC_037333.1,NC_032655.1,112344060,116930824,116930825,A,AG,1
NC_037333.1,NC_032655.1,112470797,117059607,117059608,T,TA,1
NC_037333.1,NC_032655.1,112490089,117078903,117078919,t,taaGAAGNNNNNNNNNN,16
NC_037333.1,NC_032655.1,112490179,117079013,117079014,t,ta,1
NC_037333.1,NC_032655.1,112498864,117087703,117087704,C,CT,1
NC_037333.1,NC_032655.1,112566779,117169326,117169331,a,agaatt,5
NC_037333.1,NC_032655.1,112607965,117211736,117211737,c,ca,1
NC_037333.1,NC_032655.1,112608558,117212329,117212345,a,attctttggcattgcct,16
NC_037333.1,NC_032655.1,112617823,117221610,117221611,G,GA,1
NC_037333.1,NC_032655.1,112632222,117236015,117236038,G,GGGAAAAGAAGGCAAGGAGAAAGT,23
NC_037333.1,NC_032655.1,112635756,117239572,117239573,A,AG,1
NC_037333.1,NC_032655.1,112693239,117331875,117331877,T,TCC,2
NC_037333.1,NC_032655.1,112710758,117349396,117349397,C,CA,1
NC_037333.1,NC_032655.1,112732247,117371873,117371883,t,tgtgtgtgtgc,10
NC_037333.1,NC_032655.1,112732770,117372406,117372409,c,cctg,3
NC_037333.1,NC_032655.1,112736297,117375937,117375938,A,AC,1
NC_037333.1,NC_032655.1,112737969,117377610,117377612,C,CCT,2
NC_037333.1,NC_032655.1,112743819,117383456,117383457,c,ca,1
NC_037333.1,NC_032655.1,112755302,117394942,117394946,t,taata,4
NC_037333.1,NC_032655.1,112880599,117575284,117575287,C,CAAG,3
NC_037333.1,NC_032655.1,112888551,117583240,117583246,G,GTTGCAT,6
NC_037333.1,NC_032655.1,112920660,117615260,117615263,A,AAAG,3
NC_037333.1,NC_032655.1,112921973,117616577,117616578,A,AG,1
NC_037333.1,NC_032655.1,112923665,117618281,117618283,g,ggc,2
NC_037333.1,NC_032655.1,112923737,117618354,117618355,t,tg,1
NC_037333.1,NC_032655.1,112923760,117618378,117618379,c,ca,1
NC_037333.1,NC_032655.1,112923762,117618381,117618382,a,ag,1
NC_037333.1,NC_032655.1,112923801,117618421,117618422,t,tg,1
NC_037333.1,NC_032655.1,112923824,117618445,117618446,c,cg,1
NC_037333.1,NC_032655.1,112923828,117618450,117618452,t,tca,2
NC_037333.1,NC_032655.1,113204020,121359785,121359786,G,GK,1
NC_037333.1,NC_032655.1,113214468,121370185,121370187,C,CTT,2
NC_037333.1,NC_032655.1,113215104,121370823,121370824,g,gc,1
NC_037333.1,NC_032655.1,113222118,121377876,121377877,t,tc,1
NC_037333.1,NC_032655.1,113292719,121450433,121450434,C,CA,1
NC_037333.1,NC_032655.1,113332623,121490336,121490339,T,TTAW,3
NC_037333.1,NC_032655.1,113349219,121506947,121506948,C,CS,1
NC_037333.1,NC_032655.1,113374815,121532269,121532270,C,CA,1
NC_037333.1,NC_032655.1,113374827,121532282,121532290,T,TTCTGCAAA,8
NC_037333.1,NC_032655.1,113384029,121540595,121540596,G,GA,1
NC_037333.1,NC_032655.1,113483734,121644037,121644038,C,CT,1
NC_037333.1,NC_032655.1,113535806,121689947,121689948,c,ca,1
NC_037333.1,NC_032655.1,113570682,121725384,121725395,T,TGGGCCTGGGCC,11
NC_037333.1,NC_032655.1,113592865,121747385,121747386,G,GT,1
NC_037333.1,NC_032655.1,113606307,121760834,121760835,C,CT,1
NC_037333.1,NC_032655.1,113607874,121762454,121762455,t,tK,1
NC_037333.1,NC_032655.1,113609401,121764077,121764078,t,ta,1
NC_037333.1,NC_032655.1,113620776,121775456,121775457,T,TA,1
NC_037333.1,NC_032655.1,113652940,121807030,121807031,C,CA,1
NC_037333.1,NC_032655.1,113659447,121813538,121813540,a,aNN,2
NC_037333.1,NC_032655.1,113662543,121816636,121816640,G,GAAAA,4
NC_037333.1,NC_032655.1,113665526,121819642,121819644,A,AAC,2
NC_037333.1,NC_032655.1,113674779,121828893,121828894,C,CT,1
NC_037333.1,NC_032655.1,113676336,121830450,121830451,T,TA,1
NC_037333.1,NC_032655.1,113681476,121835590,121835591,T,TG,1
NC_037333.1,NC_032655.1,113688966,121843080,121843087,G,GTGGTGGT,7
NC_037333.1,NC_032655.1,113692104,121846226,121846227,G,GA,1
NC_037333.1,NC_032655.1,113693046,121847204,121847239,A,AGAATCAGGGaggtcttcctggaggaggtgatgctg,35
NC_037333.1,NC_032655.1,113697256,121851439,121851440,A,AG,1
NC_037333.1,NC_032655.1,113735889,121890055,121890073,t,tgtgtgtgcgcagggGCGC,18
NC_037333.1,NC_032655.1,113743784,121897970,121897971,C,CY,1
NC_037333.1,NC_032655.1,113745998,121900184,121900187,G,GTGA,3
NC_037333.1,NC_032655.1,113767236,121921426,121921427,T,TC,1
NC_037333.1,NC_032655.1,113783046,121937237,121937238,g,ga,1
NC_037333.1,NC_032655.1,113814189,121968170,121968171,T,TK,1
NC_037333.1,NC_032655.1,113825840,121979824,121979825,G,GA,1
NC_037333.1,NC_032655.1,113827423,121981408,121981409,C,CA,1
NC_037333.1,NC_032655.1,113834381,121988368,121988369,C,CT,1
NC_037333.1,NC_032655.1,113835719,121989707,121989708,G,GT,1
NC_037333.1,NC_032655.1,113840432,121994421,121994424,t,tccc,3
NC_037333.1,NC_032655.1,113840449,121994441,121994448,c,cacccccS,7
NC_037333.1,NC_032655.1,113842783,121996764,121996770,A,AAAGGTG,6
NC_037333.1,NC_032655.1,113845841,121999816,121999817,A,AM,1
NC_037333.1,NC_032655.1,113850335,122004309,122004310,C,CA,1
NC_037333.1,NC_032655.1,113857630,122011583,122011584,a,at,1
NC_037333.1,NC_032655.1,113857630,122148598,122148599,a,at,1
NC_037333.1,NC_032655.1,113875570,122029507,122029508,G,GN,1
NC_037333.1,NC_032655.1,113953546,122181717,122181718,t,tY,1
NC_037333.1,NC_032655.1,114012146,122240313,122240314,g,ga,1
NC_037333.1,NC_032655.1,114033776,122261734,122261735,T,TC,1
NC_037333.1,NC_032655.1,114036851,122264789,122264790,T,TG,1
NC_037333.1,NC_032655.1,114036869,122264808,122264809,C,CT,1
NC_037333.1,NC_032655.1,114177927,122402279,122402280,A,AG,1
NC_037333.1,NC_032655.1,114184914,122409268,122409270,t,ttY,2
NC_037333.1,NC_032655.1,114225274,122449709,122449710,T,TC,1
NC_037333.1,NC_032655.1,114225419,122449853,122449855,t,tca,2
NC_037333.1,NC_032655.1,114247726,122472034,122472035,A,AC,1
NC_037333.1,NC_032655.1,114263593,122487908,122487910,T,TTA,2
NC_037333.1,NC_032655.1,114364815,122588450,122588451,T,TW,1
NC_037333.1,NC_032655.1,114377716,122600976,122600977,G,GA,1
NC_037333.1,NC_032655.1,114433107,122643532,122643536,C,CCTAA,4
NC_037333.1,NC_032655.1,114433951,122644380,122644381,a,ac,1
NC_037333.1,NC_032655.1,114435984,122646414,122646415,G,GA,1
