Reference ID,Query ID,Reference POS,Query POS,Query END,REF,ALT,SVLEN
NC_037349.1,NC_032671.1,334340,19739,19740,a,ag,1
NC_037349.1,NC_032671.1,355110,38357,38359,G,GGA,2
NC_037349.1,NC_032671.1,358163,41410,41411,T,TC,1
NC_037349.1,NC_032671.1,401714,85876,85877,t,ta,1
NC_037349.1,NC_032671.1,559521,264023,264024,T,TW,1
NC_037349.1,NC_032671.1,588435,292939,292940,A,AC,1
NC_037349.1,NC_032671.1,598029,302538,302539,g,ga,1
NC_037349.1,NC_032671.1,598465,302985,302991,g,gttccta,6
NC_037349.1,NC_032671.1,607516,314301,314305,G,GTATW,4
NC_037349.1,NC_032671.1,648357,355172,355182,a,actgttgcttc,10
NC_037349.1,NC_032671.1,651544,358371,358372,C,CM,1
NC_037349.1,NC_032671.1,731572,438265,438317,c,cacacagtCCTCAAANNNNNNNNNNNNNNNNNNNNNNNNNNNGTCCTCCAcgt,52
NC_037349.1,NC_032671.1,793571,500672,500684,G,GGTTATATCACAA,12
NC_037349.1,NC_032671.1,793595,500708,500711,T,TATA,3
NC_037349.1,NC_032671.1,799185,506727,506728,c,ct,1
NC_037349.1,NC_032671.1,800125,507663,507664,G,GC,1
NC_037349.1,NC_032671.1,802322,509881,509884,t,taaa,3
NC_037349.1,NC_032671.1,839348,546894,546896,A,AAC,2
NC_037349.1,NC_032671.1,848123,555684,555685,t,ta,1
NC_037349.1,NC_032671.1,864004,571567,571597,A,AGCACTTCCTGTTCACACTGGGCCTGGGCCC,30
NC_037349.1,NC_032671.1,885385,592980,592981,A,AG,1
NC_037349.1,NC_032671.1,902399,610003,610004,a,aW,1
NC_037349.1,NC_032671.1,904014,611619,611621,a,aaW,2
NC_037349.1,NC_032671.1,919555,627161,627164,a,aaag,3
NC_037349.1,NC_032671.1,920618,628227,628229,T,TAC,2
NC_037349.1,NC_032671.1,1033947,741639,741640,A,AM,1
NC_037349.1,NC_032671.1,1036278,743971,743973,A,AAG,2
NC_037349.1,NC_032671.1,1050468,758162,758163,a,ac,1
NC_037349.1,NC_032671.1,1123212,830843,830844,T,TY,1
NC_037349.1,NC_032671.1,1131177,838811,838814,G,GTTA,3
NC_037349.1,NC_032671.1,1228635,963974,963975,c,ct,1
NC_037349.1,NC_032671.1,1262915,998253,998254,a,at,1
NC_037349.1,NC_032671.1,1266516,1001585,1001586,A,AC,1
NC_037349.1,NC_032671.1,1288107,1023173,1023174,T,TC,1
NC_037349.1,NC_032671.1,1311620,1047454,1047459,a,agactg,5
NC_037349.1,NC_032671.1,1405978,1138707,1138709,t,taa,2
NC_037349.1,NC_032671.1,1410180,1150481,1150483,a,atg,2
NC_037349.1,NC_032671.1,1421361,1161542,1161543,g,ga,1
NC_037349.1,NC_032671.1,1444613,1184784,1184785,t,tg,1
NC_037349.1,NC_032671.1,1444801,1184973,1184974,a,aW,1
NC_037349.1,NC_032671.1,1452201,1192373,1192374,A,AW,1
NC_037349.1,NC_032671.1,1455064,1195240,1195241,t,ta,1
NC_037349.1,NC_032671.1,1468389,1208575,1208576,G,GT,1
NC_037349.1,NC_032671.1,1468401,1208588,1208591,T,TTGA,3
NC_037349.1,NC_032671.1,1468410,1208600,1208601,C,CT,1
NC_037349.1,NC_032671.1,1468861,1209054,1209056,A,AGT,2
NC_037349.1,NC_032671.1,1470938,1211133,1211135,C,CTA,2
NC_037349.1,NC_032671.1,1472143,1212340,1212341,T,TA,1
NC_037349.1,NC_032671.1,1479453,1219651,1219652,g,gN,1
NC_037349.1,NC_032671.1,1497427,1237484,1237487,G,GGTR,3
NC_037349.1,NC_032671.1,1505170,1244743,1244747,c,ctttt,4
NC_037349.1,NC_032671.1,1643556,1445425,1445426,C,CG,1
NC_037349.1,NC_032671.1,1645924,1447794,1447795,A,AR,1
NC_037349.1,NC_032671.1,1650971,1452843,1452845,c,cta,2
NC_037349.1,NC_032671.1,1678572,1480446,1480447,t,tg,1
NC_037349.1,NC_032671.1,1700734,1502612,1502613,C,CY,1
NC_037349.1,NC_032671.1,1700765,1502644,1502645,G,GC,1
NC_037349.1,NC_032671.1,1703439,1505304,1505305,C,CA,1
NC_037349.1,NC_032671.1,1723277,1523529,1523546,C,CATAGTCCTGCTTCCTGA,17
NC_037349.1,NC_032671.1,1727827,1528094,1528096,A,AAC,2
NC_037349.1,NC_032671.1,2058752,1885458,1885459,g,ga,1
NC_037349.1,NC_032671.1,2061131,1887840,1887841,C,CA,1
NC_037349.1,NC_032671.1,2062439,1889141,1889142,T,TY,1
NC_037349.1,NC_032671.1,2063202,1889906,1889907,t,ta,1
NC_037349.1,NC_032671.1,2070498,1896883,1896885,C,CCA,2
NC_037349.1,NC_032671.1,2080601,1907057,1907060,T,TGTC,3
NC_037349.1,NC_032671.1,2140187,1967089,1967090,A,AW,1
NC_037349.1,NC_032671.1,2470350,2303875,2303896,a,atctccttgcagtccaagggac,21
NC_037349.1,NC_032671.1,2471084,2305889,2305890,t,tY,1
NC_037349.1,NC_032671.1,2528065,2362871,2362872,A,AR,1
NC_037349.1,NC_032671.1,2529333,2364141,2364142,g,gt,1
NC_037349.1,NC_032671.1,2535744,2370601,2370622,a,atcacctcacaccagtcagaat,21
NC_037349.1,NC_032671.1,2537512,2372394,2372396,t,tag,2
NC_037349.1,NC_032671.1,2542467,2377339,2377377,t,tgtgtgtgtgtgtatatatatatacacacacacatgtaa,38
NC_037349.1,NC_032671.1,2547700,2382610,2382611,C,CR,1
NC_037349.1,NC_032671.1,2581535,2415670,2415671,c,ct,1
NC_037349.1,NC_032671.1,2602364,2436498,2436499,t,ta,1
NC_037349.1,NC_032671.1,2602369,2436504,2436505,t,ta,1
NC_037349.1,NC_032671.1,2604485,2438619,2438620,T,TC,1
NC_037349.1,NC_032671.1,2604961,2439096,2439097,a,ag,1
NC_037349.1,NC_032671.1,2620507,2454647,2454648,A,AT,1
NC_037349.1,NC_032671.1,2620905,2455046,2455047,T,TG,1
NC_037349.1,NC_032671.1,2637167,2470699,2470700,A,AG,1
NC_037349.1,NC_032671.1,2644503,2478033,2478034,c,ct,1
NC_037349.1,NC_032671.1,2677302,2510796,2510798,A,AAG,2
NC_037349.1,NC_032671.1,2756956,2590470,2590471,a,aR,1
NC_037349.1,NC_032671.1,2762711,2596228,2596236,C,CTACTGTGA,8
NC_037349.1,NC_032671.1,2775279,2608816,2608817,a,at,1
NC_037349.1,NC_032671.1,2779464,2613002,2613003,G,GA,1
NC_037349.1,NC_032671.1,2911157,2766922,2766923,a,ac,1
NC_037349.1,NC_032671.1,2913767,2769532,2769534,c,cat,2
NC_037349.1,NC_032671.1,2955773,2811584,2811585,G,GA,1
NC_037349.1,NC_032671.1,2972249,2828059,2828067,T,TGAGCTGCC,8
NC_037349.1,NC_032671.1,3095234,2951101,2951102,t,tg,1
NC_037349.1,NC_032671.1,3097593,2953461,2953462,T,TY,1
NC_037349.1,NC_032671.1,3131569,2987449,2987450,c,ct,1
NC_037349.1,NC_032671.1,3153670,3009553,3009554,a,at,1
NC_037349.1,NC_032671.1,3156456,3012027,3012028,t,tg,1
NC_037349.1,NC_032671.1,3165503,3021299,3021304,G,GGGATK,5
NC_037349.1,NC_032671.1,3233325,3091714,3091715,a,ag,1
NC_037349.1,NC_032671.1,3248173,3105271,3105272,a,aM,1
NC_037349.1,NC_032671.1,3250588,3107687,3107688,G,GC,1
NC_037349.1,NC_032671.1,3290290,3147397,3147398,c,ca,1
NC_037349.1,NC_032671.1,3290303,3147411,3147412,c,ca,1
NC_037349.1,NC_032671.1,3317659,3175290,3175311,a,atatatatatatatatatatat,21
NC_037349.1,NC_032671.1,3527018,3384776,3384777,T,TA,1
NC_037349.1,NC_032671.1,3558530,3416299,3416301,g,gtt,2
NC_037349.1,NC_032671.1,3567225,3424996,3424997,A,AG,1
NC_037349.1,NC_032671.1,3591374,3449951,3449960,A,AGTTCTCCAT,9
NC_037349.1,NC_032671.1,3619374,3477872,3477873,G,GT,1
NC_037349.1,NC_032671.1,3638849,3497369,3497370,a,at,1
NC_037349.1,NC_032671.1,3695631,3554000,3554002,c,caa,2
NC_037349.1,NC_032671.1,3741602,3599663,3599664,A,AC,1
NC_037349.1,NC_032671.1,3749475,3607538,3607539,T,TA,1
NC_037349.1,NC_032671.1,3801513,3739635,3739636,c,ca,1
NC_037349.1,NC_032671.1,3806174,3744292,3744320,t,tccatggcatcacaaggagtcaaacatga,28
NC_037349.1,NC_032671.1,3845171,3783324,3783328,t,tNNNN,4
NC_037349.1,NC_032671.1,3862629,3800804,3800806,T,TAC,2
NC_037349.1,NC_032671.1,3974375,3915693,3915694,G,GA,1
NC_037349.1,NC_032671.1,3984913,3926473,3926474,T,TC,1
NC_037349.1,NC_032671.1,4062673,4004058,4004060,g,gWK,2
NC_037349.1,NC_032671.1,4079376,4020762,4020763,a,at,1
NC_037349.1,NC_032671.1,4094824,4036211,4036212,g,gc,1
NC_037349.1,NC_032671.1,4124668,4066056,4066057,C,CM,1
NC_037349.1,NC_032671.1,4210534,4151928,4151930,c,cca,2
NC_037349.1,NC_032671.1,4327739,4269741,4269744,C,CTCT,3
NC_037349.1,NC_032671.1,4343133,4285142,4285143,g,ga,1
NC_037349.1,NC_032671.1,4388817,4330828,4330830,a,aag,2
NC_037349.1,NC_032671.1,4437904,4380006,4380007,A,AG,1
NC_037349.1,NC_032671.1,4452122,4394225,4394230,T,TATAAG,5
NC_037349.1,NC_032671.1,4464665,4406427,4406428,a,ac,1
NC_037349.1,NC_032671.1,4484611,4426184,4426185,t,tY,1
NC_037349.1,NC_032671.1,4489147,4430721,4430722,A,AG,1
NC_037349.1,NC_032671.1,4547361,4485178,4485179,T,TC,1
NC_037349.1,NC_032671.1,4556980,4494799,4494800,a,at,1
NC_037349.1,NC_032671.1,4652423,4591912,4591913,g,ga,1
NC_037349.1,NC_032671.1,4652426,4591916,4591917,t,tg,1
NC_037349.1,NC_032671.1,4652441,4591932,4591933,t,ta,1
NC_037349.1,NC_032671.1,4654972,4594464,4594465,T,TW,1
NC_037349.1,NC_032671.1,4675403,4615005,4615006,A,AG,1
NC_037349.1,NC_032671.1,4690329,4629934,4629936,t,tNN,2
NC_037349.1,NC_032671.1,4701696,4641317,4641338,T,TAGCAAAACTACCTGATGCCAA,21
NC_037349.1,NC_032671.1,4704437,4644058,4644059,C,CA,1
NC_037349.1,NC_032671.1,4706598,4646221,4646222,A,AC,1
NC_037349.1,NC_032671.1,4708549,4648176,4648185,c,caggagatga,9
NC_037349.1,NC_032671.1,4715076,4654858,4654862,a,attat,4
NC_037349.1,NC_032671.1,4774880,4714665,4714666,C,CG,1
NC_037349.1,NC_032671.1,4804612,4744395,4744411,G,GAAATTCCCAAACTTCT,16
NC_037349.1,NC_032671.1,4807244,4747044,4747047,t,tagc,3
NC_037349.1,NC_032671.1,4807677,4747481,4747482,g,gt,1
NC_037349.1,NC_032671.1,4811007,4750816,4750817,A,AR,1
NC_037349.1,NC_032671.1,4820490,4760302,4760303,A,AG,1
NC_037349.1,NC_032671.1,4872017,4811252,4811253,a,at,1
NC_037349.1,NC_032671.1,4937352,4876590,4876591,C,CT,1
NC_037349.1,NC_032671.1,4937371,4876610,4876611,A,AG,1
NC_037349.1,NC_032671.1,4962646,4901888,4901889,C,CR,1
NC_037349.1,NC_032671.1,4993615,4934693,4934695,t,ttg,2
NC_037349.1,NC_032671.1,5109189,5050025,5050026,A,AR,1
NC_037349.1,NC_032671.1,5142078,5082902,5082903,G,GC,1
NC_037349.1,NC_032671.1,5191384,5132219,5132227,A,ACTATAAAG,8
NC_037349.1,NC_032671.1,5201377,5142301,5142302,T,TC,1
NC_037349.1,NC_032671.1,5230356,5171284,5171285,a,ag,1
NC_037349.1,NC_032671.1,5287565,5229966,5229972,C,CATTACA,6
NC_037349.1,NC_032671.1,5293422,5235836,5235837,A,AR,1
NC_037349.1,NC_032671.1,5295013,5237426,5237432,a,aaaatat,6
NC_037349.1,NC_032671.1,5304687,5247107,5247110,t,ttaa,3
NC_037349.1,NC_032671.1,5314745,5257147,5257149,t,tta,2
NC_037349.1,NC_032671.1,5323780,5266173,5266175,g,gga,2
NC_037349.1,NC_032671.1,5327963,5270367,5270368,A,AG,1
NC_037349.1,NC_032671.1,5332011,5274417,5274418,T,TC,1
NC_037349.1,NC_032671.1,5350011,5292398,5292399,C,CT,1
NC_037349.1,NC_032671.1,5362825,5305216,5305217,A,AT,1
NC_037349.1,NC_032671.1,5434000,5376465,5376466,T,TY,1
NC_037349.1,NC_032671.1,5438184,5380650,5380651,T,TG,1
NC_037349.1,NC_032671.1,5448567,5391032,5391041,t,tgtttttKTK,9
NC_037349.1,NC_032671.1,5471030,5412490,5412500,A,AAGGGGTAAAT,10
NC_037349.1,NC_032671.1,5475443,5416921,5416922,t,ta,1
NC_037349.1,NC_032671.1,5475600,5417079,5417080,a,at,1
NC_037349.1,NC_032671.1,5545184,5486684,5486685,T,TK,1
NC_037349.1,NC_032671.1,5565264,5506761,5506790,G,GCGACACAGCTGTCATCCCTGAGCTTCCCT,29
NC_037349.1,NC_032671.1,5578976,5520503,5520504,t,ta,1
NC_037349.1,NC_032671.1,5579812,5521341,5521344,a,attt,3
NC_037349.1,NC_032671.1,5595801,5537334,5537339,T,TACCCC,5
NC_037349.1,NC_032671.1,5597741,5539280,5539281,t,ta,1
NC_037349.1,NC_032671.1,5687976,5629523,5629524,C,CN,1
NC_037349.1,NC_032671.1,5701616,5643175,5643177,a,acg,2
NC_037349.1,NC_032671.1,5848777,5789974,5789975,c,ca,1
NC_037349.1,NC_032671.1,5863107,5804012,5804013,T,TA,1
NC_037349.1,NC_032671.1,5878308,5819214,5819215,t,tY,1
NC_037349.1,NC_032671.1,5881715,5822622,5822623,a,aM,1
NC_037349.1,NC_032671.1,5881720,5822628,5822629,t,ta,1
NC_037349.1,NC_032671.1,5932605,5873487,5873500,C,CCGGGAAATGACTG,13
NC_037349.1,NC_032671.1,5933314,5874208,5874209,C,CT,1
NC_037349.1,NC_032671.1,5945018,5885918,5885919,g,ga,1
NC_037349.1,NC_032671.1,5963562,5904464,5904465,G,GT,1
NC_037349.1,NC_032671.1,5965158,5906061,5906069,g,ggatgccat,8
NC_037349.1,NC_032671.1,5976603,5917519,5917520,a,at,1
NC_037349.1,NC_032671.1,5981514,5960004,5960005,c,ct,1
NC_037349.1,NC_032671.1,5985744,5964258,5964283,A,AACACAGGCGCTGCTCTGGACCCTAC,25
NC_037349.1,NC_032671.1,5989918,5968458,5968464,a,aNNNNNN,6
NC_037349.1,NC_032671.1,6005336,5983881,5983882,a,ag,1
NC_037349.1,NC_032671.1,6049221,6032253,6032254,G,GT,1
NC_037349.1,NC_032671.1,6065307,6048348,6048349,t,tg,1
NC_037349.1,NC_032671.1,6148934,6131997,6131999,t,tta,2
NC_037349.1,NC_032671.1,6151115,6134181,6134183,C,CTT,2
NC_037349.1,NC_032671.1,6151115,6139708,6139710,C,CTT,2
NC_037349.1,NC_032671.1,6157909,6146602,6146603,G,GN,1
NC_037349.1,NC_032671.1,6170137,6158829,6158833,t,tcaac,4
NC_037349.1,NC_032671.1,6172146,6160842,6160843,G,GC,1
NC_037349.1,NC_032671.1,6174503,6163200,6163201,a,ac,1
NC_037349.1,NC_032671.1,6174879,6163577,6163578,t,tg,1
NC_037349.1,NC_032671.1,6177714,6166416,6166425,C,CCTGCGCACT,9
NC_037349.1,NC_032671.1,6182949,6171840,6171843,C,CACG,3
NC_037349.1,NC_032671.1,6192447,6181335,6181336,A,AM,1
NC_037349.1,NC_032671.1,6210024,6198914,6198915,G,GK,1
NC_037349.1,NC_032671.1,6212024,6200915,6200916,g,gt,1
NC_037349.1,NC_032671.1,6224870,6213775,6213776,C,CA,1
NC_037349.1,NC_032671.1,6247872,6236779,6236783,A,AGCTT,4
NC_037349.1,NC_032671.1,6247979,6236890,6236891,T,TC,1
NC_037349.1,NC_032671.1,6268034,6256819,6256820,t,ta,1
NC_037349.1,NC_032671.1,6270066,6258868,6258869,T,TA,1
NC_037349.1,NC_032671.1,6271227,6260017,6260020,t,tgtg,3
NC_037349.1,NC_032671.1,6304969,6293768,6293770,c,caa,2
NC_037349.1,NC_032671.1,6305088,6293889,6293891,t,taa,2
NC_037349.1,NC_032671.1,6307151,6295954,6295955,A,AC,1
NC_037349.1,NC_032671.1,6307153,6295957,6295959,C,CCT,2
NC_037349.1,NC_032671.1,6395760,6384145,6384146,g,gt,1
NC_037349.1,NC_032671.1,6408202,6396613,6396615,A,AAG,2
NC_037349.1,NC_032671.1,6439603,6414247,6414248,C,CT,1
NC_037349.1,NC_032671.1,6443161,6417830,6417831,C,CR,1
NC_037349.1,NC_032671.1,6447569,6422234,6422235,A,AT,1
NC_037349.1,NC_032671.1,6447591,6422257,6422259,T,TTA,2
NC_037349.1,NC_032671.1,6455876,6430547,6430548,A,AR,1
NC_037349.1,NC_032671.1,6471308,6445986,6445988,A,ACG,2
NC_037349.1,NC_032671.1,6481472,6456148,6456149,A,AT,1
NC_037349.1,NC_032671.1,6505550,6480220,6480221,T,TG,1
NC_037349.1,NC_032671.1,6510198,6484869,6484870,t,tc,1
NC_037349.1,NC_032671.1,6512611,6487277,6487278,A,AW,1
NC_037349.1,NC_032671.1,6514901,6489569,6489580,A,ATTAATCATAAC,11
NC_037349.1,NC_032671.1,6523710,6498385,6498388,c,cagg,3
NC_037349.1,NC_032671.1,6525058,6499748,6499750,T,TAG,2
NC_037349.1,NC_032671.1,6533383,6508096,6508097,G,GT,1
NC_037349.1,NC_032671.1,6557068,6531593,6531594,a,ac,1
NC_037349.1,NC_032671.1,6557329,6531855,6531856,c,ca,1
NC_037349.1,NC_032671.1,6557640,6532167,6532169,A,AAT,2
NC_037349.1,NC_032671.1,6561636,6536109,6536114,a,atacac,5
NC_037349.1,NC_032671.1,6578528,6552974,6552976,a,atc,2
NC_037349.1,NC_032671.1,6581484,6555932,6555933,A,AT,1
NC_037349.1,NC_032671.1,6590665,6559275,6559279,t,taggc,4
NC_037349.1,NC_032671.1,6621543,6590157,6590158,C,CT,1
NC_037349.1,NC_032671.1,6798650,6785835,6785836,A,AG,1
NC_037349.1,NC_032671.1,6828855,6816040,6816042,c,ccg,2
NC_037349.1,NC_032671.1,6857152,6868496,6868497,t,tg,1
NC_037349.1,NC_032671.1,6944962,6960008,6960014,A,AGAGATG,6
NC_037349.1,NC_032671.1,6973411,6988465,6988467,a,aat,2
NC_037349.1,NC_032671.1,7035335,7050381,7050382,A,AR,1
NC_037349.1,NC_032671.1,7263812,7279353,7279356,C,CTGT,3
NC_037349.1,NC_032671.1,7306534,7322553,7322554,a,at,1
NC_037349.1,NC_032671.1,7355241,7371259,7371260,a,ag,1
NC_037349.1,NC_032671.1,7452405,7468564,7468565,G,GC,1
NC_037349.1,NC_032671.1,7476230,7492392,7492393,T,TC,1
NC_037349.1,NC_032671.1,7488264,7504428,7504429,T,TA,1
NC_037349.1,NC_032671.1,7579301,7595847,7595854,A,AAATGTCC,7
NC_037349.1,NC_032671.1,7605425,7626640,7626641,a,ag,1
NC_037349.1,NC_032671.1,7896814,7918026,7918027,a,ag,1
NC_037349.1,NC_032671.1,7975463,8009799,8009800,g,gt,1
NC_037349.1,NC_032671.1,8023519,8059011,8059012,C,CY,1
NC_037349.1,NC_032671.1,8122241,8158294,8158295,c,ca,1
NC_037349.1,NC_032671.1,8163269,8199298,8199301,a,agtt,3
NC_037349.1,NC_032671.1,8170194,8206228,8206229,t,ta,1
NC_037349.1,NC_032671.1,8170405,8206440,8206443,t,ttNN,3
NC_037349.1,NC_032671.1,8171504,8207550,8207551,g,gt,1
NC_037349.1,NC_032671.1,8342053,8377431,8377432,g,gt,1
NC_037349.1,NC_032671.1,8530283,8565387,8565392,c,caggcg,5
NC_037349.1,NC_032671.1,8556563,8591671,8591675,G,Gaact,4
NC_037349.1,NC_032671.1,8575133,8609975,8609978,a,atat,3
NC_037349.1,NC_032671.1,8584042,8618540,8618541,G,GT,1
NC_037349.1,NC_032671.1,8587207,8621707,8621711,g,gcttt,4
NC_037349.1,NC_032671.1,8605369,8639871,8639872,a,ag,1
NC_037349.1,NC_032671.1,8614596,8648881,8648882,G,GR,1
NC_037349.1,NC_032671.1,8690702,8726386,8726392,c,caaaaaa,6
NC_037349.1,NC_032671.1,8692419,8728109,8728110,c,ct,1
NC_037349.1,NC_032671.1,8694334,8730023,8730024,G,GA,1
NC_037349.1,NC_032671.1,8694571,8730261,8730263,A,ATT,2
NC_037349.1,NC_032671.1,8694661,8730352,8730353,a,ac,1
NC_037349.1,NC_032671.1,8694720,8730412,8730413,c,ct,1
NC_037349.1,NC_032671.1,8694813,8730506,8730507,a,ag,1
NC_037349.1,NC_032671.1,8694867,8730561,8730562,t,tc,1
NC_037349.1,NC_032671.1,8694879,8730574,8730575,t,tc,1
NC_037349.1,NC_032671.1,8697486,8733180,8733181,A,AC,1
NC_037349.1,NC_032671.1,8697780,8733475,8733476,G,GA,1
NC_037349.1,NC_032671.1,8697861,8733557,8733558,T,TG,1
NC_037349.1,NC_032671.1,8697968,8733665,8733669,a,atggg,4
NC_037349.1,NC_032671.1,8698441,8734141,8734142,A,AT,1
NC_037349.1,NC_032671.1,8698928,8734624,8734627,G,GAGA,3
NC_037349.1,NC_032671.1,8699118,8734817,8734821,T,TCCAA,4
NC_037349.1,NC_032671.1,8719183,8721649,8721650,G,GC,1
NC_037349.1,NC_032671.1,8719265,8721729,8721730,T,TG,1
NC_037349.1,NC_032671.1,8719435,8721899,8721900,G,GC,1
NC_037349.1,NC_032671.1,8721189,8723626,8723627,C,CT,1
NC_037349.1,NC_032671.1,8732770,8735216,8735231,T,TTCATGTTCCTTAAAA,15
NC_037349.1,NC_032671.1,8742411,8744869,8744871,A,ACT,2
NC_037349.1,NC_032671.1,8752255,8754714,8754715,C,CT,1
NC_037349.1,NC_032671.1,8752587,8755075,8755077,a,aat,2
NC_037349.1,NC_032671.1,8773656,8776154,8776155,G,GK,1
NC_037349.1,NC_032671.1,8779204,8781704,8781705,t,tg,1
NC_037349.1,NC_032671.1,8876405,8878883,8878884,T,TA,1
NC_037349.1,NC_032671.1,8879174,8881656,8881660,c,cctat,4
NC_037349.1,NC_032671.1,8882702,8885190,8885194,T,TTGAG,4
NC_037349.1,NC_032671.1,8921812,8924294,8924295,C,CT,1
NC_037349.1,NC_032671.1,8921929,8924412,8924417,t,ttatga,5
NC_037349.1,NC_032671.1,8921933,8924421,8924425,a,atttt,4
NC_037349.1,NC_032671.1,8988740,8991231,8991232,T,TG,1
NC_037349.1,NC_032671.1,8993402,8995896,8995899,T,TKTG,3
NC_037349.1,NC_032671.1,8997853,9000349,9000359,A,AATGTTCCCTT,10
NC_037349.1,NC_032671.1,9023806,9026351,9026353,a,aat,2
NC_037349.1,NC_032671.1,9028198,9030751,9030752,T,TA,1
NC_037349.1,NC_032671.1,9033895,9036410,9036411,a,ag,1
NC_037349.1,NC_032671.1,9046823,9049367,9049368,T,TM,1
NC_037349.1,NC_032671.1,9046842,9049387,9049388,A,AC,1
NC_037349.1,NC_032671.1,9052032,9054576,9054578,a,atg,2
NC_037349.1,NC_032671.1,9057130,9059676,9059677,C,CY,1
NC_037349.1,NC_032671.1,9061234,9063870,9063872,t,tNN,2
NC_037349.1,NC_032671.1,9082706,9085346,9085357,g,gggttACGTGAT,11
NC_037349.1,NC_032671.1,9144584,9147542,9147543,a,at,1
NC_037349.1,NC_032671.1,9146984,9149426,9149430,t,tNNNN,4
NC_037349.1,NC_032671.1,9160648,9163125,9163126,t,tc,1
NC_037349.1,NC_032671.1,9161724,9164196,9164197,G,GR,1
NC_037349.1,NC_032671.1,9163158,9165631,9165632,a,ag,1
NC_037349.1,NC_032671.1,9163207,9165681,9165682,g,ga,1
NC_037349.1,NC_032671.1,9164322,9166799,9166800,a,at,1
NC_037349.1,NC_032671.1,9189657,9192474,9192480,t,tgtgtgW,6
NC_037349.1,NC_032671.1,9201260,9204091,9204093,t,tgc,2
NC_037349.1,NC_032671.1,9310258,9314091,9314092,G,GS,1
NC_037349.1,NC_032671.1,9314264,9318101,9318102,C,CS,1
NC_037349.1,NC_032671.1,9317706,9321544,9321546,A,AAG,2
NC_037349.1,NC_032671.1,9339738,9343324,9343343,G,GTGTTGCTTTTAGGAACCAT,19
NC_037349.1,NC_032671.1,9345871,9362112,9362113,T,TA,1
NC_037349.1,NC_032671.1,9346455,9350066,9350067,A,AC,1
NC_037349.1,NC_032671.1,9347305,9350918,9350919,c,ct,1
NC_037349.1,NC_032671.1,9352379,9368621,9368626,G,GCTTAT,5
NC_037349.1,NC_032671.1,9352383,9368630,9368631,A,AG,1
NC_037349.1,NC_032671.1,9373591,9389841,9389842,t,ta,1
NC_037349.1,NC_032671.1,9385793,9402049,9402051,t,ttc,2
NC_037349.1,NC_032671.1,9392379,9408637,9408638,T,TK,1
NC_037349.1,NC_032671.1,9439760,9455860,9455863,a,acct,3
NC_037349.1,NC_032671.1,9470159,9486272,9486274,t,ttg,2
NC_037349.1,NC_032671.1,9470447,9486562,9486566,T,TAGAG,4
NC_037349.1,NC_032671.1,9484759,9499776,9499777,a,ac,1
NC_037349.1,NC_032671.1,9490137,9504761,9504765,C,CTCTA,4
NC_037349.1,NC_032671.1,9507515,9524827,9524828,a,ac,1
NC_037349.1,NC_032671.1,9507886,9525199,9525200,A,AC,1
NC_037349.1,NC_032671.1,9513957,9531277,9531278,c,ca,1
NC_037349.1,NC_032671.1,9519426,9536746,9536754,g,gttcataaa,8
NC_037349.1,NC_032671.1,9556621,9573893,9573899,a,acaacag,6
NC_037349.1,NC_032671.1,9583539,9600809,9600810,t,tg,1
NC_037349.1,NC_032671.1,9608631,9625906,9625907,C,CG,1
NC_037349.1,NC_032671.1,9682779,9700528,9700529,a,at,1
NC_037349.1,NC_032671.1,9684075,9701827,9701828,C,CA,1
NC_037349.1,NC_032671.1,9703307,9721061,9721062,c,ct,1
NC_037349.1,NC_032671.1,9717726,9735479,9735481,G,GAA,2
NC_037349.1,NC_032671.1,9725120,9742868,9742869,G,GT,1
NC_037349.1,NC_032671.1,9728631,9746457,9746461,t,tgtaa,4
NC_037349.1,NC_032671.1,9729511,9747341,9747342,a,at,1
NC_037349.1,NC_032671.1,9730813,9748642,9748648,T,TCATWGC,6
NC_037349.1,NC_032671.1,9731549,9749383,9749385,t,ttc,2
NC_037349.1,NC_032671.1,9743066,9760904,9760905,c,ct,1
NC_037349.1,NC_032671.1,9743798,9761637,9761638,C,CT,1
NC_037349.1,NC_032671.1,9744280,9762135,9762140,t,tttttg,5
NC_037349.1,NC_032671.1,9774262,9792126,9792127,c,ct,1
NC_037349.1,NC_032671.1,9774468,9792333,9792347,t,tcttcagcactcagc,14
NC_037349.1,NC_032671.1,9796502,9814421,9814422,T,TA,1
NC_037349.1,NC_032671.1,9797499,9815416,9815420,T,TTATA,4
NC_037349.1,NC_032671.1,9821565,9839521,9839525,G,GACAA,4
NC_037349.1,NC_032671.1,9833807,9851769,9851770,A,AC,1
NC_037349.1,NC_032671.1,9850913,9868877,9868878,G,GA,1
NC_037349.1,NC_032671.1,9852420,9870386,9870388,t,taa,2
NC_037349.1,NC_032671.1,9856801,9874802,9874806,T,TGTCA,4
NC_037349.1,NC_032671.1,9858504,9876509,9876510,g,gc,1
NC_037349.1,NC_032671.1,9858584,9876595,9876598,g,gaaa,3
NC_037349.1,NC_032671.1,10001632,10019155,10019156,c,cg,1
NC_037349.1,NC_032671.1,10031902,10049428,10049429,g,ga,1
NC_037349.1,NC_032671.1,10038944,10056465,10056466,a,at,1
NC_037349.1,NC_032671.1,10052678,10070215,10070216,t,ta,1
NC_037349.1,NC_032671.1,10056297,10073837,10073844,t,tccttttc,7
NC_037349.1,NC_032671.1,10081920,10124274,10124275,T,TG,1
NC_037349.1,NC_032671.1,10108271,10150612,10150617,A,ATCATC,5
NC_037349.1,NC_032671.1,10108764,10151110,10151111,C,CY,1
NC_037349.1,NC_032671.1,10117105,10159457,10159458,C,CY,1
NC_037349.1,NC_032671.1,10120061,10162349,10162350,g,gc,1
NC_037349.1,NC_032671.1,10168508,10210805,10210806,t,ta,1
NC_037349.1,NC_032671.1,10173507,10215812,10215813,T,TC,1
NC_037349.1,NC_032671.1,10178679,10220984,10220985,t,tg,1
NC_037349.1,NC_032671.1,10185921,10228228,10228234,T,TTTGGTA,6
NC_037349.1,NC_032671.1,10190851,10233160,10233161,g,gt,1
NC_037349.1,NC_032671.1,10194370,10236680,10236681,G,GT,1
NC_037349.1,NC_032671.1,10200309,10242620,10242621,t,ta,1
NC_037349.1,NC_032671.1,10204599,10246924,10246925,C,CA,1
NC_037349.1,NC_032671.1,10208889,10251226,10251227,T,TY,1
NC_037349.1,NC_032671.1,10242900,10285236,10285239,A,AGTC,3
NC_037349.1,NC_032671.1,10244806,10287145,10287147,t,ttc,2
NC_037349.1,NC_032671.1,10244822,10287163,10287164,t,ta,1
NC_037349.1,NC_032671.1,10250454,10292798,10292799,T,TA,1
NC_037349.1,NC_032671.1,10251589,10293935,10293936,G,GR,1
NC_037349.1,NC_032671.1,10262891,10305449,10305450,a,ac,1
NC_037349.1,NC_032671.1,10282587,10325148,10325150,t,ttg,2
NC_037349.1,NC_032671.1,10286161,10328724,10328725,C,CA,1
NC_037349.1,NC_032671.1,10349821,10392296,10392298,c,cgg,2
NC_037349.1,NC_032671.1,10526279,10569098,10569099,C,CY,1
NC_037349.1,NC_032671.1,10569239,10612062,10612063,T,TC,1
NC_037349.1,NC_032671.1,10752306,10791455,10791458,A,AAAG,3
NC_037349.1,NC_032671.1,10772232,10811383,10811385,A,AAG,2
NC_037349.1,NC_032671.1,10807214,10846104,10846106,a,aNN,2
NC_037349.1,NC_032671.1,10873478,10912370,10912371,T,TY,1
NC_037349.1,NC_032671.1,10970049,11008941,11008950,A,AGGGCCAGAC,9
NC_037349.1,NC_032671.1,11070107,11109008,11109009,A,AC,1
NC_037349.1,NC_032671.1,11091684,11130589,11130590,T,TC,1
NC_037349.1,NC_032671.1,11150930,11190321,11190322,C,CA,1
NC_037349.1,NC_032671.1,11153164,11192556,11192557,g,gt,1
NC_037349.1,NC_032671.1,11163968,11207733,11207749,C,CAGAAAAATGGATGGAT,16
NC_037349.1,NC_032671.1,11181913,11225666,11225668,C,CSA,2
NC_037349.1,NC_032671.1,11185690,11229447,11229448,T,TY,1
NC_037349.1,NC_032671.1,11191138,11234896,11234897,G,GC,1
NC_037349.1,NC_032671.1,11205387,11249170,11249171,C,CG,1
NC_037349.1,NC_032671.1,11257754,11301543,11301544,c,ct,1
NC_037349.1,NC_032671.1,11394743,11438396,11438397,T,TY,1
NC_037349.1,NC_032671.1,11501053,11618532,11618534,g,gtt,2
NC_037349.1,NC_032671.1,11502261,11619743,11619744,A,AT,1
NC_037349.1,NC_032671.1,11502883,11620366,11620367,C,CT,1
NC_037349.1,NC_032671.1,11579650,11697121,11697123,G,GAC,2
NC_037349.1,NC_032671.1,11581291,11698765,11698768,G,GTGA,3
NC_037349.1,NC_032671.1,11583169,11700646,11700647,T,TK,1
NC_037349.1,NC_032671.1,11586496,11703974,11703976,C,CCT,2
NC_037349.1,NC_032671.1,11628510,11745991,11745992,A,AC,1
NC_037349.1,NC_032671.1,11661378,11779459,11779460,t,tY,1
NC_037349.1,NC_032671.1,11737132,11855229,11855230,C,CY,1
NC_037349.1,NC_032671.1,11756005,11874106,11874112,a,aNtatat,6
NC_037349.1,NC_032671.1,11774388,11891565,11891566,t,tc,1
NC_037349.1,NC_032671.1,11776228,11893395,11893397,c,ctt,2
NC_037349.1,NC_032671.1,11846946,11964841,11964842,G,GT,1
NC_037349.1,NC_032671.1,11933060,12051039,12051040,t,tc,1
NC_037349.1,NC_032671.1,11941034,12059011,12059012,t,ta,1
NC_037349.1,NC_032671.1,11945100,12063079,12063080,C,CG,1
NC_037349.1,NC_032671.1,11957446,12075418,12075419,G,GT,1
NC_037349.1,NC_032671.1,12011483,12129370,12129372,c,cca,2
NC_037349.1,NC_032671.1,12088562,12206096,12206099,c,cTCT,3
NC_037349.1,NC_032671.1,12173768,12311160,12311162,t,tNN,2
NC_037349.1,NC_032671.1,12411238,12703901,12703905,C,CTGTT,4
NC_037349.1,NC_032671.1,12756898,12957685,12957686,C,CG,1
NC_037349.1,NC_032671.1,12860240,13061032,13061033,a,at,1
NC_037349.1,NC_032671.1,13017486,13230856,13230858,C,CTG,2
NC_037349.1,NC_032671.1,13392038,13683747,13683748,c,ct,1
NC_037349.1,NC_032671.1,13484839,13815486,13815493,c,caaacaag,7
NC_037349.1,NC_032671.1,13486238,13816892,13816893,t,tg,1
NC_037349.1,NC_032671.1,13489389,13820042,13820043,g,gc,1
NC_037349.1,NC_032671.1,13490908,13821560,13821566,t,taattta,6
NC_037349.1,NC_032671.1,13692864,14025483,14025484,C,CT,1
NC_037349.1,NC_032671.1,13794197,14126772,14126773,C,CY,1
NC_037349.1,NC_032671.1,13821918,14154498,14154501,g,gggc,3
NC_037349.1,NC_032671.1,13914730,14248386,14248390,t,tacac,4
NC_037349.1,NC_032671.1,13932151,14265816,14265817,C,CY,1
NC_037349.1,NC_032671.1,13932223,14265889,14265890,G,GC,1
NC_037349.1,NC_032671.1,13941132,14274803,14274806,T,TGCA,3
NC_037349.1,NC_032671.1,13951090,14284773,14284774,g,ga,1
NC_037349.1,NC_032671.1,13952701,14286385,14286393,A,AAAGYGTCC,8
NC_037349.1,NC_032671.1,13952808,14286500,14286513,A,AGAAGACCAGTTCT,13
NC_037349.1,NC_032671.1,13966532,14300239,14300240,c,cg,1
NC_037349.1,NC_032671.1,13978164,14311938,14311966,T,TTGCATATTATGTTATTAGGGGCATATTA,28
NC_037349.1,NC_032671.1,14030576,14364304,14364307,C,CTCT,3
NC_037349.1,NC_032671.1,14052531,14386268,14386269,A,AM,1
NC_037349.1,NC_032671.1,14133362,14467213,14467215,A,AAT,2
NC_037349.1,NC_032671.1,14159623,14492812,14492813,t,tg,1
NC_037349.1,NC_032671.1,14167778,14500970,14500972,a,aac,2
NC_037349.1,NC_032671.1,14167838,14501032,14501033,T,TA,1
NC_037349.1,NC_032671.1,14169665,14502855,14502856,G,GK,1
NC_037349.1,NC_032671.1,14169757,14502948,14502949,g,ga,1
NC_037349.1,NC_032671.1,14169841,14503033,14503035,c,caa,2
NC_037349.1,NC_032671.1,14173905,14506545,14506556,t,taagtattatta,11
NC_037349.1,NC_032671.1,14224469,14564865,14564867,a,aNN,2
NC_037349.1,NC_032671.1,14229010,14569409,14569410,c,ca,1
NC_037349.1,NC_032671.1,14252333,14592743,14592762,c,cgactcttcgagaccccatg,19
NC_037349.1,NC_032671.1,14336171,14677296,14677297,g,gt,1
NC_037349.1,NC_032671.1,14343462,14684588,14684589,A,AW,1
NC_037349.1,NC_032671.1,14344865,14685995,14685996,a,ac,1
NC_037349.1,NC_032671.1,14344934,14686065,14686069,c,cttgt,4
NC_037349.1,NC_032671.1,14359563,14700698,14700713,c,ctaAGTGGTTGAAAAA,15
NC_037349.1,NC_032671.1,14779051,15191276,15191277,a,ac,1
NC_037349.1,NC_032671.1,14799876,15212786,15212787,G,GN,1
NC_037349.1,NC_032671.1,14827549,15240484,15240485,C,CA,1
NC_037349.1,NC_032671.1,14858845,15271509,15271510,G,GS,1
NC_037349.1,NC_032671.1,14991905,15405991,15405992,t,ta,1
NC_037349.1,NC_032671.1,15006745,15421056,15421057,T,TK,1
NC_037349.1,NC_032671.1,15203297,15617321,15617324,T,TATY,3
NC_037349.1,NC_032671.1,15350909,15765061,15765062,t,ta,1
NC_037349.1,NC_032671.1,15483329,15901489,15901490,G,GA,1
NC_037349.1,NC_032671.1,15483333,15901494,15901495,A,AT,1
NC_037349.1,NC_032671.1,15530867,15949978,15949979,g,ga,1
NC_037349.1,NC_032671.1,15542751,15961863,15961864,t,tc,1
NC_037349.1,NC_032671.1,15542867,15961980,15961981,c,ca,1
NC_037349.1,NC_032671.1,15555244,15973906,15973907,T,TG,1
NC_037349.1,NC_032671.1,15605415,16025286,16025288,T,TTG,2
NC_037349.1,NC_032671.1,15626643,16046520,16046521,A,AR,1
NC_037349.1,NC_032671.1,15637088,16056966,16056967,A,AM,1
NC_037349.1,NC_032671.1,15683659,16103180,16103182,t,tNN,2
NC_037349.1,NC_032671.1,15706859,16125864,16125865,g,gt,1
NC_037349.1,NC_032671.1,15767523,16187079,16187080,t,ta,1
NC_037349.1,NC_032671.1,15781749,16201308,16201309,G,GC,1
NC_037349.1,NC_032671.1,15781763,16201323,16201325,C,CCG,2
NC_037349.1,NC_032671.1,15813750,16233316,16233318,t,tta,2
NC_037349.1,NC_032671.1,15997439,16415125,16415126,T,TK,1
NC_037349.1,NC_032671.1,16047987,16465524,16465525,A,AR,1
NC_037349.1,NC_032671.1,16072920,16490020,16490021,g,ga,1
NC_037349.1,NC_032671.1,16079425,16496526,16496532,c,cNNNNNN,6
NC_037349.1,NC_032671.1,16158588,16575697,16575698,a,at,1
NC_037349.1,NC_032671.1,16318197,16735322,16735324,t,tta,2
NC_037349.1,NC_032671.1,16349510,16766664,16766665,t,ta,1
NC_037349.1,NC_032671.1,16352861,16770020,16770021,T,TC,1
NC_037349.1,NC_032671.1,16353136,16770282,16770283,a,at,1
NC_037349.1,NC_032671.1,16354385,16771532,16771533,a,aN,1
NC_037349.1,NC_032671.1,16359322,16776470,16776471,t,tK,1
NC_037349.1,NC_032671.1,16367737,16784772,16784773,C,CA,1
NC_037349.1,NC_032671.1,16382329,16799526,16799527,A,AR,1
NC_037349.1,NC_032671.1,16382523,16799721,16799723,A,AAW,2
NC_037349.1,NC_032671.1,16449497,16869702,16869704,T,TTG,2
NC_037349.1,NC_032671.1,16469746,16889996,16889999,t,tata,3
NC_037349.1,NC_032671.1,16481159,16901413,16901415,T,TTG,2
NC_037349.1,NC_032671.1,16485991,16906246,16906247,T,TA,1
NC_037349.1,NC_032671.1,16514448,16934555,16934557,c,ctg,2
NC_037349.1,NC_032671.1,16584255,17004305,17004307,a,aac,2
NC_037349.1,NC_032671.1,16594317,17020377,17020378,c,ct,1
NC_037349.1,NC_032671.1,16594320,17020381,17020382,c,ct,1
NC_037349.1,NC_032671.1,16713337,17139015,17139040,C,CCCATACATGCTACAGGTTTTCGATT,25
NC_037349.1,NC_032671.1,16811451,17236774,17236776,g,gcc,2
NC_037349.1,NC_032671.1,16828238,17253568,17253569,G,GS,1
NC_037349.1,NC_032671.1,16857133,17282464,17282466,A,AAC,2
NC_037349.1,NC_032671.1,16983747,17409161,17409162,c,ca,1
NC_037349.1,NC_032671.1,16984083,17409498,17409499,g,gt,1
NC_037349.1,NC_032671.1,17071756,17542535,17542536,c,ca,1
NC_037349.1,NC_032671.1,17099738,17570518,17570520,t,tNN,2
NC_037349.1,NC_032671.1,17101419,17572201,17572204,T,TATG,3
NC_037349.1,NC_032671.1,17269048,17739854,17739855,A,AT,1
NC_037349.1,NC_032671.1,17447878,17918730,17918731,A,AG,1
NC_037349.1,NC_032671.1,17498930,17969786,17969787,A,AT,1
NC_037349.1,NC_032671.1,17522393,17993250,17993251,G,GS,1
NC_037349.1,NC_032671.1,17527818,17998669,17998670,C,CA,1
NC_037349.1,NC_032671.1,17535953,18006805,18006809,T,TCTAA,4
NC_037349.1,NC_032671.1,17546270,18017126,18017148,t,tgtgtatatatataaatatatag,22
NC_037349.1,NC_032671.1,17567720,18038599,18038600,a,aM,1
NC_037349.1,NC_032671.1,17599572,18070453,18070454,T,TG,1
NC_037349.1,NC_032671.1,17629448,18100392,18100395,t,taac,3
NC_037349.1,NC_032671.1,17632596,18103544,18103545,a,ac,1
NC_037349.1,NC_032671.1,17736340,18246290,18246291,t,ta,1
NC_037349.1,NC_032671.1,17754169,18264123,18264124,T,TG,1
NC_037349.1,NC_032671.1,17754908,18264863,18264864,A,AR,1
NC_037349.1,NC_032671.1,17792338,18301957,18301958,T,TS,1
NC_037349.1,NC_032671.1,17814387,18340462,18340468,a,aNNNNNN,6
NC_037349.1,NC_032671.1,17861281,18387333,18387336,g,ggaa,3
NC_037349.1,NC_032671.1,17978075,18504029,18504030,G,GR,1
NC_037349.1,NC_032671.1,17990114,18516079,18516080,g,ga,1
NC_037349.1,NC_032671.1,18035490,18561464,18561468,C,CCTGA,4
NC_037349.1,NC_032671.1,18065886,18591682,18591683,A,AG,1
NC_037349.1,NC_032671.1,18085406,18611212,18611213,G,GR,1
NC_037349.1,NC_032671.1,18111326,18637101,18637105,T,TTTAC,4
NC_037349.1,NC_032671.1,18150493,18679784,18679785,A,AC,1
NC_037349.1,NC_032671.1,18158161,18687453,18687454,T,TG,1
NC_037349.1,NC_032671.1,18228904,18758224,18758225,c,ca,1
NC_037349.1,NC_032671.1,18238568,18767890,18767892,T,TTA,2
NC_037349.1,NC_032671.1,18277578,18806805,18806806,C,CT,1
NC_037349.1,NC_032671.1,18350498,18879786,18879787,g,gS,1
NC_037349.1,NC_032671.1,18366324,18895612,18895613,g,gc,1
NC_037349.1,NC_032671.1,18366663,18895951,18895955,g,gtata,4
NC_037349.1,NC_032671.1,18384214,18913508,18913509,t,ta,1
NC_037349.1,NC_032671.1,18390476,18919665,18919666,C,CY,1
NC_037349.1,NC_032671.1,18396138,18925332,18925338,T,TGTTTCC,6
NC_037349.1,NC_032671.1,18400258,18929459,18929462,c,cttt,3
NC_037349.1,NC_032671.1,18502486,19031700,19031701,T,TA,1
NC_037349.1,NC_032671.1,18531928,19060873,19060874,C,CY,1
NC_037349.1,NC_032671.1,18559851,19088802,19088804,g,ggt,2
NC_037349.1,NC_032671.1,18566488,19095437,19095438,a,at,1
NC_037349.1,NC_032671.1,18705367,19235417,19235418,T,TY,1
NC_037349.1,NC_032671.1,18708604,19238666,19238667,C,CG,1
NC_037349.1,NC_032671.1,18711585,19241651,19241652,T,TA,1
NC_037349.1,NC_032671.1,18711972,19242039,19242040,C,CM,1
NC_037349.1,NC_032671.1,18712154,19242222,19242224,T,TCA,2
NC_037349.1,NC_032671.1,18715473,19245544,19245546,T,TCA,2
NC_037349.1,NC_032671.1,18724373,19254578,19254579,A,AR,1
NC_037349.1,NC_032671.1,18737161,19266323,19266343,t,taaaatgatggtcattctgac,20
NC_037349.1,NC_032671.1,18740203,19269381,19269446,G,GCACAACGGCTTATTATTTGTATGTCTAAGAACTGAGGTCCTAGAAGGATGGTAAAACCTTCCTGA,65
NC_037349.1,NC_032671.1,18741220,19270459,19270463,a,agaag,4
NC_037349.1,NC_032671.1,18748014,19277241,19277242,C,CT,1
NC_037349.1,NC_032671.1,18756656,19285856,19285857,C,CT,1
NC_037349.1,NC_032671.1,18756779,19285980,19285981,T,TA,1
NC_037349.1,NC_032671.1,18804706,19329875,19329876,c,cY,1
NC_037349.1,NC_032671.1,18824408,19352055,19352056,A,AW,1
NC_037349.1,NC_032671.1,18827630,19355278,19355279,t,tg,1
NC_037349.1,NC_032671.1,18832115,19359758,19359759,a,ag,1
NC_037349.1,NC_032671.1,18857157,19384812,19384813,T,TG,1
NC_037349.1,NC_032671.1,18857730,19385386,19385387,G,GT,1
NC_037349.1,NC_032671.1,18858159,19385812,19385813,A,AS,1
NC_037349.1,NC_032671.1,19020279,19561255,19561256,g,ga,1
NC_037349.1,NC_032671.1,19050702,19591939,19591940,t,ta,1
NC_037349.1,NC_032671.1,19064662,19605908,19605910,a,aNN,2
NC_037349.1,NC_032671.1,19065171,19606419,19606422,T,TATC,3
NC_037349.1,NC_032671.1,19068128,19609407,19609408,c,ct,1
NC_037349.1,NC_032671.1,19072451,19616939,19616940,a,ag,1
NC_037349.1,NC_032671.1,19088743,19633134,19633135,T,TM,1
NC_037349.1,NC_032671.1,19089487,19633879,19633882,c,ccca,3
NC_037349.1,NC_032671.1,19127872,19672516,19672517,a,ac,1
NC_037349.1,NC_032671.1,19128158,19672802,19672804,a,aag,2
NC_037349.1,NC_032671.1,19267651,19812311,19812312,t,ta,1
NC_037349.1,NC_032671.1,19267973,19812634,19812635,c,ct,1
NC_037349.1,NC_032671.1,19273825,19818487,19818488,t,ta,1
NC_037349.1,NC_032671.1,19334296,19878965,19878966,T,TC,1
NC_037349.1,NC_032671.1,19373501,19917955,19917957,c,caa,2
NC_037349.1,NC_032671.1,19395622,19939953,19939955,a,aNN,2
NC_037349.1,NC_032671.1,19424144,19999057,19999058,G,GT,1
NC_037349.1,NC_032671.1,19433396,20012261,20012274,t,tgtgtgtgtgtata,13
NC_037349.1,NC_032671.1,19457274,20036366,20036367,a,aW,1
NC_037349.1,NC_032671.1,19458821,20037914,20037916,c,cag,2
NC_037349.1,NC_032671.1,19461286,20040380,20040381,T,TA,1
NC_037349.1,NC_032671.1,19461354,20040449,20040451,C,CAA,2
NC_037349.1,NC_032671.1,19493740,20043518,20043520,g,gTC,2
NC_037349.1,NC_032671.1,19497052,20046831,20046832,G,GC,1
NC_037349.1,NC_032671.1,19539752,20089535,20089536,A,AG,1
NC_037349.1,NC_032671.1,19562478,20112265,20112269,g,gtata,4
NC_037349.1,NC_032671.1,19620093,20169894,20169908,c,ctctgcAAGATGcct,14
NC_037349.1,NC_032671.1,19621126,20170952,20170953,C,CT,1
NC_037349.1,NC_032671.1,19621247,20171074,20171078,t,tgtgg,4
NC_037349.1,NC_032671.1,19627943,20177775,20177777,c,ctt,2
NC_037349.1,NC_032671.1,19631523,20181447,20181448,g,ga,1
NC_037349.1,NC_032671.1,19634384,20184309,20184310,A,AR,1
NC_037349.1,NC_032671.1,19644826,20194768,20194769,c,ct,1
NC_037349.1,NC_032671.1,19653394,20203363,20203364,G,GC,1
NC_037349.1,NC_032671.1,19723930,20273901,20273902,A,AC,1
NC_037349.1,NC_032671.1,19727473,20277443,20277444,c,ca,1
NC_037349.1,NC_032671.1,19727853,20277824,20277825,g,ga,1
NC_037349.1,NC_032671.1,19731456,20281429,20281430,t,tc,1
NC_037349.1,NC_032671.1,19736406,20286382,20286383,a,ag,1
NC_037349.1,NC_032671.1,19764374,20317433,20317436,g,gttt,3
NC_037349.1,NC_032671.1,19782437,20335507,20335508,A,AT,1
NC_037349.1,NC_032671.1,19787284,20340357,20340358,t,ta,1
NC_037349.1,NC_032671.1,19804610,20360418,20360438,A,ATAATTaaggcaaattatttt,20
NC_037349.1,NC_032671.1,19808554,20364383,20364387,C,CATTG,4
NC_037349.1,NC_032671.1,19899816,20457846,20457847,A,AR,1
NC_037349.1,NC_032671.1,19927212,20485179,20485181,a,aac,2
NC_037349.1,NC_032671.1,19942665,20507298,20507300,t,ttc,2
NC_037349.1,NC_032671.1,19946110,20510706,20510707,a,ag,1
NC_037349.1,NC_032671.1,19947433,20512030,20512038,a,attttgctt,8
NC_037349.1,NC_032671.1,19957953,20522539,20522540,a,ag,1
NC_037349.1,NC_032671.1,20034459,20599095,20599096,G,GW,1
NC_037349.1,NC_032671.1,20078818,20644812,20644814,t,tta,2
NC_037349.1,NC_032671.1,20176162,20741705,20741706,T,TA,1
NC_037349.1,NC_032671.1,20190007,20755554,20755556,g,gga,2
NC_037349.1,NC_032671.1,20190036,20755585,20755586,t,ta,1
NC_037349.1,NC_032671.1,20231414,20796956,20796957,g,gt,1
NC_037349.1,NC_032671.1,20321103,20888979,20888980,g,ga,1
NC_037349.1,NC_032671.1,20525582,21141376,21141377,t,tc,1
NC_037349.1,NC_032671.1,20553117,21168912,21168918,a,agtgtgt,6
NC_037349.1,NC_032671.1,20578503,21194745,21194748,c,cact,3
NC_037349.1,NC_032671.1,20590719,21208430,21208431,g,ga,1
NC_037349.1,NC_032671.1,20623731,21241457,21241461,g,gaaaa,4
NC_037349.1,NC_032671.1,20634710,21252439,21252441,a,aag,2
NC_037349.1,NC_032671.1,20683780,21301190,21301191,t,tg,1
NC_037349.1,NC_032671.1,20685664,21303106,21303118,C,CAGCACAACTGGT,12
NC_037349.1,NC_032671.1,20698688,21316163,21316164,t,tc,1
NC_037349.1,NC_032671.1,20725496,21342977,21342979,t,taa,2
NC_037349.1,NC_032671.1,20733163,21352703,21352704,t,tg,1
NC_037349.1,NC_032671.1,20793712,21413451,21413453,a,att,2
NC_037349.1,NC_032671.1,20793992,21413733,21413735,t,tac,2
NC_037349.1,NC_032671.1,20807966,21427714,21427716,C,CAG,2
NC_037349.1,NC_032671.1,20811687,21431436,21431437,T,TK,1
NC_037349.1,NC_032671.1,20826770,21490793,21490794,g,gc,1
NC_037349.1,NC_032671.1,20826827,21490851,21490852,t,tg,1
NC_037349.1,NC_032671.1,20826890,21490915,21490916,t,tc,1
NC_037349.1,NC_032671.1,20852058,21515977,21515978,c,ca,1
NC_037349.1,NC_032671.1,20894593,21558288,21558289,C,CA,1
NC_037349.1,NC_032671.1,20965828,21629193,21629194,A,AR,1
NC_037349.1,NC_032671.1,21043165,21714421,21714422,t,tc,1
NC_037349.1,NC_032671.1,21048198,21719452,21719453,a,at,1
NC_037349.1,NC_032671.1,21053732,21724988,21724989,T,TA,1
NC_037349.1,NC_032671.1,21075385,21746632,21746637,A,ATAAAT,5
NC_037349.1,NC_032671.1,21099650,21770915,21770916,G,GT,1
NC_037349.1,NC_032671.1,21152954,21824251,21824252,t,ta,1
NC_037349.1,NC_032671.1,21216315,21895298,21895299,T,TC,1
NC_037349.1,NC_032671.1,21262493,21941126,21941127,C,CA,1
NC_037349.1,NC_032671.1,21262501,21941135,21941136,G,GT,1
NC_037349.1,NC_032671.1,21262518,21941153,21941154,A,AR,1
NC_037349.1,NC_032671.1,21304265,21982895,21982908,t,ttacacacacacac,13
NC_037349.1,NC_032671.1,21307842,21986482,21986483,g,ga,1
NC_037349.1,NC_032671.1,21323763,22002405,22002407,G,GTC,2
NC_037349.1,NC_032671.1,21344442,22023088,22023089,T,TG,1
NC_037349.1,NC_032671.1,21345615,22024262,22024267,t,tcttca,5
NC_037349.1,NC_032671.1,21349148,22027799,22027801,c,caa,2
NC_037349.1,NC_032671.1,21447359,22125995,22125997,c,caa,2
NC_037349.1,NC_032671.1,21451078,22129717,22129718,A,AC,1
NC_037349.1,NC_032671.1,21517097,22192584,22192585,T,TA,1
NC_037349.1,NC_032671.1,21540873,22216371,22216372,c,ca,1
NC_037349.1,NC_032671.1,21541180,22216679,22216680,t,ta,1
NC_037349.1,NC_032671.1,21599458,22274885,22274886,A,AR,1
NC_037349.1,NC_032671.1,21604947,22280375,22280376,C,CG,1
NC_037349.1,NC_032671.1,21685216,22360645,22360646,T,TC,1
NC_037349.1,NC_032671.1,21696281,22371728,22371729,t,ta,1
NC_037349.1,NC_032671.1,21726907,22402338,22402339,G,GA,1
NC_037349.1,NC_032671.1,21726912,22402344,22402345,C,CT,1
NC_037349.1,NC_032671.1,21726925,22402358,22402359,A,AC,1
NC_037349.1,NC_032671.1,21769852,22445306,22445307,A,AR,1
NC_037349.1,NC_032671.1,21788652,22464375,22464376,A,AR,1
NC_037349.1,NC_032671.1,21796670,22473495,22473496,t,ta,1
NC_037349.1,NC_032671.1,22084876,22774260,22774261,c,ct,1
NC_037349.1,NC_032671.1,22085129,22774514,22774516,a,act,2
NC_037349.1,NC_032671.1,22112758,22802145,22802146,g,ga,1
NC_037349.1,NC_032671.1,22277063,22915036,22915037,a,at,1
NC_037349.1,NC_032671.1,22291428,22929403,22929404,C,CY,1
NC_037349.1,NC_032671.1,22305537,22943514,22943515,t,tg,1
NC_037349.1,NC_032671.1,22545397,23127000,23127006,t,ttccaag,6
NC_037349.1,NC_032671.1,22615174,23196786,23196787,A,AW,1
NC_037349.1,NC_032671.1,22635196,23216813,23216814,A,AW,1
NC_037349.1,NC_032671.1,22672540,23256083,23256084,g,ga,1
NC_037349.1,NC_032671.1,22694307,23277810,23277811,T,TG,1
NC_037349.1,NC_032671.1,22717042,23300560,23300562,g,gct,2
NC_037349.1,NC_032671.1,22717044,23300564,23300565,c,ct,1
NC_037349.1,NC_032671.1,22717050,23300571,23300573,a,aag,2
NC_037349.1,NC_032671.1,22856220,23423121,23423122,t,tc,1
NC_037349.1,NC_032671.1,22989710,23556457,23556461,T,TGTNN,4
NC_037349.1,NC_032671.1,23110833,23723970,23723971,A,AC,1
NC_037349.1,NC_032671.1,23125349,23739167,23739169,C,CCA,2
NC_037349.1,NC_032671.1,23168899,23782717,23782718,g,ga,1
NC_037349.1,NC_032671.1,23191028,23804847,23804848,g,ga,1
NC_037349.1,NC_032671.1,23371995,23986673,23986674,a,at,1
NC_037349.1,NC_032671.1,23374935,23989614,23989615,t,ta,1
NC_037349.1,NC_032671.1,23411330,24026429,24026433,G,GTACA,4
NC_037349.1,NC_032671.1,23478727,24087884,24087885,g,gc,1
NC_037349.1,NC_032671.1,23554611,24163930,24163931,c,ca,1
NC_037349.1,NC_032671.1,23566046,24175367,24175369,t,tac,2
NC_037349.1,NC_032671.1,23574167,24183489,24183491,a,aag,2
NC_037349.1,NC_032671.1,23602282,24211607,24211608,t,tg,1
NC_037349.1,NC_032671.1,23756311,24366020,24366021,a,at,1
NC_037349.1,NC_032671.1,23786319,24396033,24396043,G,GATAGTANNNA,10
NC_037349.1,NC_032671.1,23846452,24457730,24457731,T,TG,1
NC_037349.1,NC_032671.1,23854460,24465766,24465767,G,GC,1
NC_037349.1,NC_032671.1,23854515,24465824,24465825,a,at,1
NC_037349.1,NC_032671.1,23857790,24469100,24469104,t,tatta,4
NC_037349.1,NC_032671.1,23885200,24512599,24512603,T,TCAGA,4
NC_037349.1,NC_032671.1,23903379,24530328,24530348,A,ANNNNNNNNNNNNNNNNNNNN,20
NC_037349.1,NC_032671.1,23919308,24545799,24545801,a,aac,2
NC_037349.1,NC_032671.1,23925491,24551986,24551987,c,ct,1
NC_037349.1,NC_032671.1,23933337,24559833,24559835,T,TTG,2
NC_037349.1,NC_032671.1,24021470,24647021,24647022,A,AW,1
NC_037349.1,NC_032671.1,24026797,24652345,24652351,A,ATATAAC,6
NC_037349.1,NC_032671.1,24032023,24657555,24657556,a,ag,1
NC_037349.1,NC_032671.1,24033492,24659025,24659026,g,ga,1
NC_037349.1,NC_032671.1,24033684,24659218,24659220,a,atc,2
NC_037349.1,NC_032671.1,24033860,24659396,24659397,a,at,1
NC_037349.1,NC_032671.1,24033874,24659411,24659412,a,at,1
NC_037349.1,NC_032671.1,24034337,24659874,24659875,a,ac,1
NC_037349.1,NC_032671.1,24035121,24660661,24660663,T,TTC,2
NC_037349.1,NC_032671.1,24064418,24689954,24689955,g,gN,1
NC_037349.1,NC_032671.1,24065954,24807096,24807097,t,ta,1
NC_037349.1,NC_032671.1,24197082,24833320,24833321,t,ta,1
NC_037349.1,NC_032671.1,24310379,24946812,24946813,c,ca,1
NC_037349.1,NC_032671.1,24348786,24985241,24985244,C,CACT,3
NC_037349.1,NC_032671.1,24364411,25004322,25004323,G,GT,1
NC_037349.1,NC_032671.1,24369349,25009265,25009266,T,TY,1
NC_037349.1,NC_032671.1,24371074,25010991,25010995,t,tcatg,4
NC_037349.1,NC_032671.1,24466692,25110058,25110060,a,aNN,2
NC_037349.1,NC_032671.1,24502867,25147040,25147057,t,tccatcgagtcagtgatg,17
NC_037349.1,NC_032671.1,24532568,25177794,25177795,t,tg,1
NC_037349.1,NC_032671.1,24538700,25183929,25183930,C,CT,1
NC_037349.1,NC_032671.1,24555220,25200770,25200771,t,tc,1
NC_037349.1,NC_032671.1,24578584,25224135,25224136,a,aN,1
NC_037349.1,NC_032671.1,24715392,25361897,25361899,a,aNN,2
NC_037349.1,NC_032671.1,24749164,25395978,25395979,G,GN,1
NC_037349.1,NC_032671.1,24787044,25433873,25433879,c,ctttttt,6
NC_037349.1,NC_032671.1,24823501,25471696,25471697,g,gt,1
NC_037349.1,NC_032671.1,24824278,25472474,25472475,a,at,1
NC_037349.1,NC_032671.1,24831860,25480001,25480003,g,gaa,2
NC_037349.1,NC_032671.1,24833414,25481557,25481558,A,AG,1
NC_037349.1,NC_032671.1,24884967,25536428,25536434,G,GCAAAAT,6
NC_037349.1,NC_032671.1,24897287,25548764,25548765,t,tg,1
NC_037349.1,NC_032671.1,24933417,25584877,25584878,G,GC,1
NC_037349.1,NC_032671.1,24987568,25639024,25639025,T,TA,1
NC_037349.1,NC_032671.1,25109226,25760692,25760694,t,tgN,2
NC_037349.1,NC_032671.1,25214356,25865765,25865769,a,aNNNN,4
NC_037349.1,NC_032671.1,25251406,25902819,25902820,G,GM,1
NC_037349.1,NC_032671.1,25328726,25979956,25979957,A,AT,1
NC_037349.1,NC_032671.1,25332713,25983942,25983943,T,TK,1
NC_037349.1,NC_032671.1,25366931,26017920,26017921,T,TA,1
NC_037349.1,NC_032671.1,25407963,26058954,26058955,c,ca,1
NC_037349.1,NC_032671.1,25424468,26075460,26075461,G,GS,1
NC_037349.1,NC_032671.1,25448806,26099709,26099710,C,CA,1
NC_037349.1,NC_032671.1,25449769,26100674,26100675,t,ta,1
NC_037349.1,NC_032671.1,25556339,26207318,26207319,t,ta,1
NC_037349.1,NC_032671.1,25556369,26207349,26207351,c,cat,2
NC_037349.1,NC_032671.1,25772420,26422668,26422687,G,GACCCCNNNNNNNNNNNNNN,19
NC_037349.1,NC_032671.1,25772530,26422796,26422797,G,GK,1
NC_037349.1,NC_032671.1,26000068,26659252,26659257,T,TTAGAA,5
NC_037349.1,NC_032671.1,26010842,26670033,26670038,g,gactga,5
NC_037349.1,NC_032671.1,26037139,26698885,26698887,a,acg,2
NC_037349.1,NC_032671.1,26107412,26773590,26773591,t,tg,1
NC_037349.1,NC_032671.1,26158737,26824937,26824938,T,TA,1
NC_037349.1,NC_032671.1,26196345,26862550,26862551,A,AC,1
NC_037349.1,NC_032671.1,26211865,26878090,26878093,A,AATC,3
NC_037349.1,NC_032671.1,26255301,26921531,26921533,t,tgc,2
NC_037349.1,NC_032671.1,26265114,26931346,26931348,a,aat,2
NC_037349.1,NC_032671.1,26290240,26956476,26956477,t,tc,1
NC_037349.1,NC_032671.1,26295337,26971330,26971331,T,TC,1
NC_037349.1,NC_032671.1,26315963,26993409,26993418,g,gggaaacagt,9
NC_037349.1,NC_032671.1,26339341,27015447,27015448,A,AT,1
NC_037349.1,NC_032671.1,26371551,27047660,27047662,t,tNN,2
NC_037349.1,NC_032671.1,26397754,27073867,27073868,g,ga,1
NC_037349.1,NC_032671.1,26519839,27196216,27196218,A,AAC,2
NC_037349.1,NC_032671.1,26619709,27289257,27289260,a,aggt,3
NC_037349.1,NC_032671.1,26682366,27351823,27351824,C,CT,1
NC_037349.1,NC_032671.1,26686874,27356334,27356335,T,TY,1
NC_037349.1,NC_032671.1,26707342,27376808,27376809,T,TC,1
NC_037349.1,NC_032671.1,26710788,27380254,27380257,c,cgca,3
NC_037349.1,NC_032671.1,26712157,27381626,27381627,a,aW,1
NC_037349.1,NC_032671.1,26713079,27382550,27382553,C,CTGA,3
NC_037349.1,NC_032671.1,26722017,27391499,27391500,T,TK,1
NC_037349.1,NC_032671.1,26761383,27430611,27430612,t,ta,1
NC_037349.1,NC_032671.1,26809194,27478426,27478427,A,AR,1
NC_037349.1,NC_032671.1,26859976,27529216,27529217,c,ct,1
NC_037349.1,NC_032671.1,26893840,27563110,27563111,t,ta,1
NC_037349.1,NC_032671.1,26893855,27563126,27563127,t,ta,1
NC_037349.1,NC_032671.1,26903653,27572932,27572933,T,TG,1
NC_037349.1,NC_032671.1,27002774,27752074,27752080,g,ggctaac,6
NC_037349.1,NC_032671.1,27082018,27831336,27831341,t,ttttNN,5
NC_037349.1,NC_032671.1,27090371,27839694,27839696,c,ctt,2
NC_037349.1,NC_032671.1,27106594,27855906,27855907,g,ga,1
NC_037349.1,NC_032671.1,27107879,27857189,27857191,t,tga,2
NC_037349.1,NC_032671.1,27170579,27919897,27919898,a,at,1
NC_037349.1,NC_032671.1,27511843,28273410,28273411,T,TC,1
NC_037349.1,NC_032671.1,27511846,28273414,28273417,T,TTAC,3
NC_037349.1,NC_032671.1,27536778,28298342,28298344,a,att,2
NC_037349.1,NC_032671.1,27578959,28340525,28340526,C,CM,1
NC_037349.1,NC_032671.1,27626346,28387913,28387914,t,tg,1
NC_037349.1,NC_032671.1,27642943,28404510,28404511,t,tc,1
NC_037349.1,NC_032671.1,27722047,28483612,28483613,A,AM,1
NC_037349.1,NC_032671.1,27760137,28521734,28521736,c,cMa,2
NC_037349.1,NC_032671.1,27762761,28524360,28524361,t,tc,1
NC_037349.1,NC_032671.1,27764045,28525645,28525646,A,AS,1
NC_037349.1,NC_032671.1,27847307,28613288,28613289,C,CT,1
NC_037349.1,NC_032671.1,28384696,29119784,29119790,C,CAAAATA,6
NC_037349.1,NC_032671.1,28667821,29403340,29403341,T,TW,1
NC_037349.1,NC_032671.1,28735686,29470222,29470223,A,AR,1
NC_037349.1,NC_032671.1,28771467,29506071,29506076,a,aacatc,5
NC_037349.1,NC_032671.1,29079237,29796012,29796013,a,ac,1
NC_037349.1,NC_032671.1,29125537,29842315,29842317,C,CTA,2
NC_037349.1,NC_032671.1,29353125,30069264,30069266,c,cat,2
NC_037349.1,NC_032671.1,29433449,30149382,30149383,A,AR,1
NC_037349.1,NC_032671.1,29449575,30165510,30165512,c,cga,2
NC_037349.1,NC_032671.1,29585424,30297773,30297774,G,GC,1
NC_037349.1,NC_032671.1,29757813,30472173,30472174,A,AC,1
NC_037349.1,NC_032671.1,29833108,30547473,30547474,C,CY,1
NC_037349.1,NC_032671.1,29841964,30555524,30555529,C,CTAACT,5
NC_037349.1,NC_032671.1,29888339,30602300,30602301,G,GN,1
NC_037349.1,NC_032671.1,29951138,30664313,30664314,g,ga,1
NC_037349.1,NC_032671.1,29951191,30664367,30664368,A,AM,1
NC_037349.1,NC_032671.1,29999948,30713127,30713128,C,CT,1
NC_037349.1,NC_032671.1,30072925,30785927,30785928,a,at,1
NC_037349.1,NC_032671.1,30235700,30949385,30949386,t,tc,1
NC_037349.1,NC_032671.1,30236295,30949981,30949982,t,tc,1
NC_037349.1,NC_032671.1,30236638,30950325,30950326,t,tg,1
NC_037349.1,NC_032671.1,30373752,31092404,31092405,A,AT,1
NC_037349.1,NC_032671.1,30381542,31100195,31100196,t,tc,1
NC_037349.1,NC_032671.1,30452389,31170300,31170301,T,TC,1
NC_037349.1,NC_032671.1,30486068,31203986,31203994,a,aggagaagg,8
NC_037349.1,NC_032671.1,30532591,31250331,31250332,a,aN,1
NC_037349.1,NC_032671.1,30553084,31270829,31270830,T,TA,1
NC_037349.1,NC_032671.1,30944962,31663354,31663355,c,ca,1
NC_037349.1,NC_032671.1,31036540,31754770,31754771,A,AT,1
NC_037349.1,NC_032671.1,31129827,31848225,31848226,g,ga,1
NC_037349.1,NC_032671.1,31166931,31885336,31885337,a,ac,1
NC_037349.1,NC_032671.1,31599679,32335799,32335801,g,gaa,2
NC_037349.1,NC_032671.1,31724904,32461041,32461043,C,CCM,2
NC_037349.1,NC_032671.1,31961779,32699323,32699324,a,ac,1
NC_037349.1,NC_032671.1,31968797,32706422,32706423,A,AW,1
NC_037349.1,NC_032671.1,32129613,32868022,32868023,C,CA,1
NC_037349.1,NC_032671.1,32361105,33102127,33102128,g,ga,1
NC_037349.1,NC_032671.1,32472195,33213128,33213129,c,ca,1
NC_037349.1,NC_032671.1,32472465,33213399,33213409,a,acacacacccc,10
NC_037349.1,NC_032671.1,32835215,33623386,33623389,t,tttc,3
NC_037349.1,NC_032671.1,32835238,33623412,33623415,t,tata,3
NC_037349.1,NC_032671.1,32993389,33795627,33795629,C,CCG,2
NC_037349.1,NC_032671.1,32993627,33795867,33795868,t,tg,1
NC_037349.1,NC_032671.1,33115319,33916526,33916527,C,CS,1
NC_037349.1,NC_032671.1,33135893,33937102,33937103,a,ag,1
NC_037349.1,NC_032671.1,33165501,33966724,33966725,G,GS,1
NC_037349.1,NC_032671.1,33179049,33980274,33980276,a,aag,2
NC_037349.1,NC_032671.1,33211830,34012864,34012865,G,GA,1
NC_037349.1,NC_032671.1,33342233,34143275,34143276,A,AM,1
NC_037349.1,NC_032671.1,33388707,34189744,34189750,t,tacaaaa,6
NC_037349.1,NC_032671.1,33421840,34222881,34222882,C,CA,1
NC_037349.1,NC_032671.1,33427489,34228531,34228532,A,AT,1
NC_037349.1,NC_032671.1,33530888,34331540,34331541,c,ct,1
NC_037349.1,NC_032671.1,33641820,34442478,34442479,g,ga,1
NC_037349.1,NC_032671.1,33641838,34442497,34442498,c,ct,1
NC_037349.1,NC_032671.1,33641857,34442518,34442519,g,gc,1
NC_037349.1,NC_032671.1,33659478,34460140,34460144,t,tNNNN,4
NC_037349.1,NC_032671.1,33667459,34468125,34468126,T,TG,1
NC_037349.1,NC_032671.1,33711840,34512508,34512509,t,tg,1
NC_037349.1,NC_032671.1,33973348,34776039,34776042,t,tagc,3
NC_037349.1,NC_032671.1,34097439,34949451,34949453,C,CAA,2
NC_037349.1,NC_032671.1,34235772,35086430,35086431,t,ta,1
NC_037349.1,NC_032671.1,34357991,35208651,35208655,T,TCTAA,4
NC_037349.1,NC_032671.1,34378577,35229241,35229253,a,aagctggaATTCC,12
NC_037349.1,NC_032671.1,34378722,35229398,35229399,g,gc,1
NC_037349.1,NC_032671.1,34378837,35229514,35229515,c,ca,1
NC_037349.1,NC_032671.1,34403013,35253691,35253693,c,cta,2
NC_037349.1,NC_032671.1,34469901,35320584,35320585,t,tg,1
NC_037349.1,NC_032671.1,34470050,35320737,35320741,c,cctct,4
NC_037349.1,NC_032671.1,34470086,35320777,35320778,c,ct,1
NC_037349.1,NC_032671.1,34474879,35325571,35325575,C,CTAAG,4
NC_037349.1,NC_032671.1,34498331,35358125,35358126,T,TC,1
NC_037349.1,NC_032671.1,34672911,35385386,35385387,t,ta,1
NC_037349.1,NC_032671.1,34786258,35500107,35500108,c,ca,1
NC_037349.1,NC_032671.1,34834753,35548621,35548628,C,CTACTGAA,7
NC_037349.1,NC_032671.1,34996346,35746277,35746278,t,tc,1
NC_037349.1,NC_032671.1,35120889,35870790,35870792,C,CGG,2
NC_037349.1,NC_032671.1,35132983,35882888,35882889,c,ca,1
NC_037349.1,NC_032671.1,35132996,35882902,35882903,t,ta,1
NC_037349.1,NC_032671.1,35210498,36017110,36017112,A,AGG,2
NC_037349.1,NC_032671.1,35245886,36052501,36052504,C,CGTT,3
NC_037349.1,NC_032671.1,35295293,36101897,36101898,c,ca,1
NC_037349.1,NC_032671.1,35310299,36116930,36116932,C,CTT,2
NC_037349.1,NC_032671.1,35358123,36164825,36164827,a,aNN,2
NC_037349.1,NC_032671.1,35481684,36295017,36295019,T,TAG,2
NC_037349.1,NC_032671.1,35526080,36339424,36339425,T,TK,1
NC_037349.1,NC_032671.1,35622029,36432379,36432381,t,ttg,2
NC_037349.1,NC_032671.1,35632942,36443295,36443297,t,ttg,2
NC_037349.1,NC_032671.1,35654937,36465293,36465296,C,CATG,3
NC_037349.1,NC_032671.1,35718587,36529008,36529009,C,CT,1
NC_037349.1,NC_032671.1,35725854,36536274,36536275,g,ga,1
NC_037349.1,NC_032671.1,35745182,36555603,36555604,T,TY,1
NC_037349.1,NC_032671.1,36284328,37136189,37136190,T,TW,1
NC_037349.1,NC_032671.1,36333002,37184640,37184641,T,TA,1
NC_037349.1,NC_032671.1,36333024,37184663,37184664,C,CT,1
NC_037349.1,NC_032671.1,36383489,37238562,37238563,A,AY,1
NC_037349.1,NC_032671.1,36419168,37274248,37274249,A,AW,1
NC_037349.1,NC_032671.1,36553398,37420664,37420668,t,ttctg,4
NC_037349.1,NC_032671.1,36561214,37428484,37428486,a,aat,2
NC_037349.1,NC_032671.1,36561232,37428504,37428506,a,atg,2
NC_037349.1,NC_032671.1,36578869,37446147,37446149,a,aNN,2
NC_037349.1,NC_032671.1,36685219,37552526,37552527,C,CA,1
NC_037349.1,NC_032671.1,36865099,37730419,37730421,t,tNN,2
NC_037349.1,NC_032671.1,36914813,37780135,37780136,A,AM,1
NC_037349.1,NC_032671.1,37143166,38007728,38007729,T,TG,1
NC_037349.1,NC_032671.1,37259141,38124049,38124050,T,TA,1
NC_037349.1,NC_032671.1,37454492,38359282,38359283,t,tg,1
NC_037349.1,NC_032671.1,37475088,38379879,38379883,T,TCAAA,4
NC_037349.1,NC_032671.1,37483818,38388613,38388615,G,GTT,2
NC_037349.1,NC_032671.1,37546343,38451005,38451006,g,ga,1
NC_037349.1,NC_032671.1,37603476,38506299,38506300,T,TA,1
NC_037349.1,NC_032671.1,37751468,38655280,38655281,C,CT,1
NC_037349.1,NC_032671.1,37751474,38655287,38655288,C,CA,1
NC_037349.1,NC_032671.1,37751556,38655370,38655371,T,TY,1
NC_037349.1,NC_032671.1,37837243,38741066,38741072,A,AGAGAYG,6
NC_037349.1,NC_032671.1,37886376,38790207,38790208,t,tg,1
NC_037349.1,NC_032671.1,37998513,38902413,38902414,C,CA,1
NC_037349.1,NC_032671.1,38201187,39109913,39109914,G,GA,1
NC_037349.1,NC_032671.1,38455731,39366025,39366029,C,CTGTT,4
NC_037349.1,NC_032671.1,38485611,39395908,39395909,g,ga,1
NC_037349.1,NC_032671.1,38544368,39454667,39454668,G,GC,1
NC_037349.1,NC_032671.1,38589614,39499915,39499916,a,ag,1
NC_037349.1,NC_032671.1,38589637,39499939,39499940,t,tc,1
NC_037349.1,NC_032671.1,38652198,39562113,39562122,G,GCAGAAGTCT,9
NC_037349.1,NC_032671.1,38653863,39563785,39563790,T,TGCATK,5
NC_037349.1,NC_032671.1,38879338,39844063,39844064,C,CA,1
NC_037349.1,NC_032671.1,38908432,39873164,39873165,G,GT,1
NC_037349.1,NC_032671.1,38938915,39903657,39903658,t,tg,1
NC_037349.1,NC_032671.1,38948031,39912775,39912776,A,AC,1
NC_037349.1,NC_032671.1,38956814,39921558,39921560,C,CGT,2
NC_037349.1,NC_032671.1,38959933,39924717,39924718,c,cg,1
NC_037349.1,NC_032671.1,38972321,39937101,39937105,c,ccatt,4
NC_037349.1,NC_032671.1,38989873,39954674,39954675,A,AT,1
NC_037349.1,NC_032671.1,38997140,39961963,39961969,A,ACAAAAG,6
NC_037349.1,NC_032671.1,39006693,39971402,39971403,a,at,1
NC_037349.1,NC_032671.1,39008399,39973107,39973108,G,GR,1
NC_037349.1,NC_032671.1,39042028,40006011,40006012,C,CG,1
NC_037349.1,NC_032671.1,39045137,40009133,40009141,G,GAGGTTTTT,8
NC_037349.1,NC_032671.1,39076086,40040095,40040101,G,GGTTMAC,6
NC_037349.1,NC_032671.1,39078701,40042715,40042716,C,CT,1
NC_037349.1,NC_032671.1,39112069,40076085,40076086,a,at,1
NC_037349.1,NC_032671.1,39133570,40097587,40097590,G,GCTK,3
NC_037349.1,NC_032671.1,39142716,40106722,40106728,C,CACTTCA,6
NC_037349.1,NC_032671.1,39165634,40129653,40129655,G,GCK,2
NC_037349.1,NC_032671.1,39170773,40134791,40134805,t,tattgttttgtatta,14
NC_037349.1,NC_032671.1,39172083,40136115,40136116,G,GC,1
NC_037349.1,NC_032671.1,39197670,40161702,40161704,T,TTA,2
NC_037349.1,NC_032671.1,39205493,40169569,40169570,T,TW,1
NC_037349.1,NC_032671.1,39211007,40175085,40175087,T,TTG,2
NC_037349.1,NC_032671.1,39221989,40186071,40186072,a,at,1
NC_037349.1,NC_032671.1,39264311,40228407,40228409,T,TCW,2
NC_037349.1,NC_032671.1,39282700,40246794,40246795,T,TK,1
NC_037349.1,NC_032671.1,39286164,40250258,40250259,t,ta,1
NC_037349.1,NC_032671.1,39303359,40267457,40267458,A,AW,1
NC_037349.1,NC_032671.1,39304560,40268659,40268661,T,TAA,2
NC_037349.1,NC_032671.1,39304683,40268784,40268785,c,ca,1
NC_037349.1,NC_032671.1,39304699,40268801,40268802,c,ca,1
NC_037349.1,NC_032671.1,39306254,40270357,40270358,c,ca,1
NC_037349.1,NC_032671.1,39335363,40299461,40299462,c,ca,1
NC_037349.1,NC_032671.1,39341264,40305366,40305367,C,CA,1
NC_037349.1,NC_032671.1,39440710,40404850,40404851,t,tg,1
NC_037349.1,NC_032671.1,39440758,40404899,40404906,a,acacacac,7
NC_037349.1,NC_032671.1,39452113,40416261,40416263,a,aag,2
NC_037349.1,NC_032671.1,39463149,40427302,40427303,a,at,1
NC_037349.1,NC_032671.1,39532365,40496852,40496853,T,TA,1
NC_037349.1,NC_032671.1,39569911,40534303,40534304,C,CA,1
NC_037349.1,NC_032671.1,39570526,40534924,40534926,t,tta,2
NC_037349.1,NC_032671.1,39668517,40633036,40633037,C,CA,1
NC_037349.1,NC_032671.1,39677998,40642519,40642520,C,CM,1
NC_037349.1,NC_032671.1,39690020,40654542,40654545,a,aaaM,3
NC_037349.1,NC_032671.1,39795532,52361885,52361886,t,tg,1
NC_037349.1,NC_032671.1,39818391,52385944,52385945,t,ta,1
NC_037349.1,NC_032671.1,39926358,40817445,40817446,C,CA,1
NC_037349.1,NC_032671.1,39947471,40838554,40838555,a,ac,1
NC_037349.1,NC_032671.1,39954152,40845236,40845237,c,ca,1
NC_037349.1,NC_032671.1,39958785,40861617,40861620,C,CTGT,3
NC_037349.1,NC_032671.1,39979720,40882556,40882558,g,gga,2
NC_037349.1,NC_032671.1,40003912,40909829,40909835,A,ATTTATC,6
NC_037349.1,NC_032671.1,40023862,40929789,40929790,a,at,1
NC_037349.1,NC_032671.1,40036005,40941938,40941939,A,AG,1
NC_037349.1,NC_032671.1,40051540,40957487,40957488,T,TC,1
NC_037349.1,NC_032671.1,40052349,40958300,40958301,T,TY,1
NC_037349.1,NC_032671.1,40062343,40968295,40968302,t,tttttttc,7
NC_037349.1,NC_032671.1,40066615,40972548,40972553,g,gactga,5
NC_037349.1,NC_032671.1,40082855,40988363,40988367,c,ctgag,4
NC_037349.1,NC_032671.1,40089417,40994936,40994938,G,GTA,2
NC_037349.1,NC_032671.1,40098381,41003903,41003904,A,AC,1
NC_037349.1,NC_032671.1,40103175,41008691,41008692,a,at,1
NC_037349.1,NC_032671.1,40107483,41012999,41013000,C,CT,1
NC_037349.1,NC_032671.1,40118221,41023775,41023778,t,tata,3
NC_037349.1,NC_032671.1,40121297,41026851,41026852,T,TG,1
NC_037349.1,NC_032671.1,40128522,41034045,41034047,c,cag,2
NC_037349.1,NC_032671.1,40150308,41055392,41055393,T,TG,1
NC_037349.1,NC_032671.1,40153461,41058547,41058548,T,TC,1
NC_037349.1,NC_032671.1,40155889,41060975,41060989,g,ggtgtgtgtgtgtgt,14
NC_037349.1,NC_032671.1,40156159,41061259,41061263,G,GTGGA,4
NC_037349.1,NC_032671.1,40171294,41076436,41076437,T,TA,1
NC_037349.1,NC_032671.1,40174259,41078759,41078774,A,ATTTGAGTAAGGGATG,15
NC_037349.1,NC_032671.1,40183772,41088289,41088290,A,AT,1
NC_037349.1,NC_032671.1,40231768,41159287,41159289,G,GCT,2
NC_037349.1,NC_032671.1,40231866,41159387,41159391,g,gaaaa,4
NC_037349.1,NC_032671.1,40234009,41161546,41161549,T,TCTW,3
NC_037349.1,NC_032671.1,40243228,41170777,41170790,T,TTGTTCAATTGTTG,13
NC_037349.1,NC_032671.1,40245089,41172650,41172651,C,CR,1
NC_037349.1,NC_032671.1,40440832,41367970,41367974,a,aNNNN,4
NC_037349.1,NC_032671.1,40489573,41416019,41416020,T,TA,1
NC_037349.1,NC_032671.1,40510595,41437043,41437045,a,atg,2
NC_037349.1,NC_032671.1,40510618,41437068,41437069,a,at,1
NC_037349.1,NC_032671.1,40521220,41447668,41447670,a,att,2
NC_037349.1,NC_032671.1,40730619,41642079,41642080,g,gt,1
NC_037349.1,NC_032671.1,40763187,41674660,41674662,g,gaa,2
NC_037349.1,NC_032671.1,40769851,41681328,41681329,T,TC,1
NC_037349.1,NC_032671.1,40780797,41692292,41692293,t,ta,1
NC_037349.1,NC_032671.1,40784206,41695716,41695717,c,ct,1
NC_037349.1,NC_032671.1,40796851,41708366,41708369,T,TGAA,3
NC_037349.1,NC_032671.1,40797979,41709497,41709499,A,AAG,2
NC_037349.1,NC_032671.1,40798134,41709654,41709655,T,TC,1
NC_037349.1,NC_032671.1,40805413,41716933,41716944,T,TGTTGTTCCTCA,11
NC_037349.1,NC_032671.1,40832119,41743647,41743648,C,CM,1
NC_037349.1,NC_032671.1,40832447,41743976,41743978,g,ggt,2
NC_037349.1,NC_032671.1,40833531,41745062,41745066,C,CAGAG,4
NC_037349.1,NC_032671.1,40834963,41746500,41746501,c,ct,1
NC_037349.1,NC_032671.1,40868967,41801454,41801455,a,ag,1
NC_037349.1,NC_032671.1,40873323,41805811,41805818,g,gcgcgcgc,7
NC_037349.1,NC_032671.1,40873329,41805824,41805830,c,cgtgcgt,6
NC_037349.1,NC_032671.1,40893664,41826147,41826149,g,gRa,2
NC_037349.1,NC_032671.1,40899313,41831811,41831814,a,acac,3
NC_037349.1,NC_032671.1,40899334,41831835,41831836,t,ta,1
NC_037349.1,NC_032671.1,40906468,41838970,41838972,T,TGA,2
NC_037349.1,NC_032671.1,40915753,41849033,41849034,c,ca,1
NC_037349.1,NC_032671.1,40916165,41849446,41849449,t,tttc,3
NC_037349.1,NC_032671.1,40916703,41849987,41849988,G,GC,1
NC_037349.1,NC_032671.1,40919953,41853244,41853246,t,tNN,2
NC_037349.1,NC_032671.1,40979894,41913203,41913204,G,GR,1
NC_037349.1,NC_032671.1,41020449,41953772,41953773,g,ga,1
NC_037349.1,NC_032671.1,41032173,41965501,41965502,A,AG,1
NC_037349.1,NC_032671.1,41037633,41970959,41970960,c,ct,1
NC_037349.1,NC_032671.1,41038396,41971724,41971726,a,aag,2
NC_037349.1,NC_032671.1,41046028,41979359,41979360,T,TG,1
NC_037349.1,NC_032671.1,41047953,41981285,41981286,G,GY,1
NC_037349.1,NC_032671.1,41057562,41990894,41990895,C,CA,1
NC_037349.1,NC_032671.1,41059117,41992451,41992452,a,at,1
NC_037349.1,NC_032671.1,41059252,41992587,41992588,g,ga,1
NC_037349.1,NC_032671.1,41059262,41992598,41992601,t,tttc,3
NC_037349.1,NC_032671.1,41060431,41993771,41993773,A,AGT,2
NC_037349.1,NC_032671.1,41060510,41993852,41993853,T,TC,1
NC_037349.1,NC_032671.1,41060512,41993855,41993856,G,GT,1
NC_037349.1,NC_032671.1,41062896,41996240,41996241,A,AG,1
NC_037349.1,NC_032671.1,41351337,42284720,42284721,a,aY,1
NC_037349.1,NC_032671.1,41429233,42362615,42362619,T,TGTAA,4
NC_037349.1,NC_032671.1,41432880,42366267,42366268,C,CG,1
NC_037349.1,NC_032671.1,41435304,42368692,42368701,a,aaaaaaaaat,9
NC_037349.1,NC_032671.1,41440558,42373953,42373954,t,ta,1
NC_037349.1,NC_032671.1,41445114,42378508,42378512,C,CAGAA,4
NC_037349.1,NC_032671.1,41446348,42379739,42379750,A,AAAGGCGGGGAG,11
NC_037349.1,NC_032671.1,41447504,42380906,42380907,A,AC,1
NC_037349.1,NC_032671.1,41455381,42388788,42388789,C,CY,1
NC_037349.1,NC_032671.1,41469101,42402275,42402276,g,gt,1
NC_037349.1,NC_032671.1,41490262,42423441,42423442,T,TC,1
NC_037349.1,NC_032671.1,41536631,42467573,42467591,G,GTGAAATACCCCCCAGGCA,18
NC_037349.1,NC_032671.1,41536639,42467599,42467600,A,AR,1
NC_037349.1,NC_032671.1,41550039,42481000,42481003,A,AAGT,3
NC_037349.1,NC_032671.1,41573745,42505122,42505123,C,CS,1
NC_037349.1,NC_032671.1,41575687,42507065,42507067,a,att,2
NC_037349.1,NC_032671.1,41591447,42522832,42522833,t,tg,1
NC_037349.1,NC_032671.1,41598805,42530198,42530202,A,ACTCT,4
NC_037349.1,NC_032671.1,41598837,42530234,42530235,G,GA,1
NC_037349.1,NC_032671.1,41615613,42547016,42547017,A,AC,1
NC_037349.1,NC_032671.1,41657106,42588566,42588567,C,CM,1
NC_037349.1,NC_032671.1,41686001,42617332,42617333,c,ca,1
NC_037349.1,NC_032671.1,41688699,42620031,42620032,t,tg,1
NC_037349.1,NC_032671.1,41694595,42625928,42625929,C,CT,1
NC_037349.1,NC_032671.1,41709728,42641059,42641063,T,TTGTC,4
NC_037349.1,NC_032671.1,41750265,42681603,42681604,T,TR,1
NC_037349.1,NC_032671.1,41862412,42793763,42793764,G,GA,1
NC_037349.1,NC_032671.1,41884366,42815717,42815718,C,CG,1
NC_037349.1,NC_032671.1,41889170,42820523,42820524,c,cT,1
NC_037349.1,NC_032671.1,41902891,42834112,42834113,A,AR,1
NC_037349.1,NC_032671.1,41903750,42834972,42834973,A,AC,1
NC_037349.1,NC_032671.1,42099834,43083593,43083594,a,aW,1
NC_037349.1,NC_032671.1,42506300,43401425,43401427,t,tNN,2
NC_037349.1,NC_032671.1,42654882,43550001,43550002,g,gc,1
NC_037349.1,NC_032671.1,42738311,43633437,43633438,T,TA,1
NC_037349.1,NC_032671.1,42744127,43639265,43639269,c,ctgtg,4
NC_037349.1,NC_032671.1,42773348,43668491,43668500,G,GCCCAAGGTC,9
NC_037349.1,NC_032671.1,42857672,43752789,43752790,C,CY,1
NC_037349.1,NC_032671.1,42858064,43753182,43753218,T,TCACRTTACGGTTTCTAAAGTAACCTTCCTACTGCTC,36
NC_037349.1,NC_032671.1,42961416,43856181,43856182,g,gt,1
NC_037349.1,NC_032671.1,43010973,43905755,43905767,A,AGCTGCTGTTCAG,12
NC_037349.1,NC_032671.1,43032209,43927017,43927018,G,GT,1
NC_037349.1,NC_032671.1,43033609,43928427,43928428,C,CG,1
NC_037349.1,NC_032671.1,43102040,43996861,43996865,C,CATGA,4
NC_037349.1,NC_032671.1,43139574,44034404,44034405,G,GC,1
NC_037349.1,NC_032671.1,43144917,44039750,44039752,a,aat,2
NC_037349.1,NC_032671.1,43229167,44124001,44124003,C,CAT,2
NC_037349.1,NC_032671.1,43246568,44144035,44144036,a,at,1
NC_037349.1,NC_032671.1,43273298,44170638,44170639,C,CY,1
NC_037349.1,NC_032671.1,43286563,44184077,44184078,G,GA,1
NC_037349.1,NC_032671.1,43294761,44192277,44192279,G,GCT,2
NC_037349.1,NC_032671.1,43343577,44241117,44241118,C,CT,1
NC_037349.1,NC_032671.1,43362192,44260423,44260424,t,tc,1
NC_037349.1,NC_032671.1,43493522,44386422,44386423,a,aM,1
NC_037349.1,NC_032671.1,43610061,44489560,44489561,A,AT,1
NC_037349.1,NC_032671.1,43617521,44497020,44497021,G,GA,1
NC_037349.1,NC_032671.1,43641858,44521367,44521371,T,TAGAA,4
NC_037349.1,NC_032671.1,43695597,44575111,44575121,t,tatatatNNNN,10
NC_037349.1,NC_032671.1,43715675,44595197,44595198,C,CG,1
NC_037349.1,NC_032671.1,43716420,44595943,44595961,T,TACAGTTTTAACAAAAGGG,18
NC_037349.1,NC_032671.1,43758838,44638484,44638485,C,CA,1
NC_037349.1,NC_032671.1,43758973,44638621,44638622,A,AG,1
NC_037349.1,NC_032671.1,43761885,44641534,44641535,a,at,1
NC_037349.1,NC_032671.1,43775803,44655455,44655456,T,TC,1
NC_037349.1,NC_032671.1,43783522,44663367,44663368,t,ta,1
NC_037349.1,NC_032671.1,43795874,44675678,44675680,C,CTG,2
NC_037349.1,NC_032671.1,43799758,44679565,44679566,G,GT,1
NC_037349.1,NC_032671.1,43848068,44727747,44727752,T,TTAAAC,5
NC_037349.1,NC_032671.1,43888324,44767830,44767831,a,at,1
NC_037349.1,NC_032671.1,43993675,44932685,44932686,T,TA,1
NC_037349.1,NC_032671.1,44003265,44942280,44942281,T,TW,1
NC_037349.1,NC_032671.1,44020511,44960749,44960750,A,AC,1
NC_037349.1,NC_032671.1,44025672,44965903,44965904,A,AW,1
NC_037349.1,NC_032671.1,44028318,44968551,44968552,g,gK,1
NC_037349.1,NC_032671.1,44029322,44969556,44969557,G,GC,1
NC_037349.1,NC_032671.1,44042808,44982352,44982354,c,caa,2
NC_037349.1,NC_032671.1,44048201,44987747,44987748,c,ct,1
NC_037349.1,NC_032671.1,44102117,45042615,45042617,C,CAG,2
NC_037349.1,NC_032671.1,44115118,45055630,45055631,C,CR,1
NC_037349.1,NC_032671.1,44127877,45068391,45068392,C,CS,1
NC_037349.1,NC_032671.1,44128390,45068903,45068905,t,tNN,2
NC_037349.1,NC_032671.1,44133183,45073696,45073697,T,TY,1
NC_037349.1,NC_032671.1,44134631,45075152,45075153,a,at,1
NC_037349.1,NC_032671.1,44140216,45080746,45080747,T,TK,1
NC_037349.1,NC_032671.1,44212695,45153017,45153018,a,aR,1
NC_037349.1,NC_032671.1,44221870,45162196,45162197,G,GR,1
NC_037349.1,NC_032671.1,44222836,45163163,45163165,T,TAC,2
NC_037349.1,NC_032671.1,44241899,45182226,45182227,T,TC,1
NC_037349.1,NC_032671.1,44244973,45185302,45185303,A,AW,1
NC_037349.1,NC_032671.1,44245825,45186157,45186158,t,tW,1
NC_037349.1,NC_032671.1,44289658,45230449,45230450,g,gt,1
NC_037349.1,NC_032671.1,44319551,45261210,45261211,a,aN,1
NC_037349.1,NC_032671.1,44320092,45261752,45261753,C,CA,1
NC_037349.1,NC_032671.1,44323333,45264878,45264879,t,ta,1
NC_037349.1,NC_032671.1,44342497,45284031,45284032,G,GK,1
NC_037349.1,NC_032671.1,44374736,45316277,45316278,t,tg,1
NC_037349.1,NC_032671.1,44409198,45350768,45350771,C,CAAT,3
NC_037349.1,NC_032671.1,44434334,45376055,45376056,T,TA,1
NC_037349.1,NC_032671.1,44435372,45460637,45460638,A,AT,1
NC_037349.1,NC_032671.1,44436072,45461339,45461340,c,ct,1
NC_037349.1,NC_032671.1,44538811,45499839,45499840,G,GA,1
NC_037349.1,NC_032671.1,44736361,45784165,45784169,t,ttctc,4
NC_037349.1,NC_032671.1,44822587,45870517,45870521,a,aNNNN,4
NC_037349.1,NC_032671.1,44831195,45879390,45879391,t,tY,1
NC_037349.1,NC_032671.1,44833204,45881400,45881402,T,TCC,2
NC_037349.1,NC_032671.1,44912591,45961428,45961433,A,AGAAAW,5
NC_037349.1,NC_032671.1,44915406,45964248,45964250,T,TTC,2
NC_037349.1,NC_032671.1,44924853,45973700,45973702,c,cct,2
NC_037349.1,NC_032671.1,44924944,45973793,45973794,g,ga,1
NC_037349.1,NC_032671.1,44981366,46029363,46029365,G,GGA,2
NC_037349.1,NC_032671.1,44992397,46040396,46040397,t,ta,1
NC_037349.1,NC_032671.1,45034991,46082961,46082962,T,TK,1
NC_037349.1,NC_032671.1,45050302,46098273,46098274,t,ta,1
NC_037349.1,NC_032671.1,45050306,46098278,46098279,a,at,1
NC_037349.1,NC_032671.1,45112166,46160101,46160102,T,TC,1
NC_037349.1,NC_032671.1,45127600,46175527,46175528,G,GR,1
NC_037349.1,NC_032671.1,45229621,46277444,46277445,T,TA,1
NC_037349.1,NC_032671.1,45238848,46286671,46286672,a,ac,1
NC_037349.1,NC_032671.1,45326849,46375474,46375475,G,GA,1
NC_037349.1,NC_032671.1,45326857,46375483,46375484,T,TA,1
NC_037349.1,NC_032671.1,45346068,46394703,46394704,T,TG,1
NC_037349.1,NC_032671.1,45362379,46411024,46411038,G,GTGAGACATAAAGGT,14
NC_037349.1,NC_032671.1,45389056,46437718,46437719,a,aR,1
NC_037349.1,NC_032671.1,45547511,46626749,46626751,g,gta,2
NC_037349.1,NC_032671.1,45549131,46628372,46628373,A,AT,1
NC_037349.1,NC_032671.1,45551368,46630610,46630611,T,TC,1
NC_037349.1,NC_032671.1,45552581,46631827,46631828,T,TY,1
NC_037349.1,NC_032671.1,45576131,46655378,46655379,a,ag,1
NC_037349.1,NC_032671.1,45637082,46716336,46716337,G,GS,1
NC_037349.1,NC_032671.1,45718457,46798196,46798202,t,tgaaaag,6
NC_037349.1,NC_032671.1,45718648,46798393,46798394,T,TA,1
NC_037349.1,NC_032671.1,45775589,46855193,46855194,T,TG,1
NC_037349.1,NC_032671.1,45801616,46881205,46881206,G,GA,1
NC_037349.1,NC_032671.1,45836434,46916282,46916295,T,TCCAAAGCTTTCCA,13
NC_037349.1,NC_032671.1,45882309,46961745,46961746,a,at,1
NC_037349.1,NC_032671.1,45882440,46961877,46961878,C,CY,1
NC_037349.1,NC_032671.1,46176983,47255201,47255202,t,ta,1
NC_037349.1,NC_032671.1,46198395,47276619,47276620,G,GC,1
NC_037349.1,NC_032671.1,46367723,47552048,47552057,G,GTATGCCGCA,9
NC_037349.1,NC_032671.1,46384819,47569144,47569145,t,tc,1
NC_037349.1,NC_032671.1,46522917,47610468,47610471,a,aagg,3
NC_037349.1,NC_032671.1,46551139,47638697,47638702,t,ttttta,5
NC_037349.1,NC_032671.1,46551645,47639208,47639209,T,TW,1
NC_037349.1,NC_032671.1,46571113,47658677,47658686,a,aagtcacttc,9
NC_037349.1,NC_032671.1,46659538,47747119,47747120,t,tg,1
NC_037349.1,NC_032671.1,46720484,47808074,47808076,T,TTA,2
NC_037349.1,NC_032671.1,46731663,47819254,47819255,C,CT,1
NC_037349.1,NC_032671.1,46752535,47840131,47840132,a,ag,1
NC_037349.1,NC_032671.1,46775238,47862649,47862650,a,ag,1
NC_037349.1,NC_032671.1,46776332,47863745,47863746,g,ga,1
NC_037349.1,NC_032671.1,46813089,47900501,47900502,C,CA,1
NC_037349.1,NC_032671.1,46890390,47978602,47978604,a,aNN,2
NC_037349.1,NC_032671.1,46913656,48001869,48001870,T,TY,1
NC_037349.1,NC_032671.1,46968847,48057130,48057131,G,GC,1
NC_037349.1,NC_032671.1,47066441,48153981,48153982,G,GC,1
NC_037349.1,NC_032671.1,47091073,48178616,48178617,a,at,1
NC_037349.1,NC_032671.1,47094102,48181646,48181647,c,ct,1
NC_037349.1,NC_032671.1,47113442,48200986,48200987,a,at,1
NC_037349.1,NC_032671.1,47113508,48201053,48201057,A,ACTGT,4
NC_037349.1,NC_032671.1,47114369,48201918,48201919,t,tc,1
NC_037349.1,NC_032671.1,47119788,48207338,48207339,t,tY,1
NC_037349.1,NC_032671.1,47119794,48207345,48207346,t,tc,1
NC_037349.1,NC_032671.1,47159027,48246865,48246866,G,GA,1
NC_037349.1,NC_032671.1,47162348,48250187,48250191,A,ACAGT,4
NC_037349.1,NC_032671.1,47378777,48466371,48466372,G,GR,1
NC_037349.1,NC_032671.1,47381090,48468684,48468685,t,tg,1
NC_037349.1,NC_032671.1,47398444,48486039,48486042,g,gaaa,3
NC_037349.1,NC_032671.1,47398718,48486317,48486318,T,TG,1
NC_037349.1,NC_032671.1,47405219,48492667,48492668,g,ga,1
NC_037349.1,NC_032671.1,47430932,48518723,48518729,g,gcagcaa,6
NC_037349.1,NC_032671.1,47468194,48555975,48555977,A,AAC,2
NC_037349.1,NC_032671.1,47473320,48561095,48561100,C,CCTCTT,5
NC_037349.1,NC_032671.1,47494938,48582720,48582721,A,AR,1
NC_037349.1,NC_032671.1,47559306,48647032,48647033,G,GS,1
NC_037349.1,NC_032671.1,47576780,48664507,48664508,C,CR,1
NC_037349.1,NC_032671.1,47590036,48677767,48677770,A,Actt,3
NC_037349.1,NC_032671.1,47597711,48686037,48686038,T,TG,1
NC_037349.1,NC_032671.1,47639076,48727068,48727069,c,ca,1
NC_037349.1,NC_032671.1,47639080,48727073,48727075,c,cct,2
NC_037349.1,NC_032671.1,47639084,48727079,48727081,c,cct,2
NC_037349.1,NC_032671.1,47642447,48730448,48730449,a,at,1
NC_037349.1,NC_032671.1,47648565,48736004,48736005,t,tc,1
NC_037349.1,NC_032671.1,47649905,48737347,48737349,t,tta,2
NC_037349.1,NC_032671.1,47702913,48794908,48794909,T,TC,1
NC_037349.1,NC_032671.1,47735762,48827758,48827760,t,ttg,2
NC_037349.1,NC_032671.1,47758190,48850189,48850190,c,ca,1
NC_037349.1,NC_032671.1,47758195,48850195,48850199,t,tccca,4
NC_037349.1,NC_032671.1,47758202,48850206,48850209,c,ccca,3
NC_037349.1,NC_032671.1,47774561,48866575,48866576,G,GA,1
NC_037349.1,NC_032671.1,47823505,48915167,48915168,t,tc,1
NC_037349.1,NC_032671.1,47826374,48918037,48918039,G,GCT,2
NC_037349.1,NC_032671.1,47832193,48923858,48923871,c,cttttcactttcat,13
NC_037349.1,NC_032671.1,47860721,48952402,48952406,T,TCTAC,4
NC_037349.1,NC_032671.1,47870061,48961746,48961747,A,AG,1
NC_037349.1,NC_032671.1,48020921,49111875,49111879,t,tctaa,4
NC_037349.1,NC_032671.1,48028515,49119484,49119485,A,AC,1
NC_037349.1,NC_032671.1,48030814,49121784,49121785,A,AT,1
NC_037349.1,NC_032671.1,48030881,49121852,49121854,C,CTA,2
NC_037349.1,NC_032671.1,48051489,49142519,49142520,G,GK,1
NC_037349.1,NC_032671.1,48118725,49209754,49209755,c,ca,1
NC_037349.1,NC_032671.1,48165832,49256655,49256656,A,AM,1
NC_037349.1,NC_032671.1,48176593,49267417,49267419,G,GTC,2
NC_037349.1,NC_032671.1,48176628,49267454,49267455,c,ca,1
NC_037349.1,NC_032671.1,48249469,49340304,49340305,t,tg,1
NC_037349.1,NC_032671.1,48254766,49345602,49345603,T,TC,1
NC_037349.1,NC_032671.1,48381276,49555947,49555948,t,tg,1
NC_037349.1,NC_032671.1,48585203,49625304,49625309,g,gcgggt,5
NC_037349.1,NC_032671.1,48608647,49648731,49648734,g,ggat,3
NC_037349.1,NC_032671.1,48618166,49658146,49658152,t,tcagtgg,6
NC_037349.1,NC_032671.1,48618169,49658155,49658158,a,aaat,3
NC_037349.1,NC_032671.1,48629504,49669493,49669498,c,ccaccg,5
NC_037349.1,NC_032671.1,48646426,49686427,49686431,t,tNNNN,4
NC_037349.1,NC_032671.1,48686304,49726484,49726485,A,AY,1
NC_037349.1,NC_032671.1,48720503,49760699,49760700,T,TC,1
NC_037349.1,NC_032671.1,48722919,49763116,49763118,g,gaa,2
NC_037349.1,NC_032671.1,48804043,49844662,49844663,G,GA,1
NC_037349.1,NC_032671.1,48848020,49890830,49890831,A,AG,1
NC_037349.1,NC_032671.1,48863348,49906159,49906160,T,TA,1
NC_037349.1,NC_032671.1,48876187,49919007,49919011,a,aNNNN,4
NC_037349.1,NC_032671.1,48914182,49948676,49948707,T,TTTACGCAGCGCTGGGTTACCACTCTCTGCTA,31
NC_037349.1,NC_032671.1,48939276,49973786,49973789,G,GGTC,3
NC_037349.1,NC_032671.1,48964465,49998986,49998987,G,GS,1
NC_037349.1,NC_032671.1,49179243,50214630,50214631,G,GK,1
NC_037349.1,NC_032671.1,49632547,50582680,50582681,T,TC,1
NC_037349.1,NC_032671.1,49746131,50696640,50696648,a,aaaggggac,8
NC_037349.1,NC_032671.1,49790788,50741230,50741231,G,GK,1
NC_037349.1,NC_032671.1,49843796,50794105,50794106,G,GK,1
NC_037349.1,NC_032671.1,49843850,50794161,50794162,C,CG,1
NC_037349.1,NC_032671.1,49859880,50809944,50809946,G,GTR,2
NC_037349.1,NC_032671.1,49970571,50920697,50920724,C,CNNNNNNNNNNNNNNNNNNNNNNNNNNN,27
NC_037349.1,NC_032671.1,49973962,50924115,50924116,G,GC,1
NC_037349.1,NC_032671.1,50048780,50999285,50999290,a,atattt,5
NC_037349.1,NC_032671.1,50151432,51101995,51101996,a,ac,1
NC_037349.1,NC_032671.1,50160124,51110768,51110769,G,GS,1
NC_037349.1,NC_032671.1,50177531,51128176,51128179,T,TCAA,3
NC_037349.1,NC_032671.1,50213782,51164348,51164349,C,CA,1
NC_037349.1,NC_032671.1,50220606,51171173,51171174,T,TK,1
NC_037349.1,NC_032671.1,50531518,51482095,51482096,c,ct,1
NC_037349.1,NC_032671.1,50548367,51497769,51497771,C,CCS,2
NC_037349.1,NC_032671.1,50569717,51519121,51519124,A,AATC,3
NC_037349.1,NC_032671.1,50623119,51572497,51572498,C,CM,1
NC_037349.1,NC_032671.1,50656365,51605356,51605358,t,taa,2
NC_037349.1,NC_032671.1,50665227,51613913,51613914,C,CS,1
NC_037349.1,NC_032671.1,50673487,51622614,51622615,t,tc,1
NC_037349.1,NC_032671.1,50681351,51658508,51658512,g,gaagt,4
NC_037349.1,NC_032671.1,50682418,51659578,51659580,C,CAG,2
NC_037349.1,NC_032671.1,50751088,51727368,51727369,t,tN,1
NC_037349.1,NC_032671.1,50812668,51788954,51788955,c,ca,1
NC_037349.1,NC_032671.1,50849946,51826236,51826237,G,GT,1
NC_037349.1,NC_032671.1,50850513,51826804,51826805,C,CS,1
NC_037349.1,NC_032671.1,50863521,51839814,51839815,G,GS,1
NC_037349.1,NC_032671.1,50892490,51868703,51868704,C,CM,1
NC_037349.1,NC_032671.1,50897932,51874145,51874146,A,AC,1
NC_037349.1,NC_032671.1,50911027,51887241,51887242,c,ct,1
NC_037349.1,NC_032671.1,50978735,51954887,51954888,G,GA,1
NC_037349.1,NC_032671.1,51005172,51975844,51975845,A,AR,1
NC_037349.1,NC_032671.1,51029921,52004138,52004139,t,tc,1
NC_037349.1,NC_032671.1,51041464,52015689,52015690,a,ac,1
NC_037349.1,NC_032671.1,51065327,52039554,52039555,a,at,1
NC_037349.1,NC_032671.1,51116607,52090301,52090302,a,at,1
NC_037349.1,NC_032671.1,51139153,52112850,52112851,a,aN,1
NC_037349.1,NC_032671.1,51198323,52251332,52251335,A,ACTG,3
NC_037349.1,NC_032671.1,51216128,52269141,52269144,A,AGTT,3
NC_037349.1,NC_032671.1,51220705,52273719,52273720,G,GS,1
NC_037349.1,NC_032671.1,51236796,52289809,52289810,G,GA,1
NC_037349.1,NC_032671.1,51336309,52583565,52583568,C,CAGG,3
NC_037349.1,NC_032671.1,51344720,52591980,52591986,g,gcgcgcc,6
NC_037349.1,NC_032671.1,51603449,52874755,52874758,A,AAGG,3
NC_037349.1,NC_032671.1,51603727,52875036,52875037,T,TC,1
NC_037349.1,NC_032671.1,51614162,52885475,52885476,t,tg,1
NC_037349.1,NC_032671.1,51653692,52928565,52928566,C,CM,1
NC_037349.1,NC_032671.1,51654333,52932464,52932465,C,CA,1
NC_037349.1,NC_032671.1,51695742,52974413,52974415,A,AGT,2
NC_037349.1,NC_032671.1,51718296,52996974,52996975,t,tg,1
NC_037349.1,NC_032671.1,51718339,52997019,52997020,c,cg,1
NC_037349.1,NC_032671.1,51907664,53187019,53187020,G,GC,1
NC_037349.1,NC_032671.1,51971731,53251761,53251762,t,tc,1
NC_037349.1,NC_032671.1,52039430,53317133,53317135,G,GGA,2
NC_037349.1,NC_032671.1,52122726,53410749,53410750,t,ta,1
NC_037349.1,NC_032671.1,52288738,53544884,53544885,c,ca,1
NC_037349.1,NC_032671.1,52293628,53539993,53539994,t,ta,1
NC_037349.1,NC_032671.1,52348328,53688884,53688885,g,ga,1
NC_037349.1,NC_032671.1,52443437,53825303,53825311,t,tctatttcc,8
NC_037349.1,NC_032671.1,52478012,53860782,53860788,g,gCAGTGT,6
NC_037349.1,NC_032671.1,52509844,53892437,53892438,C,CG,1
NC_037349.1,NC_032671.1,52552717,53935300,53935301,A,AG,1
NC_037349.1,NC_032671.1,52587060,53969653,53969654,a,at,1
NC_037349.1,NC_032671.1,52655133,54037370,54037380,t,tcacacacaca,10
NC_037349.1,NC_032671.1,52721926,54104171,54104172,C,CT,1
NC_037349.1,NC_032671.1,52741447,54123692,54123693,T,TA,1
NC_037349.1,NC_032671.1,52779709,54161981,54161982,G,GC,1
NC_037349.1,NC_032671.1,52809783,54192132,54192133,T,TY,1
NC_037349.1,NC_032671.1,52867920,54258335,54258336,C,CY,1
NC_037349.1,NC_032671.1,52872726,54263163,54263164,A,AN,1
NC_037349.1,NC_032671.1,52874051,54264967,54264968,A,AR,1
NC_037349.1,NC_032671.1,52941885,54346853,54346854,A,AR,1
NC_037349.1,NC_032671.1,52943028,54347998,54347999,a,at,1
NC_037349.1,NC_032671.1,52952853,54357845,54357846,T,TG,1
NC_037349.1,NC_032671.1,52965044,54370039,54370048,a,acactgtttc,9
NC_037349.1,NC_032671.1,53150398,54555408,54555409,T,TK,1
NC_037349.1,NC_032671.1,53252447,54657478,54657481,a,agtc,3
NC_037349.1,NC_032671.1,53296765,54701809,54701810,t,tg,1
NC_037349.1,NC_032671.1,53351721,54756754,54756756,a,agt,2
NC_037349.1,NC_032671.1,53388414,54794950,54794953,C,CTCG,3
NC_037349.1,NC_032671.1,53405107,54811647,54811649,A,ATC,2
NC_037349.1,NC_032671.1,53413669,54820199,54820204,T,TTTATC,5
NC_037349.1,NC_032671.1,53471845,54878423,54878424,c,cg,1
NC_037349.1,NC_032671.1,53507087,54913364,54913366,t,ttg,2
NC_037349.1,NC_032671.1,53513514,54919794,54919799,A,ACTGGW,5
NC_037349.1,NC_032671.1,53526182,54932470,54932471,C,CT,1
NC_037349.1,NC_032671.1,53530563,54936852,54936853,g,ga,1
NC_037349.1,NC_032671.1,53544258,54950552,54950556,c,ctgtt,4
NC_037349.1,NC_032671.1,53544483,54950781,54950782,c,ct,1
NC_037349.1,NC_032671.1,53544519,54950818,54950820,a,att,2
NC_037349.1,NC_032671.1,53766384,55198980,55198982,C,CCG,2
NC_037349.1,NC_032671.1,53790670,55223277,55223278,G,GR,1
NC_037349.1,NC_032671.1,53812571,55246482,55246483,A,AW,1
NC_037349.1,NC_032671.1,53837172,55273263,55273264,G,GC,1
NC_037349.1,NC_032671.1,53843768,55279860,55279861,a,at,1
NC_037349.1,NC_032671.1,53844472,55280565,55280566,C,CS,1
NC_037349.1,NC_032671.1,53908733,55344822,55344824,a,aag,2
NC_037349.1,NC_032671.1,53950596,55386714,55386715,t,tW,1
NC_037349.1,NC_032671.1,53954167,55390286,55390287,A,AC,1
NC_037349.1,NC_032671.1,54023773,55459853,55459854,G,GY,1
NC_037349.1,NC_032671.1,54069544,55505639,55505640,C,CA,1
NC_037349.1,NC_032671.1,54078423,55514519,55514520,T,TS,1
NC_037349.1,NC_032671.1,54111880,55547982,55547987,T,TACTGC,5
NC_037349.1,NC_032671.1,54179623,55615327,55615328,A,AR,1
NC_037349.1,NC_032671.1,54218987,55654462,55654463,C,CY,1
NC_037349.1,NC_032671.1,54261402,55696865,55696898,C,CCCTCCTCGCCCTCNNNNNNNNNNNNNNNNNNNN,33
NC_037349.1,NC_032671.1,54267904,55703400,55703401,T,TN,1
NC_037349.1,NC_032671.1,54340872,55776371,55776374,g,gatc,3
NC_037349.1,NC_032671.1,54342506,55778008,55778012,t,taaca,4
NC_037349.1,NC_032671.1,54351280,55786780,55786781,C,CA,1
NC_037349.1,NC_032671.1,54459945,55895323,55895324,T,TC,1
NC_037349.1,NC_032671.1,54475652,55911032,55911057,T,TCCCATTCCTCAGGGCCCAGCAGAAA,25
NC_037349.1,NC_032671.1,54478602,55914005,55914010,C,CTCTGG,5
NC_037349.1,NC_032671.1,54480037,55915425,55915426,G,GC,1
NC_037349.1,NC_032671.1,54481848,55917237,55917249,A,ACGACCTGCTGAG,12
NC_037349.1,NC_032671.1,54482892,55918292,55918306,A,ACCTCCTCTGGGAMG,14
NC_037349.1,NC_032671.1,54515861,55951191,55951192,C,CY,1
NC_037349.1,NC_032671.1,54516081,55951412,55951418,A,ACATCCY,6
NC_037349.1,NC_032671.1,54525117,55960451,55960459,G,GAAAGCCCA,8
NC_037349.1,NC_032671.1,54534159,55969501,55969502,T,TA,1
NC_037349.1,NC_032671.1,54548884,55984231,55984232,c,cg,1
NC_037349.1,NC_032671.1,54605674,56079404,56079405,C,CY,1
NC_037349.1,NC_032671.1,54639374,56113503,56113514,T,TCACAGCTTAAA,11
NC_037349.1,NC_032671.1,54687683,56162068,56162073,c,ctccag,5
NC_037349.1,NC_032671.1,55079888,56546001,56546002,T,TC,1
NC_037349.1,NC_032671.1,55084348,56550459,56550460,G,GC,1
NC_037349.1,NC_032671.1,55084960,56551072,56551073,g,ga,1
NC_037349.1,NC_032671.1,55097004,56563119,56563120,A,AG,1
NC_037349.1,NC_032671.1,55106857,56572940,56572942,C,CAA,2
NC_037349.1,NC_032671.1,55107549,56573634,56573639,A,AACAAT,5
NC_037349.1,NC_032671.1,55117950,56584042,56584043,g,gt,1
NC_037349.1,NC_032671.1,55126885,56591835,56591836,C,CA,1
NC_037349.1,NC_032671.1,55148696,56613657,56613658,c,ca,1
NC_037349.1,NC_032671.1,55162034,56626995,56626997,G,GGC,2
NC_037349.1,NC_032671.1,55162341,56627303,56627304,A,AW,1
NC_037349.1,NC_032671.1,55167865,56632827,56632832,A,AGCATC,5
NC_037349.1,NC_032671.1,55265331,56735445,56735448,c,caag,3
NC_037349.1,NC_032671.1,55270696,56740661,56740662,A,AY,1
NC_037349.1,NC_032671.1,55270821,56740787,56740788,T,TY,1
NC_037349.1,NC_032671.1,55270980,56740947,56740951,t,ttttc,4
NC_037349.1,NC_032671.1,55418880,56886348,56886350,t,taa,2
NC_037349.1,NC_032671.1,55435453,56902928,56902931,a,aaag,3
NC_037349.1,NC_032671.1,55444289,56911772,56911774,A,AAG,2
NC_037349.1,NC_032671.1,55449348,56916831,56916832,G,GC,1
NC_037349.1,NC_032671.1,55512895,56979975,56979977,C,CAG,2
NC_037349.1,NC_032671.1,55576558,57093595,57093596,C,CY,1
NC_037349.1,NC_032671.1,55592507,57109546,57109549,t,tgtg,3
NC_037349.1,NC_032671.1,55609623,57126666,57126677,C,CTCTAGTACTTY,11
NC_037349.1,NC_032671.1,55645968,57163020,57163023,t,tttg,3
NC_037349.1,NC_032671.1,55646152,57163207,57163211,T,TCARA,4
NC_037349.1,NC_032671.1,55648361,57165422,57165429,A,AAGACTTC,7
NC_037349.1,NC_032671.1,55650080,57167147,57167148,a,at,1
NC_037349.1,NC_032671.1,55680233,57197366,57197367,T,TY,1
NC_037349.1,NC_032671.1,55683498,57200634,57200635,A,AT,1
NC_037349.1,NC_032671.1,55699492,57216626,57216627,A,AR,1
NC_037349.1,NC_032671.1,55723773,57240909,57240910,g,ga,1
NC_037349.1,NC_032671.1,55803600,57321125,57321126,t,ta,1
NC_037349.1,NC_032671.1,55814503,57337176,57337177,C,CA,1
NC_037349.1,NC_032671.1,55819687,57342360,57342361,c,ct,1
NC_037349.1,NC_032671.1,55825483,57348161,57348165,A,ACCAG,4
NC_037349.1,NC_032671.1,55834666,57357352,57357353,a,ag,1
NC_037349.1,NC_032671.1,55859694,57382391,57382392,G,GT,1
NC_037349.1,NC_032671.1,55867704,57390332,57390334,c,ctg,2
NC_037349.1,NC_032671.1,55871491,57394120,57394121,t,tc,1
NC_037349.1,NC_032671.1,55904269,57427968,57427980,C,CAACTAGTAAGAA,12
NC_037349.1,NC_032671.1,55911607,57435318,57435320,t,tgg,2
NC_037349.1,NC_032671.1,56004057,57534918,57534920,T,TTA,2
NC_037349.1,NC_032671.1,56035945,57567084,57567086,g,gga,2
NC_037349.1,NC_032671.1,56035955,57567096,57567097,t,tg,1
NC_037349.1,NC_032671.1,56049456,57580532,57580533,c,ct,1
NC_037349.1,NC_032671.1,56120154,57666394,57666395,T,TC,1
NC_037349.1,NC_032671.1,56120320,57666561,57666562,A,AG,1
NC_037349.1,NC_032671.1,56125559,57671807,57671808,T,TC,1
NC_037349.1,NC_032671.1,56252884,57799433,57799437,G,GCCAC,4
NC_037349.1,NC_032671.1,56264003,57810428,57810429,C,CY,1
NC_037349.1,NC_032671.1,56264180,57810606,57810608,C,CTT,2
NC_037349.1,NC_032671.1,56265223,57811796,57811798,A,ACT,2
NC_037349.1,NC_032671.1,56285890,57832280,57832281,A,AG,1
NC_037349.1,NC_032671.1,56299482,57845657,57845658,C,CY,1
NC_037349.1,NC_032671.1,56304543,57850719,57850720,T,TA,1
NC_037349.1,NC_032671.1,56316810,57862988,57862991,c,cttt,3
NC_037349.1,NC_032671.1,56440945,58081883,58081886,T,TGGC,3
NC_037349.1,NC_032671.1,56441206,58082147,58082148,T,TC,1
NC_037349.1,NC_032671.1,56480058,58121011,58121012,T,TK,1
NC_037349.1,NC_032671.1,56485009,58126005,58126009,C,CTTAY,4
NC_037349.1,NC_032671.1,56487767,58128682,58128683,T,TA,1
NC_037349.1,NC_032671.1,56488276,58129191,58129192,C,CT,1
NC_037349.1,NC_032671.1,56506279,58147180,58147182,C,CCY,2
NC_037349.1,NC_032671.1,56506665,58147575,58147581,c,ctatata,6
NC_037349.1,NC_032671.1,56507732,58148648,58148649,G,GR,1
NC_037349.1,NC_032671.1,56510047,58150965,58150966,t,tR,1
NC_037349.1,NC_032671.1,56529357,58170263,58170264,T,TG,1
NC_037349.1,NC_032671.1,56538354,58179241,58179242,T,TS,1
NC_037349.1,NC_032671.1,56549087,58189968,58189970,A,ACT,2
NC_037349.1,NC_032671.1,56577076,58220405,58220406,G,GC,1
NC_037349.1,NC_032671.1,56652327,58293965,58293966,c,cg,1
NC_037349.1,NC_032671.1,56719950,58361692,58361693,C,CT,1
NC_037349.1,NC_032671.1,56745611,58387431,58387432,T,TY,1
NC_037349.1,NC_032671.1,56751495,58393317,58393327,C,CTCAAACATTT,10
NC_037349.1,NC_032671.1,56811237,58460431,58460432,t,ta,1
NC_037349.1,NC_032671.1,56811253,58460448,58460450,t,ttW,2
NC_037349.1,NC_032671.1,56823568,58472767,58472768,T,TY,1
NC_037349.1,NC_032671.1,56827638,58476838,58476839,T,TW,1
NC_037349.1,NC_032671.1,56994033,58602182,58602183,g,gt,1
NC_037349.1,NC_032671.1,57007843,58616005,58616006,A,AG,1
NC_037349.1,NC_032671.1,57008111,58616274,58616275,A,AR,1
NC_037349.1,NC_032671.1,57009512,58617678,58617679,a,ag,1
NC_037349.1,NC_032671.1,57009518,58617685,58617686,a,ac,1
NC_037349.1,NC_032671.1,57041348,58649057,58649070,A,AACAGAGGTCAGAT,13
NC_037349.1,NC_032671.1,57044546,58652268,58652269,a,at,1
NC_037349.1,NC_032671.1,57057262,58664832,58664833,C,CT,1
NC_037349.1,NC_032671.1,57071279,58679308,58679312,t,ttccc,4
NC_037349.1,NC_032671.1,57074421,58682141,58682142,G,GA,1
NC_037349.1,NC_032671.1,57142151,58752201,58752203,A,ACT,2
NC_037349.1,NC_032671.1,57144540,58754594,58754600,A,ACCACAG,6
NC_037349.1,NC_032671.1,57156018,58766077,58766078,A,AC,1
NC_037349.1,NC_032671.1,57267372,58917263,58917264,A,AC,1
NC_037349.1,NC_032671.1,57282426,58932318,58932319,C,CY,1
NC_037349.1,NC_032671.1,57319577,58969508,58969512,g,gggac,4
NC_037349.1,NC_032671.1,57336634,58986580,58986581,A,AG,1
NC_037349.1,NC_032671.1,57336641,58986588,58986589,T,TA,1
NC_037349.1,NC_032671.1,57443697,59093286,59093287,A,AG,1
NC_037349.1,NC_032671.1,57444819,59094409,59094411,t,tac,2
NC_037349.1,NC_032671.1,57445509,59095101,59095113,G,GACTCCCCATCTS,12
NC_037349.1,NC_032671.1,57500718,59149018,59149020,c,cat,2
NC_037349.1,NC_032671.1,57613765,59261352,59261353,A,AW,1
NC_037349.1,NC_032671.1,57613809,59261397,59261400,C,CTAT,3
NC_037349.1,NC_032671.1,57613923,59261514,59261515,g,gc,1
NC_037349.1,NC_032671.1,57647696,59295883,59295885,g,gga,2
NC_037349.1,NC_032671.1,57647696,59443757,59443759,g,gga,2
NC_037349.1,NC_032671.1,57676249,59324424,59324425,C,CG,1
NC_037349.1,NC_032671.1,57707084,59503830,59503831,g,gt,1
NC_037349.1,NC_032671.1,57710972,59507856,59507857,A,AC,1
NC_037349.1,NC_032671.1,57748417,59406677,59406679,A,AAG,2
NC_037349.1,NC_032671.1,57764057,59422319,59422320,A,AT,1
NC_037349.1,NC_032671.1,57768584,59426850,59426851,C,CM,1
NC_037349.1,NC_032671.1,57791376,59529340,59529342,C,CCA,2
NC_037349.1,NC_032671.1,57791528,59529494,59529503,A,ACCCTCAGGG,9
NC_037349.1,NC_032671.1,57832472,59569608,59569609,C,CY,1
NC_037349.1,NC_032671.1,57851707,59588844,59588848,T,TAATC,4
NC_037349.1,NC_032671.1,57851707,59589785,59589789,T,TAATC,4
NC_037349.1,NC_032671.1,57879970,59617449,59617450,A,AG,1
NC_037349.1,NC_032671.1,57880268,59617756,59617757,g,gt,1
NC_037349.1,NC_032671.1,57900998,59639099,59639100,G,GA,1
NC_037349.1,NC_032671.1,57911215,59649318,59649319,A,AC,1
NC_037349.1,NC_032671.1,57967407,59708969,59708977,C,CTTAAAACT,8
NC_037349.1,NC_032671.1,57989314,59730895,59730896,A,AC,1
NC_037349.1,NC_032671.1,57991106,59732688,59732689,T,TC,1
NC_037349.1,NC_032671.1,58038159,59779444,59779445,G,GR,1
NC_037349.1,NC_032671.1,58042939,59784225,59784226,G,GA,1
NC_037349.1,NC_032671.1,58045525,59786812,59786813,A,AT,1
NC_037349.1,NC_032671.1,58153500,59901265,59901267,C,CCA,2
NC_037349.1,NC_032671.1,58155661,59903428,59903430,T,TTC,2
NC_037349.1,NC_032671.1,58331273,60147387,60147388,C,CY,1
NC_037349.1,NC_032671.1,58339930,60156047,60156055,g,gcgggggca,8
NC_037349.1,NC_032671.1,58339934,60156059,60156063,t,tgagg,4
NC_037349.1,NC_032671.1,58347991,60164105,60164106,G,GA,1
NC_037349.1,NC_032671.1,58348100,60164217,60164218,T,TG,1
NC_037349.1,NC_032671.1,58364366,60180543,60180545,g,gaa,2
NC_037349.1,NC_032671.1,58410482,60229074,60229075,G,GT,1
NC_037349.1,NC_032671.1,58410527,60229120,60229121,G,GC,1
NC_037349.1,NC_032671.1,58430930,60249314,60249315,G,GY,1
NC_037349.1,NC_032671.1,58441982,60260214,60260215,C,CT,1
NC_037349.1,NC_032671.1,58485088,60298354,60298355,t,ta,1
NC_037349.1,NC_032671.1,58491380,60304718,60304719,G,GC,1
NC_037349.1,NC_032671.1,58502303,60315644,60315645,g,gc,1
NC_037349.1,NC_032671.1,58505916,60319258,60319262,T,TCCCN,4
NC_037349.1,NC_032671.1,58561848,60375290,60375291,c,ca,1
NC_037349.1,NC_032671.1,58605152,60418233,60418237,G,GCTGT,4
NC_037349.1,NC_032671.1,58605700,60418785,60418786,G,GA,1
NC_037349.1,NC_032671.1,58617541,60430628,60430629,G,GA,1
NC_037349.1,NC_032671.1,58622084,60435304,60435305,G,GT,1
NC_037349.1,NC_032671.1,58672831,60482738,60482739,T,TG,1
NC_037349.1,NC_032671.1,58691727,60501635,60501636,C,CM,1
NC_037349.1,NC_032671.1,58760432,60570511,60570512,t,tc,1
NC_037349.1,NC_032671.1,58785413,60595488,60595489,G,GC,1
NC_037349.1,NC_032671.1,58842275,60655159,60655160,G,GA,1
NC_037349.1,NC_032671.1,58856835,60669714,60669716,A,ACT,2
NC_037349.1,NC_032671.1,58867496,60680419,60680421,C,CGT,2
NC_037349.1,NC_032671.1,58887973,60700898,60700899,T,TA,1
NC_037349.1,NC_032671.1,58898279,60711209,60711210,G,GC,1
NC_037349.1,NC_032671.1,58945987,60813545,60813546,T,TC,1
NC_037349.1,NC_032671.1,58958211,60825772,60825773,A,AN,1
NC_037349.1,NC_032671.1,59139505,60987874,60987875,G,GA,1
NC_037349.1,NC_032671.1,59150036,60998393,60998394,T,TA,1
NC_037349.1,NC_032671.1,59179292,61027314,61027315,T,TC,1
NC_037349.1,NC_032671.1,59190233,61038264,61038266,A,ATc,2
NC_037349.1,NC_032671.1,59242588,61090546,61090547,C,CT,1
NC_037349.1,NC_032671.1,59262375,61110352,61110362,G,GGGCGGGNNNN,10
NC_037349.1,NC_032671.1,59301156,61149386,61149387,G,GC,1
NC_037349.1,NC_032671.1,59313617,61161899,61161900,C,CA,1
NC_037349.1,NC_032671.1,59362753,61250999,61251001,C,CCT,2
NC_037349.1,NC_032671.1,59375976,61264390,61264391,T,TG,1
NC_037349.1,NC_032671.1,59376051,61264465,61264466,G,GS,1
NC_037349.1,NC_032671.1,59393368,61281898,61281899,A,AM,1
NC_037349.1,NC_032671.1,59427286,61315839,61315840,T,TG,1
NC_037349.1,NC_032671.1,59473572,61363907,61363908,C,CT,1
NC_037349.1,NC_032671.1,59513062,61403274,61403275,C,CA,1
NC_037349.1,NC_032671.1,59551406,61441621,61441624,T,TCTA,3
NC_037349.1,NC_032671.1,59555267,61445468,61445472,A,AAGGG,4
NC_037349.1,NC_032671.1,59555304,61445509,61445511,A,AAC,2
NC_037349.1,NC_032671.1,59559532,61449666,61449667,T,TG,1
NC_037349.1,NC_032671.1,59572620,61462756,61462764,A,ATGTAGGGC,8
NC_037349.1,NC_032671.1,59583144,61473284,61473285,G,GC,1
NC_037349.1,NC_032671.1,59599362,61489503,61489523,C,CTGAGAGCAGCACCCCCGATT,20
NC_037349.1,NC_032671.1,59617560,61508179,61508180,C,CA,1
NC_037349.1,NC_032671.1,59627950,61518574,61518575,C,CA,1
NC_037349.1,NC_032671.1,59661948,61560800,61560801,c,ct,1
NC_037349.1,NC_032671.1,59682572,61581495,61581496,T,TA,1
NC_037349.1,NC_032671.1,59691094,61590068,61590069,g,gc,1
NC_037349.1,NC_032671.1,59691222,61590197,61590219,C,CCCACACTCAGGGAGAGCCCCGT,22
NC_037349.1,NC_032671.1,59707559,61606563,61606564,A,AM,1
NC_037349.1,NC_032671.1,59714383,61613388,61613393,C,CTTTSS,5
NC_037349.1,NC_032671.1,59720249,61619259,61619261,c,cca,2
NC_037349.1,NC_032671.1,59740421,61639434,61639447,C,CTGGGCTCAGCCCG,13
NC_037349.1,NC_032671.1,59895838,61869182,61869183,A,AT,1
