Reference ID,Query ID,Reference POS,Query POS,Query END,REF,ALT,SVLEN
NC_037335.1,NC_032657.1,644826,356685,356686,c,ct,1
NC_037335.1,NC_032657.1,721660,433525,433526,T,TA,1
NC_037335.1,NC_032657.1,721665,433531,433532,T,TA,1
NC_037335.1,NC_032657.1,855145,566059,566074,t,ttgtgaccccacggac,15
NC_037335.1,NC_032657.1,1102596,810797,810801,g,gctct,4
NC_037335.1,NC_032657.1,1134106,842746,842747,C,CG,1
NC_037335.1,NC_032657.1,1134203,842842,842843,A,AT,1
NC_037335.1,NC_032657.1,1135884,857466,857486,T,TTCCAGTCCAGCTCTGAGGCC,20
NC_037335.1,NC_032657.1,1151317,872917,872938,G,GTCTCTGCTGATTTGACCTAAA,21
NC_037335.1,NC_032657.1,1322540,1059397,1059398,t,tc,1
NC_037335.1,NC_032657.1,1510367,1267477,1267478,a,ag,1
NC_037335.1,NC_032657.1,1556877,1313990,1313991,C,CS,1
NC_037335.1,NC_032657.1,1625791,1382892,1382893,A,AG,1
NC_037335.1,NC_032657.1,1625799,1382901,1382902,T,TG,1
NC_037335.1,NC_032657.1,1628939,1385913,1385914,A,AG,1
NC_037335.1,NC_032657.1,1628982,1385958,1385959,G,GA,1
NC_037335.1,NC_032657.1,1628994,1385971,1385972,T,TA,1
NC_037335.1,NC_032657.1,1701009,1449866,1449867,T,TY,1
NC_037335.1,NC_032657.1,1850230,1598418,1598419,a,ag,1
NC_037335.1,NC_032657.1,1857444,1605484,1605486,g,gtc,2
NC_037335.1,NC_032657.1,1864343,1613423,1613425,T,TAA,2
NC_037335.1,NC_032657.1,1898772,1647837,1647838,T,TG,1
NC_037335.1,NC_032657.1,1987219,1774422,1774423,g,ga,1
NC_037335.1,NC_032657.1,2134159,1922602,1922603,g,gc,1
NC_037335.1,NC_032657.1,2195864,1984148,1984149,t,tc,1
NC_037335.1,NC_032657.1,2221077,2009715,2009716,T,TK,1
NC_037335.1,NC_032657.1,2231215,2019863,2019864,a,at,1
NC_037335.1,NC_032657.1,2296394,2074754,2074755,T,TA,1
NC_037335.1,NC_032657.1,2439700,2129062,2129067,t,tacttg,5
NC_037335.1,NC_032657.1,2569983,2286315,2286317,T,TCC,2
NC_037335.1,NC_032657.1,2649730,2366211,2366215,c,ctctt,4
NC_037335.1,NC_032657.1,2686866,2403357,2403358,g,gt,1
NC_037335.1,NC_032657.1,2714563,2431050,2431058,C,CCATCTAST,8
NC_037335.1,NC_032657.1,2717757,2434266,2434267,a,ac,1
NC_037335.1,NC_032657.1,2809707,2526226,2526228,a,atg,2
NC_037335.1,NC_032657.1,2854291,2570818,2570819,a,ac,1
NC_037335.1,NC_032657.1,2862333,2578860,2578861,c,cg,1
NC_037335.1,NC_032657.1,2892734,2609247,2609248,c,ca,1
NC_037335.1,NC_032657.1,2892761,2609275,2609277,t,tNN,2
NC_037335.1,NC_032657.1,2972897,2698726,2698727,a,at,1
NC_037335.1,NC_032657.1,3018738,2744568,2744569,t,ta,1
NC_037335.1,NC_032657.1,3024667,2750498,2750499,t,tc,1
NC_037335.1,NC_032657.1,3082474,2808309,2808310,c,ca,1
NC_037335.1,NC_032657.1,3171279,2935895,2935905,a,aNNNNNNNNNN,10
NC_037335.1,NC_032657.1,3186113,2950718,2950719,a,at,1
NC_037335.1,NC_032657.1,3210175,2974961,2974962,C,CM,1
NC_037335.1,NC_032657.1,3327142,3091927,3091928,c,ca,1
NC_037335.1,NC_032657.1,3356073,3120860,3120861,A,AT,1
NC_037335.1,NC_032657.1,3366426,3131214,3131215,C,CA,1
NC_037335.1,NC_032657.1,3421281,3186062,3186064,a,aNN,2
NC_037335.1,NC_032657.1,3544077,3308732,3308746,g,gtNTACTCCTCAagt,14
NC_037335.1,NC_032657.1,3622857,3387169,3387170,g,gR,1
NC_037335.1,NC_032657.1,3634372,3398685,3398687,a,atc,2
NC_037335.1,NC_032657.1,3778984,3552231,3552232,t,ta,1
NC_037335.1,NC_032657.1,3791358,3564473,3564474,t,ta,1
NC_037335.1,NC_032657.1,3793493,3566608,3566609,T,TA,1
NC_037335.1,NC_032657.1,3794212,3567326,3567327,T,TC,1
NC_037335.1,NC_032657.1,3826948,3599929,3599931,c,caa,2
NC_037335.1,NC_032657.1,3827471,3600451,3600466,t,tgctcgagaatttcca,15
NC_037335.1,NC_032657.1,3838760,3611753,3611754,a,at,1
NC_037335.1,NC_032657.1,3838765,3611759,3611760,c,ca,1
NC_037335.1,NC_032657.1,3868649,3643101,3643102,A,AT,1
NC_037335.1,NC_032657.1,3892605,3667073,3667074,a,aN,1
NC_037335.1,NC_032657.1,3893145,3667614,3667618,t,ttatc,4
NC_037335.1,NC_032657.1,3921234,3695719,3695723,t,ttttg,4
NC_037335.1,NC_032657.1,3926472,3700960,3700961,t,ta,1
NC_037335.1,NC_032657.1,3940877,3715367,3715368,a,ac,1
NC_037335.1,NC_032657.1,3961803,3736305,3736306,T,TC,1
NC_037335.1,NC_032657.1,3971393,3745897,3745913,a,ataataataataataat,16
NC_037335.1,NC_032657.1,3978744,3753275,3753276,t,tc,1
NC_037335.1,NC_032657.1,3981090,3755626,3755628,t,tcg,2
NC_037335.1,NC_032657.1,3983114,3757650,3757652,C,CAA,2
NC_037335.1,NC_032657.1,3986852,3761390,3761392,t,tNN,2
NC_037335.1,NC_032657.1,4043979,3818550,3818551,A,AT,1
NC_037335.1,NC_032657.1,4147875,3922629,3922636,c,cttttttt,7
NC_037335.1,NC_032657.1,4211539,3988394,3988400,t,tagcagg,6
NC_037335.1,NC_032657.1,4235452,4013383,4013384,t,tg,1
NC_037335.1,NC_032657.1,4334076,4111566,4111567,g,gt,1
NC_037335.1,NC_032657.1,4368312,4148814,4148815,C,CA,1
NC_037335.1,NC_032657.1,4370920,4151423,4151429,t,ttaaaaa,6
NC_037335.1,NC_032657.1,4370928,4151437,4151441,a,aaatt,4
NC_037335.1,NC_032657.1,4374032,4154544,4154545,T,TY,1
NC_037335.1,NC_032657.1,4385841,4166349,4166371,c,catgtatatatatatatatatat,22
NC_037335.1,NC_032657.1,4386661,4167191,4167201,T,TCATAGCTAAA,10
NC_037335.1,NC_032657.1,4395121,4175647,4175648,t,tW,1
NC_037335.1,NC_032657.1,4396928,4177459,4177461,t,taa,2
NC_037335.1,NC_032657.1,4413671,4194205,4194206,a,ac,1
NC_037335.1,NC_032657.1,4420497,4201032,4201033,c,ct,1
NC_037335.1,NC_032657.1,4437880,4218420,4218421,A,AG,1
NC_037335.1,NC_032657.1,4439402,4219943,4219944,c,ct,1
NC_037335.1,NC_032657.1,4501940,4253658,4253659,T,TA,1
NC_037335.1,NC_032657.1,4506752,4258470,4258471,g,ga,1
NC_037335.1,NC_032657.1,4506767,4258486,4258489,g,gcgc,3
NC_037335.1,NC_032657.1,4506872,4258600,4258601,t,ta,1
NC_037335.1,NC_032657.1,4507676,4259395,4259396,t,tc,1
NC_037335.1,NC_032657.1,4511561,4263443,4263446,c,ccaa,3
NC_037335.1,NC_032657.1,4514065,4265948,4265950,a,att,2
NC_037335.1,NC_032657.1,4514082,4265967,4265968,a,at,1
NC_037335.1,NC_032657.1,4515001,4266887,4266888,t,tW,1
NC_037335.1,NC_032657.1,4523848,4275760,4275769,c,ccttccaatg,9
NC_037335.1,NC_032657.1,4525401,4277290,4277293,T,TAGG,3
NC_037335.1,NC_032657.1,4526412,4278304,4278305,G,GC,1
NC_037335.1,NC_032657.1,4531295,4283188,4283190,g,gca,2
NC_037335.1,NC_032657.1,4536273,4288165,4288166,T,TG,1
NC_037335.1,NC_032657.1,4550542,4302437,4302438,t,tN,1
NC_037335.1,NC_032657.1,4570666,4324646,4324661,t,tccaAGNNNNNNNNNN,15
NC_037335.1,NC_032657.1,4646746,4400756,4400759,c,caag,3
NC_037335.1,NC_032657.1,4674735,4522088,4522089,c,ca,1
NC_037335.1,NC_032657.1,4684302,4531530,4531531,t,tg,1
NC_037335.1,NC_032657.1,4689714,4536943,4536944,T,TY,1
NC_037335.1,NC_032657.1,4690292,4537523,4537524,a,ac,1
NC_037335.1,NC_032657.1,4694014,4541245,4541246,t,tc,1
NC_037335.1,NC_032657.1,4699805,4547039,4547040,A,AR,1
NC_037335.1,NC_032657.1,4743144,4590398,4590402,t,tacac,4
NC_037335.1,NC_032657.1,4754560,4601819,4601820,t,tg,1
NC_037335.1,NC_032657.1,4754592,4601852,4601860,c,ccttacaca,8
NC_037335.1,NC_032657.1,4757575,4604843,4604845,g,gaa,2
NC_037335.1,NC_032657.1,4798840,4646110,4646116,a,atataNN,6
NC_037335.1,NC_032657.1,4847118,4701020,4701033,a,aNNNNtatatatat,13
NC_037335.1,NC_032657.1,4848292,4702207,4702230,g,ggggatgacagaggatgagatggc,23
NC_037335.1,NC_032657.1,4884370,4737885,4737886,a,at,1
NC_037335.1,NC_032657.1,4889725,4743249,4743250,t,ta,1
NC_037335.1,NC_032657.1,4894790,4747089,4747093,t,tttta,4
NC_037335.1,NC_032657.1,4903371,4755673,4755679,T,TCACCTA,6
NC_037335.1,NC_032657.1,4925166,4777397,4777398,T,TK,1
NC_037335.1,NC_032657.1,4997498,4849347,4849348,G,GC,1
NC_037335.1,NC_032657.1,5006735,4858589,4858596,g,gaaagtga,7
NC_037335.1,NC_032657.1,5045404,4897166,4897168,C,CCA,2
NC_037335.1,NC_032657.1,5201707,5064280,5064281,a,at,1
NC_037335.1,NC_032657.1,5212707,5075280,5075281,T,TA,1
NC_037335.1,NC_032657.1,5216834,5079408,5079414,t,ttaaaaa,6
NC_037335.1,NC_032657.1,5217236,5079816,5079818,c,ctt,2
NC_037335.1,NC_032657.1,5221701,5084268,5084269,G,GA,1
NC_037335.1,NC_032657.1,5291608,5154274,5154275,g,gt,1
NC_037335.1,NC_032657.1,5374272,5237700,5237702,g,gga,2
NC_037335.1,NC_032657.1,5414438,5277574,5277595,t,tgtgtgtgtgtgtgtgtgtgtg,21
NC_037335.1,NC_032657.1,5414732,5277889,5277890,A,AC,1
NC_037335.1,NC_032657.1,5709390,5572687,5572693,t,tNNNNNN,6
NC_037335.1,NC_032657.1,5741909,5605503,5605504,t,tc,1
NC_037335.1,NC_032657.1,5775708,5639327,5639328,A,AR,1
NC_037335.1,NC_032657.1,5813966,5677595,5677596,t,tg,1
NC_037335.1,NC_032657.1,5854168,5752243,5752244,A,AC,1
NC_037335.1,NC_032657.1,5854810,5752886,5752887,t,tg,1
NC_037335.1,NC_032657.1,5911199,5809907,5809912,A,AGGTCT,5
NC_037335.1,NC_032657.1,5977935,5877681,5877682,T,TC,1
NC_037335.1,NC_032657.1,6006479,5906227,5906228,c,ca,1
NC_037335.1,NC_032657.1,6025257,5924942,5924943,c,ct,1
NC_037335.1,NC_032657.1,6089607,5989298,5989299,a,ac,1
NC_037335.1,NC_032657.1,6093822,5993514,5993516,t,tgc,2
NC_037335.1,NC_032657.1,6104547,6004240,6004242,a,act,2
NC_037335.1,NC_032657.1,6132751,6032444,6032445,a,at,1
NC_037335.1,NC_032657.1,6142396,6042090,6042091,t,ta,1
NC_037335.1,NC_032657.1,6224124,6123227,6123228,g,gc,1
NC_037335.1,NC_032657.1,6246622,6145730,6145731,a,at,1
NC_037335.1,NC_032657.1,6252767,6151875,6151876,t,tg,1
NC_037335.1,NC_032657.1,6278349,6179455,6179464,c,ccctggcagt,9
NC_037335.1,NC_032657.1,6287946,6189026,6189072,C,CTCAACAGAAAATGGAGAAGGTAACTATCGCATTCATAGAAACTGGG,46
NC_037335.1,NC_032657.1,6324484,6226400,6226401,a,aN,1
NC_037335.1,NC_032657.1,6329587,6231504,6231506,t,tta,2
NC_037335.1,NC_032657.1,6421661,6323771,6323772,c,ct,1
NC_037335.1,NC_032657.1,6509988,6450609,6450610,C,CG,1
NC_037335.1,NC_032657.1,6569965,6510043,6510045,a,agg,2
NC_037335.1,NC_032657.1,6570659,6510739,6510745,G,GACATAT,6
NC_037335.1,NC_032657.1,6639243,6580028,6580029,T,TC,1
NC_037335.1,NC_032657.1,6656547,6597285,6597288,c,caaa,3
NC_037335.1,NC_032657.1,6682656,6624174,6624175,a,at,1
NC_037335.1,NC_032657.1,6759545,6698691,6698692,G,GA,1
NC_037335.1,NC_032657.1,6767737,6706885,6706890,c,caaagt,5
NC_037335.1,NC_032657.1,6768192,6707344,6707383,c,cagtctgttgttccatgttagtTCATGTCAGTTCCATgtt,39
NC_037335.1,NC_032657.1,6776172,6715364,6715368,A,AAAGT,4
NC_037335.1,NC_032657.1,6776738,6715934,6715935,A,AT,1
NC_037335.1,NC_032657.1,6784724,6723929,6723930,T,TG,1
NC_037335.1,NC_032657.1,6797838,6736991,6736994,T,TTAA,3
NC_037335.1,NC_032657.1,6911595,6873380,6873402,g,gcggattctttaccagctgagcc,22
NC_037335.1,NC_032657.1,6976672,6938479,6938480,T,TC,1
NC_037335.1,NC_032657.1,7092019,7177241,7177242,t,tN,1
NC_037335.1,NC_032657.1,7096479,7181707,7181708,c,ca,1
NC_037335.1,NC_032657.1,7096678,7181904,7181905,t,ta,1
NC_037335.1,NC_032657.1,7157992,7107989,7107990,t,tc,1
NC_037335.1,NC_032657.1,7159359,7109357,7109358,g,ga,1
NC_037335.1,NC_032657.1,7277159,7202103,7202104,a,ag,1
NC_037335.1,NC_032657.1,7282353,7207299,7207300,C,CT,1
NC_037335.1,NC_032657.1,7282379,7207326,7207329,T,TCTA,3
NC_037335.1,NC_032657.1,7323429,7206636,7206646,c,ccgactSTGTG,10
NC_037335.1,NC_032657.1,7324436,7207653,7207654,G,GC,1
NC_037335.1,NC_032657.1,7325211,7208424,7208427,C,CCTT,3
NC_037335.1,NC_032657.1,7326036,7209253,7209260,t,tcagcaca,7
NC_037335.1,NC_032657.1,7340880,7225687,7225688,A,AC,1
NC_037335.1,NC_032657.1,7539792,7418930,7418933,t,taaa,3
NC_037335.1,NC_032657.1,7541457,7420598,7420600,A,AAG,2
NC_037335.1,NC_032657.1,7595902,7474980,7474981,g,ga,1
NC_037335.1,NC_032657.1,7597761,7476840,7476841,A,AC,1
NC_037335.1,NC_032657.1,7802009,7681184,7681185,C,CS,1
NC_037335.1,NC_032657.1,8096877,7976150,7976152,c,cag,2
NC_037335.1,NC_032657.1,8097298,7976572,7976581,t,tactgtttcc,9
NC_037335.1,NC_032657.1,8099845,7979124,7979125,T,TA,1
NC_037335.1,NC_032657.1,8498920,8381413,8381414,C,CT,1
NC_037335.1,NC_032657.1,8498922,8381416,8381417,G,GC,1
NC_037335.1,NC_032657.1,8643773,8532247,8532248,c,ct,1
NC_037335.1,NC_032657.1,8662220,8550696,8550698,t,taa,2
NC_037335.1,NC_032657.1,8747862,8776368,8776373,c,cctttg,5
NC_037335.1,NC_032657.1,8748265,8776776,8776777,g,ga,1
NC_037335.1,NC_032657.1,8865603,8893848,8893849,a,at,1
NC_037335.1,NC_032657.1,8868935,8897186,8897187,a,ag,1
NC_037335.1,NC_032657.1,8869096,8897348,8897349,c,ct,1
NC_037335.1,NC_032657.1,9008982,8998713,8998732,C,CTCAAAGACACTTCAGTGCT,19
NC_037335.1,NC_032657.1,9017901,9007651,9007652,C,CY,1
NC_037335.1,NC_032657.1,9047808,9083250,9083251,G,GA,1
NC_037335.1,NC_032657.1,9115096,9150805,9150806,a,ag,1
NC_037335.1,NC_032657.1,9216572,9273714,9273716,G,GAC,2
NC_037335.1,NC_032657.1,9252579,9309697,9309698,A,AG,1
NC_037335.1,NC_032657.1,9300618,9357751,9357752,T,TW,1
NC_037335.1,NC_032657.1,9332628,9389721,9389726,a,aaactc,5
NC_037335.1,NC_032657.1,9358715,9415915,9415916,a,at,1
NC_037335.1,NC_032657.1,9371881,9435581,9435582,T,TK,1
NC_037335.1,NC_032657.1,9403347,9466751,9466752,c,ct,1
NC_037335.1,NC_032657.1,9411479,9474883,9474922,G,GACTAGCACAGGGTGCCTATATGAAGAAAACCGGGTTCGA,39
NC_037335.1,NC_032657.1,9426033,9489474,9489475,g,gR,1
NC_037335.1,NC_032657.1,9541735,9604644,9604645,G,GA,1
NC_037335.1,NC_032657.1,9597043,9659949,9659951,T,TTC,2
NC_037335.1,NC_032657.1,9597671,9660575,9660578,G,GAGR,3
NC_037335.1,NC_032657.1,9598661,9661568,9661577,C,CGCTCCAGCT,9
NC_037335.1,NC_032657.1,9612887,9675826,9675827,c,ct,1
NC_037335.1,NC_032657.1,9619458,9682400,9682401,g,ga,1
NC_037335.1,NC_032657.1,9625654,9688619,9688620,t,tg,1
NC_037335.1,NC_032657.1,9728166,9790895,9790897,A,AAC,2
NC_037335.1,NC_032657.1,9728904,9791635,9791638,t,ttta,3
NC_037335.1,NC_032657.1,9729277,9792011,9792012,T,TW,1
NC_037335.1,NC_032657.1,9744737,9807502,9807503,c,ct,1
NC_037335.1,NC_032657.1,9749882,9812649,9812650,A,AG,1
NC_037335.1,NC_032657.1,9760298,9823223,9823224,g,gt,1
NC_037335.1,NC_032657.1,9766159,9829115,9829116,a,at,1
NC_037335.1,NC_032657.1,9779982,9842899,9842901,a,aat,2
NC_037335.1,NC_032657.1,9813417,9876291,9876292,c,ct,1
NC_037335.1,NC_032657.1,9929731,9991309,9991334,g,gtaaggagttccaaccagtccattct,25
NC_037335.1,NC_032657.1,9982630,10044249,10044250,t,tN,1
NC_037335.1,NC_032657.1,10056606,10118609,10118610,T,TK,1
NC_037335.1,NC_032657.1,10124857,10186323,10186327,c,cWTCA,4
NC_037335.1,NC_032657.1,10170559,10232220,10232228,t,tattcattg,8
NC_037335.1,NC_032657.1,10172738,10234409,10234410,t,ta,1
NC_037335.1,NC_032657.1,10172972,10234644,10234702,t,ttaaaatagcaatgaggatggggaacacatgagaaataaaaaaaaaaaaaataaaaaaa,58
NC_037335.1,NC_032657.1,10174673,10236403,10236405,c,cag,2
NC_037335.1,NC_032657.1,10217046,10278662,10278663,T,TC,1
NC_037335.1,NC_032657.1,10218032,10279715,10279716,C,CG,1
NC_037335.1,NC_032657.1,10235530,10297039,10297040,t,ta,1
NC_037335.1,NC_032657.1,10249881,10311391,10311392,a,ag,1
NC_037335.1,NC_032657.1,10290883,10352392,10352393,T,TG,1
NC_037335.1,NC_032657.1,10295353,10356852,10356853,C,CT,1
NC_037335.1,NC_032657.1,10478420,10538182,10538183,A,AT,1
NC_037335.1,NC_032657.1,10589715,10670231,10670233,C,CAT,2
NC_037335.1,NC_032657.1,10853010,10941850,10941851,G,GK,1
NC_037335.1,NC_032657.1,10922805,11016533,11016534,c,ct,1
NC_037335.1,NC_032657.1,11407874,11496947,11496949,a,aNN,2
NC_037335.1,NC_032657.1,11427250,11516324,11516325,C,CA,1
NC_037335.1,NC_032657.1,11544743,11633950,11633979,T,TCCTTCNNNNNNNNNNNNNNNNNNNNNNNN,29
NC_037335.1,NC_032657.1,11674731,11764017,11764018,T,TA,1
NC_037335.1,NC_032657.1,11713143,11809971,11809972,A,AW,1
NC_037335.1,NC_032657.1,11897519,11994101,11994110,a,attttttttt,9
NC_037335.1,NC_032657.1,11900465,11997057,11997058,c,ca,1
NC_037335.1,NC_032657.1,12002359,12119752,12119753,A,AN,1
NC_037335.1,NC_032657.1,12064599,12204267,12204268,a,at,1
NC_037335.1,NC_032657.1,12068348,12207855,12207856,t,ta,1
NC_037335.1,NC_032657.1,12326572,12464219,12464220,a,ag,1
NC_037335.1,NC_032657.1,12342598,12480247,12480248,G,GA,1
NC_037335.1,NC_032657.1,12361356,12498890,12498891,g,gc,1
NC_037335.1,NC_032657.1,12544748,12729646,12729647,a,ag,1
NC_037335.1,NC_032657.1,12549363,12734262,12734264,a,aat,2
NC_037335.1,NC_032657.1,12706003,12895567,12895569,t,tta,2
NC_037335.1,NC_032657.1,12709090,12898656,12898663,C,CACTTTAA,7
NC_037335.1,NC_032657.1,12725188,12914751,12914757,a,ataaaat,6
NC_037335.1,NC_032657.1,12780442,12970011,12970012,T,TC,1
NC_037335.1,NC_032657.1,13000602,13190103,13190104,t,ta,1
NC_037335.1,NC_032657.1,13010962,13200471,13200472,c,ct,1
NC_037335.1,NC_032657.1,13012598,13202108,13202109,g,ga,1
NC_037335.1,NC_032657.1,13019077,13208589,13208591,a,aNN,2
NC_037335.1,NC_032657.1,13042536,13231687,13231689,t,tcc,2
NC_037335.1,NC_032657.1,13042594,13231747,13231748,g,gc,1
NC_037335.1,NC_032657.1,13057000,13246158,13246171,c,cttcactttcactt,13
NC_037335.1,NC_032657.1,13058701,13247872,13247875,C,CAGT,3
NC_037335.1,NC_032657.1,13125458,13314684,13314685,T,TM,1
NC_037335.1,NC_032657.1,13289945,13501537,13501538,T,TA,1
NC_037335.1,NC_032657.1,13309974,13524509,13524510,c,ct,1
NC_037335.1,NC_032657.1,13443420,13658930,13658932,t,tNN,2
NC_037335.1,NC_032657.1,13487083,13702853,13702855,a,aNN,2
NC_037335.1,NC_032657.1,13649607,13877913,13877914,a,ag,1
NC_037335.1,NC_032657.1,13649630,13877937,13877938,a,ag,1
NC_037335.1,NC_032657.1,13661068,13889370,13889372,c,cat,2
NC_037335.1,NC_032657.1,13705123,13933172,13933173,g,ga,1
NC_037335.1,NC_032657.1,13705171,13933224,13933225,g,ga,1
NC_037335.1,NC_032657.1,14272201,14503304,14503305,a,at,1
NC_037335.1,NC_032657.1,14418020,14637963,14637965,a,atc,2
NC_037335.1,NC_032657.1,14479671,14700418,14700423,G,GTTTAA,5
NC_037335.1,NC_032657.1,14546573,14775314,14775315,C,CT,1
NC_037335.1,NC_032657.1,14725392,14977194,14977196,C,CTG,2
NC_037335.1,NC_032657.1,14752046,15003851,15003852,t,ta,1
NC_037335.1,NC_032657.1,14756142,15007940,15007941,g,gt,1
NC_037335.1,NC_032657.1,14758692,15010495,15010496,T,TG,1
NC_037335.1,NC_032657.1,14759154,15010989,15010990,A,AC,1
NC_037335.1,NC_032657.1,14759278,15011114,15011115,C,CM,1
NC_037335.1,NC_032657.1,14762173,15014010,15014012,a,att,2
NC_037335.1,NC_032657.1,14763977,15015416,15015417,t,tc,1
NC_037335.1,NC_032657.1,14764041,15015484,15015485,c,ca,1
NC_037335.1,NC_032657.1,14766509,15017951,15017955,G,GACCR,4
NC_037335.1,NC_032657.1,14791759,15043157,15043173,t,taaagactccaccagaa,16
NC_037335.1,NC_032657.1,14792763,15044177,15044178,c,ct,1
NC_037335.1,NC_032657.1,14857890,15110211,15110212,A,AC,1
NC_037335.1,NC_032657.1,14919625,15170956,15171073,a,aggttACTGTTAAAAAACAATCTTCCAAGAGATGATAATAAAAAGTAGATAGGTCAACTNNNNNNNNNNNNNNNNNNNNNNNNNNNNNNNNNNNNNNNNNNNNNNNNNNNNNNNNNNN,117
NC_037335.1,NC_032657.1,14970890,15222457,15222458,g,ga,1
NC_037335.1,NC_032657.1,14971506,15223074,15223075,c,ca,1
NC_037335.1,NC_032657.1,14972362,15223931,15223932,a,ac,1
NC_037335.1,NC_032657.1,14982303,15233873,15233874,g,gc,1
NC_037335.1,NC_032657.1,14982313,15233884,15233886,a,aac,2
NC_037335.1,NC_032657.1,14983913,15235491,15235492,T,TC,1
NC_037335.1,NC_032657.1,14991668,15243250,15243251,a,ac,1
NC_037335.1,NC_032657.1,15024998,15276585,15276587,t,tNN,2
NC_037335.1,NC_032657.1,15064038,15332890,15332891,t,tg,1
NC_037335.1,NC_032657.1,15066245,15335098,15335099,g,ga,1
NC_037335.1,NC_032657.1,15093004,15361858,15361862,t,tNNNN,4
NC_037335.1,NC_032657.1,15100038,15368896,15368897,c,ca,1
NC_037335.1,NC_032657.1,15175691,15444553,15444554,a,at,1
NC_037335.1,NC_032657.1,15181909,15450769,15450770,A,AT,1
NC_037335.1,NC_032657.1,15200174,15469036,15469037,t,tc,1
NC_037335.1,NC_032657.1,15232607,15501744,15501745,G,GT,1
NC_037335.1,NC_032657.1,15248663,15517789,15517794,a,atatat,5
NC_037335.1,NC_032657.1,15297074,15566241,15566242,t,ta,1
NC_037335.1,NC_032657.1,15299006,15568201,15568202,T,TA,1
NC_037335.1,NC_032657.1,15308538,15577818,15577819,g,gc,1
NC_037335.1,NC_032657.1,15308541,15577822,15577823,a,at,1
NC_037335.1,NC_032657.1,15326580,15601077,15601081,G,GTATR,4
NC_037335.1,NC_032657.1,15328496,15602983,15602984,A,AC,1
NC_037335.1,NC_032657.1,15339335,15613824,15613826,g,gga,2
NC_037335.1,NC_032657.1,15364903,15639281,15639282,t,tg,1
NC_037335.1,NC_032657.1,15378986,15653626,15653630,t,tataK,4
NC_037335.1,NC_032657.1,15393233,15667857,15667862,g,gggggc,5
NC_037335.1,NC_032657.1,15429744,15704583,15704584,t,ta,1
NC_037335.1,NC_032657.1,15430292,15705132,15705133,g,gt,1
NC_037335.1,NC_032657.1,15431253,15706089,15706090,c,ca,1
NC_037335.1,NC_032657.1,15439941,15714781,15714782,C,CG,1
NC_037335.1,NC_032657.1,15439963,15714804,15714805,C,CT,1
NC_037335.1,NC_032657.1,15450214,15725054,15725055,a,at,1
NC_037335.1,NC_032657.1,15451062,15725905,15725913,t,tgtgtgtga,8
NC_037335.1,NC_032657.1,15461537,15736378,15736379,t,tg,1
NC_037335.1,NC_032657.1,15462711,15737554,15737556,C,CTA,2
NC_037335.1,NC_032657.1,15477453,15752298,15752299,c,ca,1
NC_037335.1,NC_032657.1,15542827,15817034,15817035,g,ga,1
NC_037335.1,NC_032657.1,15559885,15834104,15834106,g,gca,2
NC_037335.1,NC_032657.1,15562381,15836612,15836615,T,TTTC,3
NC_037335.1,NC_032657.1,15563961,15838195,15838196,A,AC,1
NC_037335.1,NC_032657.1,15563975,15838210,15838213,G,GTGT,3
NC_037335.1,NC_032657.1,15564264,15838502,15838510,T,TTTACATCA,8
NC_037335.1,NC_032657.1,15578770,15853008,15853010,A,AAG,2
NC_037335.1,NC_032657.1,15584152,15858378,15858379,t,tc,1
NC_037335.1,NC_032657.1,15586548,15860778,15860779,T,TC,1
NC_037335.1,NC_032657.1,15591161,15865392,15865396,a,acTAT,4
NC_037335.1,NC_032657.1,15595844,15870076,15870078,t,tta,2
NC_037335.1,NC_032657.1,15597716,15872150,15872151,t,tg,1
NC_037335.1,NC_032657.1,15598435,15872863,15872865,G,GAT,2
NC_037335.1,NC_032657.1,15601087,15875520,15875521,T,TY,1
NC_037335.1,NC_032657.1,15605076,15879508,15879510,a,aat,2
NC_037335.1,NC_032657.1,15616108,15890473,15890474,C,CA,1
NC_037335.1,NC_032657.1,15618445,15899566,15899567,A,AY,1
NC_037335.1,NC_032657.1,15911134,16137476,16137478,a,atg,2
NC_037335.1,NC_032657.1,15946116,16172922,16172923,g,gc,1
NC_037335.1,NC_032657.1,15949773,16176577,16176578,T,TG,1
NC_037335.1,NC_032657.1,16018415,16245222,16245224,t,tca,2
NC_037335.1,NC_032657.1,16018759,16257699,16257702,a,aaag,3
NC_037335.1,NC_032657.1,16146245,16385781,16385782,a,at,1
NC_037335.1,NC_032657.1,16173595,16413139,16413141,a,acc,2
NC_037335.1,NC_032657.1,16201219,16440745,16440749,a,aNNNN,4
NC_037335.1,NC_032657.1,16215670,16455201,16455202,T,TG,1
NC_037335.1,NC_032657.1,16216748,16456280,16456287,A,ACTTGCTC,7
NC_037335.1,NC_032657.1,16317403,16534379,16534380,a,at,1
NC_037335.1,NC_032657.1,16350376,16567353,16567368,t,tatatatatatatata,15
NC_037335.1,NC_032657.1,16365909,16582901,16582906,C,CAGAAT,5
NC_037335.1,NC_032657.1,16437914,16831935,16831936,A,AR,1
NC_037335.1,NC_032657.1,16438044,16832066,16832069,g,gggt,3
NC_037335.1,NC_032657.1,16438361,16832380,16832382,T,TCA,2
NC_037335.1,NC_032657.1,16452495,16846520,16846521,t,ta,1
NC_037335.1,NC_032657.1,16456582,16850612,16850616,C,CCAGT,4
NC_037335.1,NC_032657.1,16486997,16881026,16881040,a,aatttaactcagatg,14
NC_037335.1,NC_032657.1,16494110,16888981,16888982,G,GN,1
NC_037335.1,NC_032657.1,16569470,16964352,16964353,t,ta,1
NC_037335.1,NC_032657.1,16610804,17005823,17005837,t,tNNNNNNNNNNNNNN,14
NC_037335.1,NC_032657.1,16683532,17078152,17078153,G,GC,1
NC_037335.1,NC_032657.1,16762201,17156513,17156514,A,AG,1
NC_037335.1,NC_032657.1,16848298,17253895,17253896,A,AC,1
NC_037335.1,NC_032657.1,16880084,17285622,17285628,t,tttttta,6
NC_037335.1,NC_032657.1,16891598,17297144,17297145,C,CM,1
NC_037335.1,NC_032657.1,16908445,17366134,17366135,T,TN,1
NC_037335.1,NC_032657.1,16958252,17416132,17416136,A,AAAGT,4
NC_037335.1,NC_032657.1,16958266,17416150,17416151,c,ct,1
NC_037335.1,NC_032657.1,17010116,17467862,17467863,A,AG,1
NC_037335.1,NC_032657.1,17031874,17489484,17489486,c,cat,2
NC_037335.1,NC_032657.1,17076944,17534260,17534261,t,tg,1
NC_037335.1,NC_032657.1,17232828,17690671,17690673,a,aag,2
NC_037335.1,NC_032657.1,17429814,17887645,17887646,c,ca,1
NC_037335.1,NC_032657.1,17470125,17927334,17927335,a,aR,1
NC_037335.1,NC_032657.1,17509907,17967144,17967146,a,att,2
NC_037335.1,NC_032657.1,17516036,17973273,17973274,T,TK,1
NC_037335.1,NC_032657.1,17517127,17974365,17974366,T,TC,1
NC_037335.1,NC_032657.1,17621684,18079393,18079419,t,tNNNNNNNNNNNNNNNNNNNNNNNNNN,26
NC_037335.1,NC_032657.1,17629281,18087020,18087021,T,TC,1
NC_037335.1,NC_032657.1,17636800,18094542,18094543,A,AG,1
NC_037335.1,NC_032657.1,17640315,18098058,18098059,c,cg,1
NC_037335.1,NC_032657.1,17643803,18101548,18101551,t,taaa,3
NC_037335.1,NC_032657.1,17660418,18118159,18118160,C,CN,1
NC_037335.1,NC_032657.1,17663157,18120873,18120882,T,TGTTAAGATA,9
NC_037335.1,NC_032657.1,17663602,18121327,18121328,t,ta,1
NC_037335.1,NC_032657.1,17730089,18188266,18188268,t,ttg,2
NC_037335.1,NC_032657.1,17750280,18208418,18208420,a,aNN,2
NC_037335.1,NC_032657.1,18017824,18486760,18486767,A,ANNNNNNN,7
NC_037335.1,NC_032657.1,18017918,18486861,18486863,G,GAA,2
NC_037335.1,NC_032657.1,18017966,18486911,18486912,T,TA,1
NC_037335.1,NC_032657.1,18066556,18534786,18534787,a,aN,1
NC_037335.1,NC_032657.1,18087269,18555504,18555506,A,AAG,2
NC_037335.1,NC_032657.1,18215467,18684505,18684506,t,ta,1
NC_037335.1,NC_032657.1,18301028,18770502,18770503,g,gc,1
NC_037335.1,NC_032657.1,18308107,18777508,18777509,C,CA,1
NC_037335.1,NC_032657.1,18313526,18782928,18782929,C,CA,1
NC_037335.1,NC_032657.1,18326443,18795831,18795833,c,ctt,2
NC_037335.1,NC_032657.1,18342043,18811529,18811530,c,ct,1
NC_037335.1,NC_032657.1,18354894,18824381,18824382,c,ct,1
NC_037335.1,NC_032657.1,18361078,18830564,18830565,G,GA,1
NC_037335.1,NC_032657.1,18361827,18831313,18831315,c,cat,2
NC_037335.1,NC_032657.1,18468609,18937889,18937890,g,ga,1
NC_037335.1,NC_032657.1,18511421,18980829,18980830,G,GK,1
NC_037335.1,NC_032657.1,18574646,19044653,19044654,a,ac,1
NC_037335.1,NC_032657.1,18580077,19050086,19050095,a,aacccaagtt,9
NC_037335.1,NC_032657.1,18590867,19060891,19060892,T,TK,1
NC_037335.1,NC_032657.1,18593382,19063407,19063415,a,aNNNNNNNN,8
NC_037335.1,NC_032657.1,18593947,19064014,19064015,c,ca,1
NC_037335.1,NC_032657.1,18608839,19078958,19078960,t,tNN,2
NC_037335.1,NC_032657.1,18625687,19095842,19095847,a,aaagtc,5
NC_037335.1,NC_032657.1,18643733,19113974,19113977,t,tata,3
NC_037335.1,NC_032657.1,18733183,19200373,19200396,t,ttgccagcatcagctggatcattg,23
NC_037335.1,NC_032657.1,18739794,19206943,19206944,C,CT,1
NC_037335.1,NC_032657.1,18756680,19224016,19224017,T,TK,1
NC_037335.1,NC_032657.1,18774142,19241373,19241374,t,tg,1
NC_037335.1,NC_032657.1,18789194,19256426,19256428,C,CYG,2
NC_037335.1,NC_032657.1,18846310,19313543,19313544,a,ag,1
NC_037335.1,NC_032657.1,18854206,19321445,19321446,a,ag,1
NC_037335.1,NC_032657.1,18872729,19339969,19339970,A,AT,1
NC_037335.1,NC_032657.1,18886614,19353879,19353880,t,tc,1
NC_037335.1,NC_032657.1,18900924,19368188,19368189,c,ca,1
NC_037335.1,NC_032657.1,18955311,19422512,19422513,t,ta,1
NC_037335.1,NC_032657.1,19012283,19479512,19479515,A,AACT,3
NC_037335.1,NC_032657.1,19013018,19480250,19480251,c,ca,1
NC_037335.1,NC_032657.1,19017764,19484917,19484919,t,taa,2
NC_037335.1,NC_032657.1,19053982,19521124,19521125,T,TG,1
NC_037335.1,NC_032657.1,19058996,19526136,19526137,t,tY,1
NC_037335.1,NC_032657.1,19081124,19548271,19548272,g,ga,1
NC_037335.1,NC_032657.1,19085514,19552666,19552667,a,ag,1
NC_037335.1,NC_032657.1,19143591,19589173,19589174,T,TY,1
NC_037335.1,NC_032657.1,19227395,20053276,20053294,t,tacacacacacacacacac,18
NC_037335.1,NC_032657.1,19376659,19857232,19857233,t,tg,1
NC_037335.1,NC_032657.1,19385528,19866844,19866845,t,ta,1
NC_037335.1,NC_032657.1,19456166,19937381,19937390,g,gtttccactc,9
NC_037335.1,NC_032657.1,19482357,20116582,20116583,t,ta,1
NC_037335.1,NC_032657.1,19483009,20117234,20117235,t,tg,1
NC_037335.1,NC_032657.1,19483161,20117387,20117388,g,gt,1
NC_037335.1,NC_032657.1,19486901,20121132,20121133,a,at,1
NC_037335.1,NC_032657.1,19487160,20121391,20121395,a,atttg,4
NC_037335.1,NC_032657.1,19498640,20132871,20132877,a,aTACTgg,6
NC_037335.1,NC_032657.1,19506820,20141057,20141058,T,TA,1
NC_037335.1,NC_032657.1,19508360,20142597,20142598,A,AT,1
NC_037335.1,NC_032657.1,19511808,20146057,20146058,G,GA,1
NC_037335.1,NC_032657.1,19514858,20160328,20160329,c,ct,1
NC_037335.1,NC_032657.1,19555782,20201253,20201260,c,ctttcact,7
NC_037335.1,NC_032657.1,19584644,20230465,20230466,G,GA,1
NC_037335.1,NC_032657.1,19586291,20232114,20232124,c,cacacacacaY,10
NC_037335.1,NC_032657.1,19596850,20242683,20242688,a,aaaaat,5
NC_037335.1,NC_032657.1,19786025,20433459,20433461,t,tcc,2
NC_037335.1,NC_032657.1,19805365,20452969,20452970,a,ac,1
NC_037335.1,NC_032657.1,19822714,20470326,20470327,c,ct,1
NC_037335.1,NC_032657.1,19873707,20521320,20521321,C,CA,1
NC_037335.1,NC_032657.1,19887053,20534671,20534673,a,atg,2
NC_037335.1,NC_032657.1,19908111,20555741,20555742,T,TW,1
NC_037335.1,NC_032657.1,19924755,20572964,20572965,t,tg,1
NC_037335.1,NC_032657.1,19925500,20573710,20573712,T,TTC,2
NC_037335.1,NC_032657.1,19935936,20584136,20584137,T,TC,1
NC_037335.1,NC_032657.1,19953635,20601651,20601653,g,ggt,2
NC_037335.1,NC_032657.1,19991472,21066158,21066159,g,ga,1
NC_037335.1,NC_032657.1,20014332,21089038,21089039,a,ag,1
NC_037335.1,NC_032657.1,20024693,21099401,21099402,T,TA,1
NC_037335.1,NC_032657.1,20025136,21099845,21099847,t,taa,2
NC_037335.1,NC_032657.1,20053810,20630512,20630513,A,AM,1
NC_037335.1,NC_032657.1,20090153,20667377,20667378,T,TG,1
NC_037335.1,NC_032657.1,20114401,20691639,20691640,c,cM,1
NC_037335.1,NC_032657.1,20119513,20696756,20696757,c,ct,1
NC_037335.1,NC_032657.1,20132526,20709766,20709768,C,CGT,2
NC_037335.1,NC_032657.1,20145616,20722860,20722861,t,ta,1
NC_037335.1,NC_032657.1,20154356,20731601,20731602,a,ag,1
NC_037335.1,NC_032657.1,20181600,20758844,20758845,G,GC,1
NC_037335.1,NC_032657.1,20252103,20887044,20887045,c,ca,1
NC_037335.1,NC_032657.1,20272993,20907938,20907939,C,CY,1
NC_037335.1,NC_032657.1,20276579,20911525,20911529,G,GTTTT,4
NC_037335.1,NC_032657.1,20338668,20973953,20973954,T,TC,1
NC_037335.1,NC_032657.1,20346046,20981332,20981333,T,TC,1
NC_037335.1,NC_032657.1,20349265,20984559,20984560,T,TW,1
NC_037335.1,NC_032657.1,20373376,21007799,21007803,C,CTAAT,4
NC_037335.1,NC_032657.1,20383127,21017562,21017563,T,TK,1
NC_037335.1,NC_032657.1,20387055,21021490,21021492,t,tca,2
NC_037335.1,NC_032657.1,20501211,21162657,21162658,T,TW,1
NC_037335.1,NC_032657.1,20504348,21165792,21165794,g,ggt,2
NC_037335.1,NC_032657.1,20537419,21198861,21198863,a,agt,2
NC_037335.1,NC_032657.1,20549726,21211098,21211100,T,TTC,2
NC_037335.1,NC_032657.1,20558577,21219950,21219952,C,CAT,2
NC_037335.1,NC_032657.1,20568256,21229647,21229648,t,tY,1
NC_037335.1,NC_032657.1,20654108,21315507,21315513,a,acagcag,6
NC_037335.1,NC_032657.1,20671506,21332912,21332913,G,GA,1
NC_037335.1,NC_032657.1,20682251,21343653,21343655,a,aNN,2
NC_037335.1,NC_032657.1,20713088,21374216,21374217,T,TA,1
NC_037335.1,NC_032657.1,20715190,21376320,21376321,c,ca,1
NC_037335.1,NC_032657.1,20729833,21391014,21391030,t,tctttgtgaccccatgg,16
NC_037335.1,NC_032657.1,20733964,21395164,21395165,t,tg,1
NC_037335.1,NC_032657.1,20742294,21403602,21403605,t,tagc,3
NC_037335.1,NC_032657.1,20747924,21409235,21409236,a,ac,1
NC_037335.1,NC_032657.1,20796415,21459921,21459922,a,ag,1
NC_037335.1,NC_032657.1,20796452,21459959,21459960,g,gt,1
NC_037335.1,NC_032657.1,20916636,21574939,21574940,g,ga,1
NC_037335.1,NC_032657.1,20921027,21579334,21579337,a,aaag,3
NC_037335.1,NC_032657.1,20921027,21634229,21634232,a,aaag,3
NC_037335.1,NC_032657.1,20921574,21579884,21579886,a,atg,2
NC_037335.1,NC_032657.1,20926634,21639850,21639851,c,ca,1
NC_037335.1,NC_032657.1,20926657,21639874,21639875,t,tg,1
NC_037335.1,NC_032657.1,20927554,21640771,21640772,t,tc,1
NC_037335.1,NC_032657.1,20927952,21641170,21641174,a,agaag,4
NC_037335.1,NC_032657.1,20929171,21642403,21642404,t,tg,1
NC_037335.1,NC_032657.1,20930114,21643346,21643347,C,CA,1
NC_037335.1,NC_032657.1,20931740,21645601,21645602,a,at,1
NC_037335.1,NC_032657.1,20932208,21646070,21646071,g,gt,1
NC_037335.1,NC_032657.1,20995333,21710036,21710037,t,tg,1
NC_037335.1,NC_032657.1,21008280,21722983,21722984,a,at,1
NC_037335.1,NC_032657.1,21013039,21727314,21727317,g,gata,3
NC_037335.1,NC_032657.1,21013039,21760031,21760034,g,gata,3
NC_037335.1,NC_032657.1,21013115,21727393,21727394,g,gt,1
NC_037335.1,NC_032657.1,21017412,21764406,21764407,t,ta,1
NC_037335.1,NC_032657.1,21018298,21732265,21732266,g,gc,1
NC_037335.1,NC_032657.1,21018298,21765295,21765296,g,gc,1
NC_037335.1,NC_032657.1,21023424,21770422,21770423,c,cN,1
NC_037335.1,NC_032657.1,21070596,21821807,21821808,g,ga,1
NC_037335.1,NC_032657.1,21070620,21821832,21821833,g,ga,1
NC_037335.1,NC_032657.1,21070657,21821870,21821871,c,ca,1
NC_037335.1,NC_032657.1,21074563,21825776,21825777,A,AC,1
NC_037335.1,NC_032657.1,21110819,21862034,21862036,t,tNN,2
NC_037335.1,NC_032657.1,21189205,21940281,21940282,A,AT,1
NC_037335.1,NC_032657.1,21193572,21944650,21944651,t,ta,1
NC_037335.1,NC_032657.1,21202336,21953378,21953379,t,tg,1
NC_037335.1,NC_032657.1,21202429,21953471,21953472,t,tc,1
NC_037335.1,NC_032657.1,21206857,21957823,21957824,c,ct,1
NC_037335.1,NC_032657.1,21225472,21975013,21975018,A,ATGTCT,5
NC_037335.1,NC_032657.1,21234560,22031896,22031897,a,aN,1
NC_037335.1,NC_032657.1,21301864,22100640,22100677,t,tatatatatatatatatatatatatataaatatatata,37
NC_037335.1,NC_032657.1,21336599,22136079,22136080,c,ca,1
NC_037335.1,NC_032657.1,21354531,22154016,22154020,c,caact,4
NC_037335.1,NC_032657.1,21644032,22197085,22197089,a,aaggt,4
NC_037335.1,NC_032657.1,21646009,22195110,22195111,a,ac,1
NC_037335.1,NC_032657.1,21667613,22580788,22580789,A,AT,1
NC_037335.1,NC_032657.1,21667884,22581060,22581061,a,at,1
NC_037335.1,NC_032657.1,21670442,22583620,22583621,a,at,1
NC_037335.1,NC_032657.1,21684534,22598334,22598336,a,aac,2
NC_037335.1,NC_032657.1,21757808,22671628,22671629,g,ga,1
NC_037335.1,NC_032657.1,21761148,22674961,22674962,C,CM,1
NC_037335.1,NC_032657.1,21768972,22682788,22682791,C,CATG,3
NC_037335.1,NC_032657.1,21780621,22694441,22694442,g,gt,1
NC_037335.1,NC_032657.1,21838017,22780012,22780013,a,aS,1
NC_037335.1,NC_032657.1,21845316,22786619,22786627,C,CKAGAATGT,8
NC_037335.1,NC_032657.1,21946639,22891323,22891328,G,GTACCT,5
NC_037335.1,NC_032657.1,21993518,22938260,22938264,t,tNNNN,4
NC_037335.1,NC_032657.1,22002195,22947010,22947012,t,ttg,2
NC_037335.1,NC_032657.1,22125178,23071112,23071119,a,aNNNNNNN,7
NC_037335.1,NC_032657.1,22127209,23073150,23073153,G,GTTC,3
NC_037335.1,NC_032657.1,22168108,23159315,23159318,a,aaat,3
NC_037335.1,NC_032657.1,22222888,23122575,23122576,C,CT,1
NC_037335.1,NC_032657.1,22222888,23234206,23234207,C,CT,1
NC_037335.1,NC_032657.1,22242076,23254192,23254194,c,cgg,2
NC_037335.1,NC_032657.1,22245842,23257959,23257960,C,CG,1
NC_037335.1,NC_032657.1,22294131,23306251,23306254,t,taaa,3
NC_037335.1,NC_032657.1,22367289,23379412,23379413,C,CG,1
NC_037335.1,NC_032657.1,22374676,23386815,23386816,a,at,1
NC_037335.1,NC_032657.1,22377438,23389576,23389579,a,actc,3
NC_037335.1,NC_032657.1,22399114,23416204,23416208,a,aNNNN,4
NC_037335.1,NC_032657.1,22418449,23435546,23435547,A,AG,1
NC_037335.1,NC_032657.1,22418820,23435918,23435931,G,GGAGACCCTTCACC,13
NC_037335.1,NC_032657.1,22514464,23549744,23549746,A,ACT,2
NC_037335.1,NC_032657.1,22573384,23648305,23648306,G,GA,1
NC_037335.1,NC_032657.1,22580568,23648745,23648746,G,GA,1
NC_037335.1,NC_032657.1,22581522,23649700,23649701,t,tc,1
NC_037335.1,NC_032657.1,22588272,23656451,23656453,t,ttg,2
NC_037335.1,NC_032657.1,22593671,23661850,23661851,A,AC,1
NC_037335.1,NC_032657.1,22605975,23611047,23611048,G,GA,1
NC_037335.1,NC_032657.1,22612068,23616620,23616621,t,tc,1
NC_037335.1,NC_032657.1,22621838,23626399,23626408,A,AAATGTAGTC,9
NC_037335.1,NC_032657.1,22624102,23628671,23628672,G,GC,1
NC_037335.1,NC_032657.1,22624297,23628867,23628868,A,AG,1
NC_037335.1,NC_032657.1,22624661,23629230,23629233,t,tttc,3
NC_037335.1,NC_032657.1,22624954,23629526,23629527,A,AT,1
NC_037335.1,NC_032657.1,22786959,24114896,24114897,c,ct,1
NC_037335.1,NC_032657.1,22938559,23935119,23935120,G,GT,1
NC_037335.1,NC_032657.1,22982744,24291139,24291140,a,aN,1
NC_037335.1,NC_032657.1,22998144,24307319,24307320,t,tY,1
NC_037335.1,NC_032657.1,23007485,24315652,24315653,a,ac,1
NC_037335.1,NC_032657.1,23020725,24333309,24333310,C,CN,1
NC_037335.1,NC_032657.1,23040021,24352610,24352611,a,at,1
NC_037335.1,NC_032657.1,23040602,24353192,24353199,T,TTTGGAGG,7
NC_037335.1,NC_032657.1,23044996,24357595,24357596,T,TA,1
NC_037335.1,NC_032657.1,23076044,24388660,24388661,G,GC,1
NC_037335.1,NC_032657.1,23086599,24399221,24399231,T,TAAGAAGCAGC,10
NC_037335.1,NC_032657.1,23087084,24399716,24399717,G,GA,1
NC_037335.1,NC_032657.1,23092509,24405143,24405145,A,AAG,2
NC_037335.1,NC_032657.1,23174403,24487928,24487930,c,cgg,2
NC_037335.1,NC_032657.1,23209443,24489555,24489556,C,CA,1
NC_037335.1,NC_032657.1,23211539,24491654,24491660,c,cgggggg,6
NC_037335.1,NC_032657.1,23213430,24493552,24493566,C,CTGCTCAGATCACCA,14
NC_037335.1,NC_032657.1,23213519,24493655,24493657,C,CCG,2
NC_037335.1,NC_032657.1,23215119,24495258,24495259,A,AT,1
NC_037335.1,NC_032657.1,23233637,24660740,24660745,C,CTTCTT,5
NC_037335.1,NC_032657.1,23241414,24668517,24668518,c,ca,1
NC_037335.1,NC_032657.1,23260477,24687597,24687600,C,CCTA,3
NC_037335.1,NC_032657.1,23260757,24687882,24687886,G,GTTTC,4
NC_037335.1,NC_032657.1,23265303,24692398,24692401,a,aatg,3
NC_037335.1,NC_032657.1,23265362,24692460,24692463,g,gcta,3
NC_037335.1,NC_032657.1,23266720,24693819,24693820,T,TG,1
NC_037335.1,NC_032657.1,23271491,24695188,24695189,T,TA,1
NC_037335.1,NC_032657.1,23272661,24696345,24696350,a,aaaaac,5
NC_037335.1,NC_032657.1,23274842,24698534,24698535,c,ct,1
NC_037335.1,NC_032657.1,23275986,24699680,24699681,a,ag,1
NC_037335.1,NC_032657.1,23276341,24700036,24700037,t,tg,1
NC_037335.1,NC_032657.1,23277257,24700953,24700958,c,cactga,5
NC_037335.1,NC_032657.1,23277967,24701668,24701669,C,CA,1
NC_037335.1,NC_032657.1,23278422,24702124,24702126,t,tNN,2
NC_037335.1,NC_032657.1,23278458,24702162,24702163,C,CA,1
NC_037335.1,NC_032657.1,23278538,24702243,24702244,a,at,1
NC_037335.1,NC_032657.1,23279154,24702860,24702861,g,gc,1
NC_037335.1,NC_032657.1,23393857,24817665,24817666,T,TA,1
NC_037335.1,NC_032657.1,23439167,24920656,24920657,t,ta,1
NC_037335.1,NC_032657.1,23468744,24950235,24950236,A,AW,1
NC_037335.1,NC_032657.1,23468871,24950363,24950367,a,aaaag,4
NC_037335.1,NC_032657.1,23475136,24956635,24956636,G,GR,1
NC_037335.1,NC_032657.1,23481464,24962946,24962947,A,AR,1
NC_037335.1,NC_032657.1,23513940,24995799,24995800,C,CA,1
NC_037335.1,NC_032657.1,23580295,25058088,25058089,a,at,1
NC_037335.1,NC_032657.1,23580425,25058219,25058220,a,ag,1
NC_037335.1,NC_032657.1,23584499,25062297,25062298,G,GC,1
NC_037335.1,NC_032657.1,23586065,25063896,25063899,g,gggc,3
NC_037335.1,NC_032657.1,23586073,25063907,25063909,t,tag,2
NC_037335.1,NC_032657.1,23604630,25082322,25082324,C,CTT,2
NC_037335.1,NC_032657.1,23619870,25097133,25097134,a,at,1
NC_037335.1,NC_032657.1,23641110,25118363,25118364,A,AC,1
NC_037335.1,NC_032657.1,23641117,25118371,25118372,C,CA,1
NC_037335.1,NC_032657.1,23641129,25118384,25118385,T,TG,1
NC_037335.1,NC_032657.1,23642683,25119938,25119941,T,TAAG,3
NC_037335.1,NC_032657.1,23669174,25146568,25146584,a,aaaccaatacaatattg,16
NC_037335.1,NC_032657.1,23671371,25148786,25148789,A,AAGG,3
NC_037335.1,NC_032657.1,23672928,25150347,25150348,t,ta,1
NC_037335.1,NC_032657.1,23675721,25153119,25153121,C,CTT,2
NC_037335.1,NC_032657.1,23676015,25153415,25153416,G,GA,1
NC_037335.1,NC_032657.1,23676986,25154387,25154397,a,actggaccttc,10
NC_037335.1,NC_032657.1,23681611,25159024,25159025,C,CA,1
NC_037335.1,NC_032657.1,23711060,25188485,25188486,C,CY,1
NC_037335.1,NC_032657.1,23767995,25245158,25245159,A,AM,1
NC_037335.1,NC_032657.1,23914165,25402748,25402749,T,TC,1
NC_037335.1,NC_032657.1,24011145,25499891,25499892,T,TA,1
NC_037335.1,NC_032657.1,24036527,25525276,25525293,A,AGTTGCAGTAAGTGGAGC,17
NC_037335.1,NC_032657.1,24070515,25559312,25559313,t,tg,1
NC_037335.1,NC_032657.1,24093197,25581994,25581995,T,TG,1
NC_037335.1,NC_032657.1,24246433,25739834,25739864,A,ATTNNNNNNNNNNNNNNNNNNNNNNNNNNNN,30
NC_037335.1,NC_032657.1,24270415,25763855,25763856,t,ta,1
NC_037335.1,NC_032657.1,24348400,25854093,25854094,T,TK,1
NC_037335.1,NC_032657.1,24409850,25915549,25915550,c,ca,1
NC_037335.1,NC_032657.1,24523206,26035013,26035014,c,ca,1
NC_037335.1,NC_032657.1,24525262,26037070,26037071,T,TG,1
NC_037335.1,NC_032657.1,24554521,26066330,26066331,g,gt,1
NC_037335.1,NC_032657.1,24559937,26071747,26071748,t,tg,1
NC_037335.1,NC_032657.1,24629333,26143866,26143867,t,ta,1
NC_037335.1,NC_032657.1,24650497,26165040,26165049,t,tccatatata,9
NC_037335.1,NC_032657.1,24742045,26256589,26256590,G,GA,1
NC_037335.1,NC_032657.1,24742490,26257035,26257045,C,CACGTGTCTGT,10
NC_037335.1,NC_032657.1,24768007,26282560,26282561,A,AG,1
NC_037335.1,NC_032657.1,24768340,26282894,26282895,a,at,1
NC_037335.1,NC_032657.1,24845836,26362152,26362153,g,gR,1
NC_037335.1,NC_032657.1,24848644,26364960,26364961,t,tW,1
NC_037335.1,NC_032657.1,24848984,26365303,26365304,G,GC,1
NC_037335.1,NC_032657.1,24853269,26369590,26369591,g,ga,1
NC_037335.1,NC_032657.1,24856856,26373178,26373179,A,AG,1
NC_037335.1,NC_032657.1,24857577,26373900,26373915,T,TANNNNNNNNGTCTAA,15
NC_037335.1,NC_032657.1,24882953,26399226,26399227,T,TY,1
NC_037335.1,NC_032657.1,24915484,26431872,26431873,A,AN,1
NC_037335.1,NC_032657.1,24935110,26451412,26451417,G,GWCGTT,5
NC_037335.1,NC_032657.1,25002001,26517632,26517637,a,attttt,5
NC_037335.1,NC_032657.1,25026946,26542525,26542528,t,ttaa,3
NC_037335.1,NC_032657.1,25038920,26554518,26554520,a,atg,2
NC_037335.1,NC_032657.1,25196501,26712088,26712089,g,ga,1
NC_037335.1,NC_032657.1,25313078,26828349,26828350,C,CY,1
NC_037335.1,NC_032657.1,25381404,26896721,26896725,c,ctctg,4
NC_037335.1,NC_032657.1,25642437,27194059,27194062,G,GAGA,3
NC_037335.1,NC_032657.1,25671765,27232638,27232640,t,ttg,2
NC_037335.1,NC_032657.1,25692644,27253517,27253518,c,ca,1
NC_037335.1,NC_032657.1,25704557,27265434,27265435,a,at,1
NC_037335.1,NC_032657.1,25718364,27279137,27279139,t,tac,2
NC_037335.1,NC_032657.1,25720650,27281417,27281485,T,TANNNNNNNNNNNNNNNNNNNNNNNNNNNNNNNNNNNNNNNNNNNNNNNNNNNNNNNNNNNNNNNNNNN,68
NC_037335.1,NC_032657.1,25725529,27286364,27286365,a,at,1
NC_037335.1,NC_032657.1,25741812,27302651,27302652,a,ac,1
NC_037335.1,NC_032657.1,25756224,27317071,27317072,C,CA,1
NC_037335.1,NC_032657.1,25818291,27379163,27379165,T,TTG,2
NC_037335.1,NC_032657.1,25818301,27379175,27379176,T,TG,1
NC_037335.1,NC_032657.1,25818336,27379210,27379212,C,CCT,2
NC_037335.1,NC_032657.1,25818396,27379273,27379274,C,CT,1
NC_037335.1,NC_032657.1,26000629,27560427,27560428,t,ta,1
NC_037335.1,NC_032657.1,26007876,27568410,27568411,c,ct,1
NC_037335.1,NC_032657.1,26078296,27638855,27638858,c,cgtt,3
NC_037335.1,NC_032657.1,26086021,27646575,27646576,t,ta,1
NC_037335.1,NC_032657.1,26089871,27650435,27650437,a,atg,2
NC_037335.1,NC_032657.1,26102477,27663046,27663047,t,tg,1
NC_037335.1,NC_032657.1,26125497,27686061,27686062,a,aW,1
NC_037335.1,NC_032657.1,26192890,27753457,27753462,T,TACAAC,5
NC_037335.1,NC_032657.1,26227294,27787866,27787867,c,ct,1
NC_037335.1,NC_032657.1,26353970,27900140,27900142,g,gtc,2
NC_037335.1,NC_032657.1,26354048,27900220,27900223,t,tgtc,3
NC_037335.1,NC_032657.1,26528383,28080770,28080772,C,CCT,2
NC_037335.1,NC_032657.1,26557220,28109745,28109746,g,gt,1
NC_037335.1,NC_032657.1,26598144,28150934,28150935,T,TC,1
NC_037335.1,NC_032657.1,26624150,28176899,28176900,t,tg,1
NC_037335.1,NC_032657.1,26633763,28186511,28186514,a,atgt,3
NC_037335.1,NC_032657.1,26661761,28214520,28214521,g,ga,1
NC_037335.1,NC_032657.1,26707135,28259898,28259899,c,ct,1
NC_037335.1,NC_032657.1,26713905,28266706,28266707,C,CA,1
NC_037335.1,NC_032657.1,26748952,28301755,28301761,a,aatagac,6
NC_037335.1,NC_032657.1,26749416,28302225,28302226,t,ta,1
NC_037335.1,NC_032657.1,26749857,28302667,28302668,a,at,1
NC_037335.1,NC_032657.1,26798889,28485824,28485825,g,ga,1
NC_037335.1,NC_032657.1,26800338,28487274,28487275,g,gc,1
NC_037335.1,NC_032657.1,26812110,28498967,28498968,t,ta,1
NC_037335.1,NC_032657.1,26822237,28509075,28509076,t,tc,1
NC_037335.1,NC_032657.1,26822597,28509436,28509437,g,gt,1
NC_037335.1,NC_032657.1,26850169,28537037,28537038,C,CA,1
NC_037335.1,NC_032657.1,26851298,28538167,28538170,T,TGGA,3
NC_037335.1,NC_032657.1,26853074,28539946,28539947,t,tc,1
NC_037335.1,NC_032657.1,26853312,28540185,28540186,A,AC,1
NC_037335.1,NC_032657.1,26858374,28545284,28545285,a,ag,1
NC_037335.1,NC_032657.1,26859473,28546401,28546403,c,cat,2
NC_037335.1,NC_032657.1,26866692,28553237,28553240,c,cgca,3
NC_037335.1,NC_032657.1,26885515,28592134,28592135,t,tg,1
NC_037335.1,NC_032657.1,26891296,28597913,28597914,T,TG,1
NC_037335.1,NC_032657.1,26897741,28604367,28604369,c,caa,2
NC_037335.1,NC_032657.1,26923375,28629382,28629383,g,ga,1
NC_037335.1,NC_032657.1,26992007,28698424,28698436,T,TATTCTCCATTTA,12
NC_037335.1,NC_032657.1,27095500,28800702,28800704,T,TTA,2
NC_037335.1,NC_032657.1,27098959,28804059,28804065,a,aNNNNNN,6
NC_037335.1,NC_032657.1,27099601,28804712,28804713,t,tc,1
NC_037335.1,NC_032657.1,27099608,28804720,28804721,c,ct,1
NC_037335.1,NC_032657.1,27104957,28810072,28810073,T,TY,1
NC_037335.1,NC_032657.1,27105459,28810576,28810577,T,TM,1
NC_037335.1,NC_032657.1,27105779,28810896,28810899,A,AATG,3
NC_037335.1,NC_032657.1,27108134,28813166,28813167,T,TC,1
NC_037335.1,NC_032657.1,27159363,28864399,28864400,a,at,1
NC_037335.1,NC_032657.1,27243761,28971850,28971851,T,TA,1
NC_037335.1,NC_032657.1,27278684,29006779,29006782,c,cact,3
NC_037335.1,NC_032657.1,27404805,29132968,29132974,A,AAGATAT,6
NC_037335.1,NC_032657.1,27420784,29148950,29148951,C,CA,1
NC_037335.1,NC_032657.1,27428821,29156982,29156983,t,tc,1
NC_037335.1,NC_032657.1,27469547,29196220,29196221,C,CG,1
NC_037335.1,NC_032657.1,27524837,29252097,29252098,T,TW,1
NC_037335.1,NC_032657.1,27550719,29277985,29277986,C,CT,1
NC_037335.1,NC_032657.1,27550728,29277995,29277996,T,TA,1
NC_037335.1,NC_032657.1,27550740,29278008,29278009,t,ta,1
NC_037335.1,NC_032657.1,27681893,29409173,29409174,c,ct,1
NC_037335.1,NC_032657.1,27695470,29422061,29422065,a,aNNNN,4
NC_037335.1,NC_032657.1,27780367,29506489,29506490,G,GT,1
NC_037335.1,NC_032657.1,27791513,29517637,29517638,G,GK,1
NC_037335.1,NC_032657.1,27822421,29548412,29548413,a,at,1
NC_037335.1,NC_032657.1,27833166,29558999,29559000,g,ga,1
NC_037335.1,NC_032657.1,27912155,29632336,29632337,C,CM,1
NC_037335.1,NC_032657.1,27934632,29654818,29654821,T,TAAG,3
NC_037335.1,NC_032657.1,27938732,29658924,29658927,a,acat,3
NC_037335.1,NC_032657.1,27939222,29659417,29659418,A,AG,1
NC_037335.1,NC_032657.1,27943241,29663437,29663439,t,tta,2
NC_037335.1,NC_032657.1,27969594,29689794,29689812,t,tgtgtgggtgtgggtgtgg,18
NC_037335.1,NC_032657.1,27996633,29716568,29716569,a,ag,1
NC_037335.1,NC_032657.1,28091103,29811851,29811852,c,ca,1
NC_037335.1,NC_032657.1,28173864,29902094,29902095,T,TK,1
NC_037335.1,NC_032657.1,28177515,29905749,29905750,c,ca,1
NC_037335.1,NC_032657.1,28253583,29991030,29991031,C,CT,1
NC_037335.1,NC_032657.1,28287667,30027775,30027776,t,tg,1
NC_037335.1,NC_032657.1,28301151,30041261,30041262,A,AT,1
NC_037335.1,NC_032657.1,28351592,30091714,30091715,t,tg,1
NC_037335.1,NC_032657.1,28358041,30098167,30098172,C,CAAAAT,5
NC_037335.1,NC_032657.1,28361597,30101732,30101733,t,tg,1
NC_037335.1,NC_032657.1,28382301,30122439,30122452,A,AGTTGCCTAGGAAT,13
NC_037335.1,NC_032657.1,28406643,30146793,30146798,t,tttttg,5
NC_037335.1,NC_032657.1,28441405,30181540,30181544,G,GCTTA,4
NC_037335.1,NC_032657.1,28453797,30193937,30193939,c,cag,2
NC_037335.1,NC_032657.1,28453880,30194022,30194023,t,tg,1
NC_037335.1,NC_032657.1,28485800,30225952,30225953,C,CG,1
NC_037335.1,NC_032657.1,28517304,30257436,30257437,a,ac,1
NC_037335.1,NC_032657.1,28555291,30295429,30295430,C,CG,1
NC_037335.1,NC_032657.1,28575035,30315193,30315194,G,GC,1
NC_037335.1,NC_032657.1,28641392,30382017,30382018,T,TW,1
NC_037335.1,NC_032657.1,28677395,30418021,30418032,t,tcttaatatata,11
NC_037335.1,NC_032657.1,28677431,30418068,30418079,a,ataataataatt,11
NC_037335.1,NC_032657.1,28700432,30441119,30441120,T,TA,1
NC_037335.1,NC_032657.1,28702519,30443213,30443214,g,ga,1
NC_037335.1,NC_032657.1,28702524,30443219,30443221,a,agt,2
NC_037335.1,NC_032657.1,28702657,30443354,30443355,t,ta,1
NC_037335.1,NC_032657.1,28703955,30444653,30444655,a,agt,2
NC_037335.1,NC_032657.1,28711503,30452210,30452211,A,AW,1
NC_037335.1,NC_032657.1,28733150,30475417,30475419,A,AAC,2
NC_037335.1,NC_032657.1,28785636,30528166,30528167,g,gc,1
NC_037335.1,NC_032657.1,28797450,30539748,30539749,C,CT,1
NC_037335.1,NC_032657.1,28806950,30549251,30549253,C,CAG,2
NC_037335.1,NC_032657.1,28813793,30556099,30556100,t,tY,1
NC_037335.1,NC_032657.1,28866836,30642794,30642795,C,CR,1
NC_037335.1,NC_032657.1,28880422,30656380,30656381,a,at,1
NC_037335.1,NC_032657.1,28897813,30673773,30673774,T,TG,1
NC_037335.1,NC_032657.1,28916285,30692249,30692251,g,gct,2
NC_037335.1,NC_032657.1,28951004,30726992,30726993,C,CY,1
NC_037335.1,NC_032657.1,28981757,30758214,30758215,C,CA,1
NC_037335.1,NC_032657.1,28982166,30758624,30758627,A,AGAC,3
NC_037335.1,NC_032657.1,28986805,30763264,30763265,t,tc,1
NC_037335.1,NC_032657.1,29009951,30786421,30786422,g,gt,1
NC_037335.1,NC_032657.1,29066775,30843929,30843930,a,ag,1
NC_037335.1,NC_032657.1,29067908,30845062,30845064,t,ttc,2
NC_037335.1,NC_032657.1,29078554,30855706,30855707,c,ct,1
NC_037335.1,NC_032657.1,29247354,31025892,31025893,g,gc,1
NC_037335.1,NC_032657.1,29247735,31026274,31026276,g,ggt,2
NC_037335.1,NC_032657.1,29402945,31184071,31184072,t,tK,1
NC_037335.1,NC_032657.1,29526409,31307258,31307259,g,ga,1
NC_037335.1,NC_032657.1,29526485,31307335,31307336,t,tg,1
NC_037335.1,NC_032657.1,29547216,31328036,31328037,a,ag,1
NC_037335.1,NC_032657.1,29610333,31391145,31391148,t,tgtg,3
NC_037335.1,NC_032657.1,29666938,31444634,31444636,C,CAA,2
NC_037335.1,NC_032657.1,29672969,31450657,31450658,G,GC,1
NC_037335.1,NC_032657.1,29681764,31459457,31459462,t,ttcagg,5
NC_037335.1,NC_032657.1,29683956,31461651,31461652,t,tY,1
NC_037335.1,NC_032657.1,29711535,31489235,31489236,t,ta,1
NC_037335.1,NC_032657.1,29724040,31501548,31501552,t,tcaca,4
NC_037335.1,NC_032657.1,29808698,31607417,31607419,C,CTG,2
NC_037335.1,NC_032657.1,29844164,31642205,31642206,A,AM,1
NC_037335.1,NC_032657.1,29946588,31743795,31743797,a,aac,2
NC_037335.1,NC_032657.1,29977934,31775142,31775143,a,ag,1
NC_037335.1,NC_032657.1,29994905,31792116,31792118,a,aat,2
NC_037335.1,NC_032657.1,30012874,31811193,31811194,g,gc,1
NC_037335.1,NC_032657.1,30072933,31873848,31873849,C,CT,1
NC_037335.1,NC_032657.1,30113013,31913940,31913944,c,ctatt,4
NC_037335.1,NC_032657.1,30184258,31984945,31984947,g,gta,2
NC_037335.1,NC_032657.1,30198255,31998950,31998953,t,tagc,3
NC_037335.1,NC_032657.1,30300522,32101614,32101615,G,GW,1
NC_037335.1,NC_032657.1,30361122,32165384,32165385,T,TA,1
NC_037335.1,NC_032657.1,30361231,32165494,32165496,t,tga,2
NC_037335.1,NC_032657.1,30368639,32172904,32172905,g,ga,1
NC_037335.1,NC_032657.1,30373952,32178065,32178070,t,taaaac,5
NC_037335.1,NC_032657.1,30375729,32179844,32179845,a,ac,1
NC_037335.1,NC_032657.1,30399872,32204177,32204179,G,GCT,2
NC_037335.1,NC_032657.1,30403019,32207326,32207327,C,CA,1
NC_037335.1,NC_032657.1,30417328,32221634,32221635,C,CT,1
NC_037335.1,NC_032657.1,30430881,32235258,32235259,c,ct,1
NC_037335.1,NC_032657.1,30433676,32238054,32238055,t,tg,1
NC_037335.1,NC_032657.1,30433827,32238206,32238231,t,taacaattataaatatatatgcaccc,25
NC_037335.1,NC_032657.1,30434161,32238565,32238575,a,aaaaaaaaaat,10
NC_037335.1,NC_032657.1,30457745,32278458,32278459,a,at,1
NC_037335.1,NC_032657.1,30493838,32320172,32320173,c,ct,1
NC_037335.1,NC_032657.1,30508420,32334756,32334757,C,CY,1
NC_037335.1,NC_032657.1,30511696,32338044,32338045,A,AG,1
NC_037335.1,NC_032657.1,30537797,32364145,32364146,A,AM,1
NC_037335.1,NC_032657.1,30627452,32453617,32453622,T,TGTGTN,5
NC_037335.1,NC_032657.1,30646718,32472916,32472924,a,aNNNNNNNN,8
NC_037335.1,NC_032657.1,30766063,32592299,32592301,T,TTG,2
NC_037335.1,NC_032657.1,30780001,32606239,32606240,t,ta,1
NC_037335.1,NC_032657.1,30789329,32615394,32615396,A,ATC,2
NC_037335.1,NC_032657.1,30792485,32619226,32619228,g,gtt,2
NC_037335.1,NC_032657.1,30853305,32680059,32680060,C,CT,1
NC_037335.1,NC_032657.1,30946786,32773348,32773352,a,aNNNN,4
NC_037335.1,NC_032657.1,30998377,32825397,32825398,C,CA,1
NC_037335.1,NC_032657.1,31046892,32873532,32873533,g,gc,1
NC_037335.1,NC_032657.1,31341099,33167693,33167694,a,at,1
NC_037335.1,NC_032657.1,31435224,33261164,33261171,T,TTAGGGAW,7
NC_037335.1,NC_032657.1,31438601,33264547,33264549,c,cta,2
NC_037335.1,NC_032657.1,31482649,33314183,33314184,a,ac,1
NC_037335.1,NC_032657.1,31519997,33350689,33350694,C,CAGTCA,5
NC_037335.1,NC_032657.1,31537823,33369456,33369457,a,aN,1
NC_037335.1,NC_032657.1,31557980,33389612,33389614,C,CTT,2
NC_037335.1,NC_032657.1,31631929,33473959,33473961,c,cta,2
NC_037335.1,NC_032657.1,31664432,33506287,33506288,C,CY,1
NC_037335.1,NC_032657.1,31665615,33507476,33507478,c,cta,2
NC_037335.1,NC_032657.1,31672658,33514539,33514540,T,TW,1
NC_037335.1,NC_032657.1,31672806,33514686,33514687,T,TW,1
NC_037335.1,NC_032657.1,31672992,33514870,33514871,T,TY,1
NC_037335.1,NC_032657.1,31673658,33515549,33515550,A,AR,1
NC_037335.1,NC_032657.1,31679661,33521568,33521569,T,TC,1
NC_037335.1,NC_032657.1,31680772,33522681,33522682,g,gc,1
NC_037335.1,NC_032657.1,31688264,33530171,33530173,a,aac,2
NC_037335.1,NC_032657.1,31716731,33558588,33558590,c,cct,2
NC_037335.1,NC_032657.1,31717304,33559163,33559167,t,tgata,4
NC_037335.1,NC_032657.1,31717758,33559621,33559622,g,gt,1
NC_037335.1,NC_032657.1,31719288,33561152,33561161,a,aactgaactg,9
NC_037335.1,NC_032657.1,31720934,33565328,33565348,g,gttcccttttctccacaccct,20
NC_037335.1,NC_032657.1,31721864,33566278,33566279,g,gt,1
NC_037335.1,NC_032657.1,31730578,33574994,33575000,T,TTATATC,6
NC_037335.1,NC_032657.1,31731048,33575470,33575473,A,ACTC,3
NC_037335.1,NC_032657.1,31734110,33578536,33578537,G,GK,1
NC_037335.1,NC_032657.1,31735058,33579483,33579484,A,AG,1
NC_037335.1,NC_032657.1,31754083,33598396,33598397,g,gt,1
NC_037335.1,NC_032657.1,31756821,33601131,33601132,g,gt,1
NC_037335.1,NC_032657.1,31758297,33602611,33602631,t,taaggagttcatgatctgaac,20
NC_037335.1,NC_032657.1,31783319,33628188,33628192,A,ACAAG,4
NC_037335.1,NC_032657.1,31828963,33673844,33673845,T,TA,1
NC_037335.1,NC_032657.1,31842495,33687492,33687495,C,CATT,3
NC_037335.1,NC_032657.1,31859340,33704346,33704347,c,ca,1
NC_037335.1,NC_032657.1,31873446,33718482,33718483,T,TC,1
NC_037335.1,NC_032657.1,31877538,33722571,33722574,a,acag,3
NC_037335.1,NC_032657.1,31880057,33725092,33725093,t,tg,1
NC_037335.1,NC_032657.1,31899303,33744350,33744351,g,gt,1
NC_037335.1,NC_032657.1,31905255,33750197,33750198,T,TY,1
NC_037335.1,NC_032657.1,32007890,33852934,33852935,c,ct,1
NC_037335.1,NC_032657.1,32008017,33853062,33853063,A,AC,1
NC_037335.1,NC_032657.1,32017572,33862628,33862630,c,ctt,2
NC_037335.1,NC_032657.1,32020154,33865212,33865213,G,GT,1
NC_037335.1,NC_032657.1,32022047,33867106,33867107,a,aM,1
NC_037335.1,NC_032657.1,32029003,33874061,33874062,t,ta,1
NC_037335.1,NC_032657.1,32049765,33894805,33894807,T,TAG,2
NC_037335.1,NC_032657.1,32115025,33966648,33966649,a,at,1
NC_037335.1,NC_032657.1,32118123,33969747,33969748,G,GA,1
NC_037335.1,NC_032657.1,32120195,33971821,33971824,C,CATG,3
NC_037335.1,NC_032657.1,32125960,33977589,33977590,a,at,1
NC_037335.1,NC_032657.1,32126335,33977966,33977967,t,ta,1
NC_037335.1,NC_032657.1,32166230,34017922,34017924,a,aNN,2
NC_037335.1,NC_032657.1,32174655,34026352,34026353,a,at,1
NC_037335.1,NC_032657.1,32181312,34033010,34033012,C,CTT,2
NC_037335.1,NC_032657.1,32182059,34033759,34033760,T,TG,1
NC_037335.1,NC_032657.1,32183154,34034856,34034857,a,ag,1
NC_037335.1,NC_032657.1,32289049,34140745,34140746,C,CA,1
NC_037335.1,NC_032657.1,32310152,34161851,34161855,g,gtgta,4
NC_037335.1,NC_032657.1,32323216,34174928,34174929,G,GR,1
NC_037335.1,NC_032657.1,32350665,34202377,34202378,T,TG,1
NC_037335.1,NC_032657.1,32536563,34394193,34394194,a,at,1
NC_037335.1,NC_032657.1,32539069,34396701,34396702,a,at,1
NC_037335.1,NC_032657.1,32541423,34399056,34399060,A,ATTCT,4
NC_037335.1,NC_032657.1,32564086,34421713,34421714,g,gt,1
NC_037335.1,NC_032657.1,32623323,34480961,34480962,t,ta,1
NC_037335.1,NC_032657.1,32661699,34519334,34519335,c,ca,1
NC_037335.1,NC_032657.1,32661752,34519389,34519390,c,ca,1
NC_037335.1,NC_032657.1,32682459,34540107,34540109,g,gtt,2
NC_037335.1,NC_032657.1,32692591,34550242,34550243,T,TA,1
NC_037335.1,NC_032657.1,32715861,34573513,34573514,T,TG,1
NC_037335.1,NC_032657.1,32778339,34636309,34636310,c,ca,1
NC_037335.1,NC_032657.1,32783115,34641085,34641091,t,tatNNNN,6
NC_037335.1,NC_032657.1,32787381,34645357,34645358,t,ta,1
NC_037335.1,NC_032657.1,32827782,34679699,34679700,t,tG,1
NC_037335.1,NC_032657.1,32860115,34712033,34712034,G,GR,1
NC_037335.1,NC_032657.1,32871149,34723074,34723078,t,tNNNN,4
NC_037335.1,NC_032657.1,32900047,34751968,34751969,G,GA,1
NC_037335.1,NC_032657.1,32902039,34753961,34753970,g,gggaaacagt,9
NC_037335.1,NC_032657.1,32965341,34820967,34820969,c,cat,2
NC_037335.1,NC_032657.1,32968658,34824286,34824287,A,AW,1
NC_037335.1,NC_032657.1,32972540,34828168,34828169,t,ta,1
NC_037335.1,NC_032657.1,32985799,34842984,34842985,c,ct,1
NC_037335.1,NC_032657.1,32997745,34854931,34854932,c,ct,1
NC_037335.1,NC_032657.1,33034625,34891786,34891787,c,cg,1
NC_037335.1,NC_032657.1,33168279,35025256,35025257,t,ta,1
NC_037335.1,NC_032657.1,33168315,35025292,35025293,T,TA,1
NC_037335.1,NC_032657.1,33168396,35025375,35025376,t,tc,1
NC_037335.1,NC_032657.1,33168407,35025387,35025388,t,tg,1
NC_037335.1,NC_032657.1,33250205,35109677,35109678,a,ac,1
NC_037335.1,NC_032657.1,33304211,35163743,35163744,a,ac,1
NC_037335.1,NC_032657.1,33371369,35248590,35248591,t,tc,1
NC_037335.1,NC_032657.1,33373125,35250333,35250334,a,at,1
NC_037335.1,NC_032657.1,33373598,35250807,35250811,A,ACAGT,4
NC_037335.1,NC_032657.1,33374070,35251283,35251287,C,CCAGT,4
NC_037335.1,NC_032657.1,33384182,35259461,35259462,a,at,1
NC_037335.1,NC_032657.1,33384443,35259724,35259725,C,CY,1
NC_037335.1,NC_032657.1,33389431,35264715,35264727,A,ARCTCAACTTGGT,12
NC_037335.1,NC_032657.1,33407345,35282611,35282612,T,TG,1
NC_037335.1,NC_032657.1,33488744,35352303,35352305,g,gaa,2
NC_037335.1,NC_032657.1,33577922,35456130,35456131,T,TN,1
NC_037335.1,NC_032657.1,33612451,35490685,35490686,g,ga,1
NC_037335.1,NC_032657.1,33630577,35508522,35508523,T,TC,1
NC_037335.1,NC_032657.1,33658193,35536154,35536157,c,ccca,3
NC_037335.1,NC_032657.1,33671252,35549220,35549222,T,TGW,2
NC_037335.1,NC_032657.1,33686662,35565017,35565019,a,aat,2
NC_037335.1,NC_032657.1,33712237,35590604,35590608,A,AGAGC,4
NC_037335.1,NC_032657.1,33750751,35629121,35629122,G,GC,1
NC_037335.1,NC_032657.1,33799963,35678340,35678341,g,gt,1
NC_037335.1,NC_032657.1,33801469,35679847,35679862,t,tgctctgattgctgtg,15
NC_037335.1,NC_032657.1,33814613,35693009,35693010,A,AC,1
NC_037335.1,NC_032657.1,33814613,35717624,35717625,A,AC,1
NC_037335.1,NC_032657.1,33820591,35698950,35698955,T,TATCAA,5
NC_037335.1,NC_032657.1,33820591,35723597,35723602,T,TATCAA,5
NC_037335.1,NC_032657.1,33834448,35738344,35738345,G,GA,1
NC_037335.1,NC_032657.1,33897767,35801854,35801856,t,tac,2
NC_037335.1,NC_032657.1,34089376,35993527,35993529,T,TTC,2
NC_037335.1,NC_032657.1,34100050,36004930,36004931,c,cg,1
NC_037335.1,NC_032657.1,34107721,36012606,36012607,t,ta,1
NC_037335.1,NC_032657.1,34137778,36042748,36042750,a,aNN,2
NC_037335.1,NC_032657.1,34146626,36051598,36051599,a,ag,1
NC_037335.1,NC_032657.1,34155011,36059985,36059986,a,aW,1
NC_037335.1,NC_032657.1,34253952,36159236,36159237,C,CA,1
NC_037335.1,NC_032657.1,34273384,36175954,36175955,A,AT,1
NC_037335.1,NC_032657.1,34358929,36261002,36261003,A,AC,1
NC_037335.1,NC_032657.1,34457914,36412490,36412500,g,gactgaactga,10
NC_037335.1,NC_032657.1,34458195,36412781,36412787,t,tacacac,6
NC_037335.1,NC_032657.1,34463587,36419579,36419588,C,CACAATTGTT,9
NC_037335.1,NC_032657.1,34483144,36438994,36438995,c,cg,1
NC_037335.1,NC_032657.1,34566865,36522077,36522078,g,gt,1
NC_037335.1,NC_032657.1,34578100,36533316,36533317,g,ga,1
NC_037335.1,NC_032657.1,34580406,36535622,36535625,G,GAAC,3
NC_037335.1,NC_032657.1,34582791,36538010,36538011,c,ct,1
NC_037335.1,NC_032657.1,34606417,36561651,36561652,T,TC,1
NC_037335.1,NC_032657.1,34608301,36563536,36563537,t,ta,1
NC_037335.1,NC_032657.1,34627864,36583133,36583134,A,AG,1
NC_037335.1,NC_032657.1,34633809,36589101,36589107,T,TGGCAGA,6
NC_037335.1,NC_032657.1,34697811,36653088,36653091,g,gttt,3
NC_037335.1,NC_032657.1,34706320,36661625,36661626,A,AG,1
NC_037335.1,NC_032657.1,34712443,36667750,36667753,c,cctt,3
NC_037335.1,NC_032657.1,34712457,36667767,36667769,c,cga,2
NC_037335.1,NC_032657.1,34715626,36670938,36670939,C,CY,1
NC_037335.1,NC_032657.1,34716088,36671401,36671402,a,at,1
NC_037335.1,NC_032657.1,34718587,36673915,36673917,t,tca,2
NC_037335.1,NC_032657.1,34742049,36702549,36702550,a,ag,1
NC_037335.1,NC_032657.1,34763472,36723985,36723986,A,AT,1
NC_037335.1,NC_032657.1,34770413,36730947,36730948,A,AG,1
NC_037335.1,NC_032657.1,34807176,36762436,36762437,C,CT,1
NC_037335.1,NC_032657.1,34817850,36773723,36773724,a,ag,1
NC_037335.1,NC_032657.1,34819030,36774904,36774905,c,ct,1
NC_037335.1,NC_032657.1,34826040,36781918,36781919,C,CT,1
NC_037335.1,NC_032657.1,34827931,36783816,36783817,a,at,1
NC_037335.1,NC_032657.1,34837177,36792936,36792947,t,tgagatgagtgc,11
NC_037335.1,NC_032657.1,34845022,36800789,36800798,g,gaaacagtgt,9
NC_037335.1,NC_032657.1,34847848,36803618,36803619,t,tc,1
NC_037335.1,NC_032657.1,34851741,36807515,36807517,t,taa,2
NC_037335.1,NC_032657.1,34953872,36908988,36909022,G,GGATTACTATCCCAGGTATTTGCTTCACTAGAAAA,34
NC_037335.1,NC_032657.1,34998072,36950744,36950745,T,TW,1
NC_037335.1,NC_032657.1,35011934,36965654,36965661,a,accctcct,7
NC_037335.1,NC_032657.1,35038998,36992723,36992730,c,caaaaaaa,7
NC_037335.1,NC_032657.1,35054004,37007736,37007737,t,ta,1
NC_037335.1,NC_032657.1,35133630,37087840,37087841,t,tc,1
NC_037335.1,NC_032657.1,35174003,37128223,37128227,t,ttttc,4
NC_037335.1,NC_032657.1,35179521,37133757,37133767,g,gagttcagtcc,10
NC_037335.1,NC_032657.1,35180495,37134741,37134742,t,tc,1
NC_037335.1,NC_032657.1,35184490,37138737,37138741,A,ATGTM,4
NC_037335.1,NC_032657.1,35184606,37138847,37138849,C,CTT,2
NC_037335.1,NC_032657.1,35189488,37143732,37143733,A,AT,1
NC_037335.1,NC_032657.1,35201714,37155949,37155950,C,CT,1
NC_037335.1,NC_032657.1,35202855,37157091,37157092,T,TY,1
NC_037335.1,NC_032657.1,35207205,37161454,37161455,A,AT,1
NC_037335.1,NC_032657.1,35213198,37167447,37167448,t,ta,1
NC_037335.1,NC_032657.1,35236343,37190608,37190609,C,CA,1
NC_037335.1,NC_032657.1,35261045,37215318,37215319,a,at,1
NC_037335.1,NC_032657.1,35264393,37218667,37218668,g,ga,1
NC_037335.1,NC_032657.1,35332587,37286873,37286874,c,ct,1
NC_037335.1,NC_032657.1,35344758,37299048,37299051,t,tgaa,3
NC_037335.1,NC_032657.1,35352078,37306371,37306373,t,taa,2
NC_037335.1,NC_032657.1,35352309,37306604,37306605,g,gc,1
NC_037335.1,NC_032657.1,35447768,37441797,37441799,T,TTA,2
NC_037335.1,NC_032657.1,35451230,37445261,37445263,a,att,2
NC_037335.1,NC_032657.1,35453913,37447946,37447947,a,ag,1
NC_037335.1,NC_032657.1,35476545,37470583,37470584,t,tc,1
NC_037335.1,NC_032657.1,35520136,37515321,37515322,c,ct,1
NC_037335.1,NC_032657.1,35527659,37522856,37522858,a,aat,2
NC_037335.1,NC_032657.1,35648150,37643700,37643709,t,tgaggaaaca,9
NC_037335.1,NC_032657.1,35680697,37713757,37713761,T,TTCCG,4
NC_037335.1,NC_032657.1,35863402,37897172,37897173,c,ca,1
NC_037335.1,NC_032657.1,35875448,37909228,37909229,a,ac,1
NC_037335.1,NC_032657.1,35924052,37957831,37957832,t,ta,1
NC_037335.1,NC_032657.1,35981031,38024310,38024311,A,AM,1
NC_037335.1,NC_032657.1,36007734,38051024,38051026,G,GAT,2
NC_037335.1,NC_032657.1,36015032,38058328,38058331,t,tttc,3
NC_037335.1,NC_032657.1,36038388,38081672,38081675,A,ATAG,3
NC_037335.1,NC_032657.1,36293582,38335069,38335070,G,GA,1
NC_037335.1,NC_032657.1,36293591,38335077,38335078,G,GA,1
NC_037335.1,NC_032657.1,36329121,38370367,38370369,a,agt,2
NC_037335.1,NC_032657.1,36478443,38519706,38519707,A,AM,1
NC_037335.1,NC_032657.1,36663156,38704494,38704495,T,TC,1
NC_037335.1,NC_032657.1,36666668,38708639,38708640,g,gt,1
NC_037335.1,NC_032657.1,36667105,38709077,38709078,G,GT,1
NC_037335.1,NC_032657.1,36668328,38710303,38710305,T,TTC,2
NC_037335.1,NC_032657.1,36725340,38767151,38767152,a,ac,1
NC_037335.1,NC_032657.1,36733998,38775809,38775813,t,tNNNN,4
NC_037335.1,NC_032657.1,36741521,38783341,38783343,t,tNN,2
NC_037335.1,NC_032657.1,36791715,38833876,38833882,c,cgAAAAT,6
NC_037335.1,NC_032657.1,36829531,38871712,38871714,T,TTA,2
NC_037335.1,NC_032657.1,36835950,38878133,38878135,t,taa,2
NC_037335.1,NC_032657.1,36841096,38883367,38883368,G,GR,1
NC_037335.1,NC_032657.1,36846457,38888764,38888765,a,ag,1
NC_037335.1,NC_032657.1,36873329,38917092,38917101,t,ttttttttAN,9
NC_037335.1,NC_032657.1,36878164,38921952,38921954,T,TTA,2
NC_037335.1,NC_032657.1,36886302,38930097,38930098,a,ac,1
NC_037335.1,NC_032657.1,36905215,38949032,38949033,G,GR,1
NC_037335.1,NC_032657.1,36917011,38960829,38960830,g,ga,1
NC_037335.1,NC_032657.1,36932055,38975878,38975879,t,ta,1
NC_037335.1,NC_032657.1,36948749,38992461,38992464,T,TTTA,3
NC_037335.1,NC_032657.1,36949506,38993219,38993220,G,GC,1
NC_037335.1,NC_032657.1,36959832,39004107,39004108,G,GA,1
NC_037335.1,NC_032657.1,36967611,39011630,39011633,g,gcca,3
NC_037335.1,NC_032657.1,36969076,39013089,39013091,a,aat,2
NC_037335.1,NC_032657.1,36987350,39031377,39031378,a,at,1
NC_037335.1,NC_032657.1,36995252,39039197,39039198,T,TY,1
NC_037335.1,NC_032657.1,36998707,39042656,39042657,C,CY,1
NC_037335.1,NC_032657.1,37000164,39044113,39044114,t,tY,1
NC_037335.1,NC_032657.1,37056660,39100619,39100620,A,AG,1
NC_037335.1,NC_032657.1,37093398,39137200,39137220,C,CCAGCTNNNNNNNNNNNNNNN,20
NC_037335.1,NC_032657.1,37211043,39254031,39254032,t,ta,1
NC_037335.1,NC_032657.1,37310977,39373500,39373501,g,gc,1
NC_037335.1,NC_032657.1,37319083,39381607,39381614,a,accctcct,7
NC_037335.1,NC_032657.1,37320183,39382714,39382716,c,cag,2
NC_037335.1,NC_032657.1,37370838,39433523,39433524,t,tc,1
NC_037335.1,NC_032657.1,37387728,39450415,39450416,t,ta,1
NC_037335.1,NC_032657.1,37410461,39482114,39482116,C,CTT,2
NC_037335.1,NC_032657.1,37422074,39493731,39493734,t,tctc,3
NC_037335.1,NC_032657.1,37452014,39523621,39523622,A,AC,1
NC_037335.1,NC_032657.1,37454478,39526085,39526086,a,at,1
NC_037335.1,NC_032657.1,37466342,39537994,39537996,a,atg,2
NC_037335.1,NC_032657.1,37536827,39614206,39614207,A,AM,1
NC_037335.1,NC_032657.1,37639094,39721742,39721743,A,AC,1
NC_037335.1,NC_032657.1,37832090,39914733,39914736,T,TTAA,3
NC_037335.1,NC_032657.1,37833001,39915643,39915644,C,CA,1
NC_037335.1,NC_032657.1,38002713,40085234,40085235,G,GC,1
NC_037335.1,NC_032657.1,38160615,40271365,40271366,g,gc,1
NC_037335.1,NC_032657.1,38232611,40343598,40343599,G,GA,1
NC_037335.1,NC_032657.1,38254124,40365143,40365144,t,tc,1
NC_037335.1,NC_032657.1,38327690,40438355,40438356,C,CT,1
NC_037335.1,NC_032657.1,38327717,40438383,40438384,T,TA,1
NC_037335.1,NC_032657.1,38327728,40438395,40438396,C,CM,1
NC_037335.1,NC_032657.1,38499566,40663839,40663845,t,tttcttg,6
NC_037335.1,NC_032657.1,38499616,40663895,40663897,c,ctt,2
NC_037335.1,NC_032657.1,38501311,40666064,40666066,t,taa,2
NC_037335.1,NC_032657.1,38501505,40666260,40666261,t,ta,1
NC_037335.1,NC_032657.1,38527166,40691503,40691504,a,at,1
NC_037335.1,NC_032657.1,38527202,40691540,40691541,a,at,1
NC_037335.1,NC_032657.1,38529068,40695026,40695027,t,tc,1
NC_037335.1,NC_032657.1,38619700,40786787,40786788,A,AC,1
NC_037335.1,NC_032657.1,38619702,40786790,40786791,C,CT,1
NC_037335.1,NC_032657.1,39058042,41225171,41225172,c,cg,1
NC_037335.1,NC_032657.1,39058077,41225207,41225208,c,ca,1
NC_037335.1,NC_032657.1,39099004,41266060,41266063,t,ttga,3
NC_037335.1,NC_032657.1,39246442,41413368,41413369,T,TC,1
NC_037335.1,NC_032657.1,39480564,41651557,41651569,T,TNNNNNNNNNNNN,12
NC_037335.1,NC_032657.1,39558007,41767790,41767793,a,actt,3
NC_037335.1,NC_032657.1,39727640,41937427,41937429,a,agc,2
NC_037335.1,NC_032657.1,39796703,42001130,42001131,T,TW,1
NC_037335.1,NC_032657.1,39869815,42074417,42074418,t,ta,1
NC_037335.1,NC_032657.1,40132015,42336626,42336627,a,at,1
NC_037335.1,NC_032657.1,40145018,42349630,42349631,G,GA,1
NC_037335.1,NC_032657.1,40193652,42398397,42398398,G,GA,1
NC_037335.1,NC_032657.1,40195257,42400003,42400004,g,gK,1
NC_037335.1,NC_032657.1,40233150,42437898,42437899,A,AK,1
NC_037335.1,NC_032657.1,40233173,42437922,42437923,G,GT,1
NC_037335.1,NC_032657.1,40362119,42566922,42566923,t,tc,1
NC_037335.1,NC_032657.1,40362998,42567802,42567804,C,CTA,2
NC_037335.1,NC_032657.1,40378318,42583152,42583153,C,CA,1
NC_037335.1,NC_032657.1,40387610,42592443,42592444,t,ta,1
NC_037335.1,NC_032657.1,40387948,42592782,42592784,g,gat,2
NC_037335.1,NC_032657.1,40387948,42654310,42654312,g,gat,2
NC_037335.1,NC_032657.1,40388770,42655134,42655135,t,ta,1
NC_037335.1,NC_032657.1,40397400,42602230,42602231,C,CA,1
NC_037335.1,NC_032657.1,40397400,42663761,42663762,C,CA,1
NC_037335.1,NC_032657.1,40421505,42626335,42626338,a,aaat,3
NC_037335.1,NC_032657.1,40421505,42687866,42687869,a,aaat,3
NC_037335.1,NC_032657.1,40445736,42712100,42712101,g,gc,1
NC_037335.1,NC_032657.1,40465317,42731684,42731685,G,GR,1
NC_037335.1,NC_032657.1,40467723,42734091,42734092,C,CY,1
NC_037335.1,NC_032657.1,40525712,42792078,42792079,t,ta,1
NC_037335.1,NC_032657.1,40533042,42799407,42799411,g,ggttt,4
NC_037335.1,NC_032657.1,40567449,42833939,42833940,t,tg,1
NC_037335.1,NC_032657.1,40680839,42946987,42946990,T,TATC,3
NC_037335.1,NC_032657.1,40706927,42973072,42973073,C,CA,1
NC_037335.1,NC_032657.1,40733360,42999619,42999639,A,ACTCCTGAAGGCATTGTTTGR,20
NC_037335.1,NC_032657.1,40756103,43022419,43022420,C,CA,1
NC_037335.1,NC_032657.1,40769358,43035675,43035680,G,GGGAAA,5
NC_037335.1,NC_032657.1,40778085,43044410,43044411,c,ca,1
NC_037335.1,NC_032657.1,40782758,43049085,43049086,T,TC,1
NC_037335.1,NC_032657.1,40804967,43071292,43071311,T,TCACATCTTCACTGTGATGA,19
NC_037335.1,NC_032657.1,40805044,43071388,43071389,A,AY,1
NC_037335.1,NC_032657.1,40809109,43075444,43075445,T,TW,1
NC_037335.1,NC_032657.1,40812134,43078470,43078471,c,ct,1
NC_037335.1,NC_032657.1,40836682,43102491,43102492,C,CT,1
NC_037335.1,NC_032657.1,40878166,43144033,43144034,C,CY,1
NC_037335.1,NC_032657.1,40900287,43166159,43166161,c,cat,2
NC_037335.1,NC_032657.1,40905935,43171809,43171810,C,CY,1
NC_037335.1,NC_032657.1,40912094,43177970,43177971,g,ga,1
NC_037335.1,NC_032657.1,40931252,43197131,43197132,g,ga,1
NC_037335.1,NC_032657.1,40932057,43197935,43197939,g,gctgc,4
NC_037335.1,NC_032657.1,40932714,43198596,43198602,t,tagtagc,6
NC_037335.1,NC_032657.1,40933171,43199059,43199060,g,gc,1
NC_037335.1,NC_032657.1,40933180,43199069,43199070,a,ac,1
NC_037335.1,NC_032657.1,40983049,43249025,43249026,C,CT,1
NC_037335.1,NC_032657.1,40995174,43261115,43261116,T,TA,1
NC_037335.1,NC_032657.1,40995192,43261134,43261135,A,AC,1
NC_037335.1,NC_032657.1,40996405,43262349,43262353,G,GAAGT,4
NC_037335.1,NC_032657.1,40996989,43262937,43262938,A,AC,1
NC_037335.1,NC_032657.1,41025895,43291872,43291878,G,GAATTTC,6
NC_037335.1,NC_032657.1,41175874,43369475,43369476,A,AC,1
NC_037335.1,NC_032657.1,41194269,43462811,43462812,T,TA,1
NC_037335.1,NC_032657.1,41194309,43462852,43462853,T,TW,1
NC_037335.1,NC_032657.1,41194320,43462864,43462866,A,AAT,2
NC_037335.1,NC_032657.1,41194327,43462873,43462874,a,ag,1
NC_037335.1,NC_032657.1,41316077,43584708,43584709,t,ta,1
NC_037335.1,NC_032657.1,41332804,43601209,43601210,A,AG,1
NC_037335.1,NC_032657.1,41351479,43619889,43619891,t,tcc,2
NC_037335.1,NC_032657.1,41357587,43625998,43625999,g,gt,1
NC_037335.1,NC_032657.1,41421966,43690054,43690056,C,CAA,2
NC_037335.1,NC_032657.1,41465836,43733942,43733944,t,tga,2
NC_037335.1,NC_032657.1,41468670,43736778,43736780,a,act,2
NC_037335.1,NC_032657.1,41542057,43810006,43810007,A,AG,1
NC_037335.1,NC_032657.1,41635279,43920359,43920360,t,tW,1
NC_037335.1,NC_032657.1,41651711,43936792,43936793,A,AR,1
NC_037335.1,NC_032657.1,41668434,43953517,43953518,T,TA,1
NC_037335.1,NC_032657.1,41698247,43983003,43983005,C,CAT,2
NC_037335.1,NC_032657.1,41700026,43984784,43984785,C,CY,1
NC_037335.1,NC_032657.1,41704169,43988957,43988965,a,aggaatacW,8
NC_037335.1,NC_032657.1,41728400,44013195,44013196,T,TC,1
NC_037335.1,NC_032657.1,41730673,44015469,44015472,T,TCTG,3
NC_037335.1,NC_032657.1,42153629,44375863,44375864,g,gt,1
NC_037335.1,NC_032657.1,42153660,44375895,44375896,c,ct,1
NC_037335.1,NC_032657.1,42177481,44399730,44399752,C,CAGGGAGTTGTGGGTGGGAAARY,22
NC_037335.1,NC_032657.1,42190406,44412398,44412399,g,gt,1
NC_037335.1,NC_032657.1,42209845,44431742,44431744,c,cct,2
NC_037335.1,NC_032657.1,42219356,44441260,44441261,t,ta,1
NC_037335.1,NC_032657.1,42219583,44441488,44441489,t,ta,1
NC_037335.1,NC_032657.1,42240546,44479357,44479359,T,TAG,2
NC_037335.1,NC_032657.1,42245868,44484681,44484682,T,TA,1
NC_037335.1,NC_032657.1,42249410,44488218,44488225,C,CATCACAA,7
NC_037335.1,NC_032657.1,42294510,44536265,44536266,g,ga,1
NC_037335.1,NC_032657.1,42334400,44576162,44576163,c,ca,1
NC_037335.1,NC_032657.1,42337380,44579144,44579148,t,tNNNN,4
NC_037335.1,NC_032657.1,42357775,44446982,44446983,a,ac,1
NC_037335.1,NC_032657.1,42383483,44628415,44628417,C,CTA,2
NC_037335.1,NC_032657.1,42445988,44690942,44690945,t,tagc,3
NC_037335.1,NC_032657.1,42836893,44907386,44907387,T,TC,1
NC_037335.1,NC_032657.1,42881616,44952114,44952116,A,AAG,2
NC_037335.1,NC_032657.1,42907386,44977896,44977897,T,TG,1
NC_037335.1,NC_032657.1,42921393,44991939,44991940,g,ga,1
NC_037335.1,NC_032657.1,42927927,44998473,44998474,a,at,1
NC_037335.1,NC_032657.1,42938668,45009649,45009658,G,GGCTGCTATA,9
NC_037335.1,NC_032657.1,42941116,45012106,45012122,C,CAGGCTGAATCTCTTCA,16
NC_037335.1,NC_032657.1,42943203,45014207,45014208,T,TA,1
NC_037335.1,NC_032657.1,42953360,45024350,45024355,g,gaactK,5
NC_037335.1,NC_032657.1,42953745,45024740,45024741,t,tc,1
NC_037335.1,NC_032657.1,42960911,45031902,45031903,t,ta,1
NC_037335.1,NC_032657.1,42961113,45032105,45032106,G,GR,1
NC_037335.1,NC_032657.1,42962925,45035983,45035984,t,tc,1
NC_037335.1,NC_032657.1,43106845,45167670,45167672,a,aNN,2
NC_037335.1,NC_032657.1,43194344,45256037,45256039,a,aNN,2
NC_037335.1,NC_032657.1,43207349,45269044,45269045,G,GK,1
NC_037335.1,NC_032657.1,43218056,45280892,45280894,T,TCC,2
NC_037335.1,NC_032657.1,43218061,45280899,45280900,T,TA,1
NC_037335.1,NC_032657.1,43218063,45280902,45280904,A,AGC,2
NC_037335.1,NC_032657.1,43236116,45298957,45298958,g,gt,1
NC_037335.1,NC_032657.1,43293390,45358095,45358102,a,accctcct,7
NC_037335.1,NC_032657.1,43373075,45419884,45419885,a,at,1
NC_037335.1,NC_032657.1,43393413,45440223,45440247,A,ANNNNNNNNNNNNNNNNNNNNNNNN,24
NC_037335.1,NC_032657.1,43492987,45611661,45611662,G,GR,1
NC_037335.1,NC_032657.1,43493097,45611772,45611773,C,CT,1
NC_037335.1,NC_032657.1,43502939,45654293,45654296,C,CAAG,3
NC_037335.1,NC_032657.1,43651486,45802590,45802591,C,CA,1
NC_037335.1,NC_032657.1,43838463,45975102,45975103,t,tc,1
NC_037335.1,NC_032657.1,43927664,46103593,46103602,A,ACTGCTGCAT,9
NC_037335.1,NC_032657.1,43932438,46108379,46108380,g,ga,1
NC_037335.1,NC_032657.1,43970334,46146280,46146281,G,GR,1
NC_037335.1,NC_032657.1,43973458,46149394,46149399,t,tttaaa,5
NC_037335.1,NC_032657.1,43996575,46172603,46172605,a,act,2
NC_037335.1,NC_032657.1,43996699,46172729,46172730,t,ta,1
NC_037335.1,NC_032657.1,43996752,46172783,46172784,c,ca,1
NC_037335.1,NC_032657.1,44000263,46176293,46176297,a,aaccc,4
NC_037335.1,NC_032657.1,44008800,46184838,46184839,g,gt,1
NC_037335.1,NC_032657.1,44013991,46190030,46190034,c,cacaa,4
NC_037335.1,NC_032657.1,44126577,46302619,46302620,g,gc,1
NC_037335.1,NC_032657.1,44148400,46324444,46324446,C,CCG,2
NC_037335.1,NC_032657.1,44243937,46419986,46419987,a,ac,1
NC_037335.1,NC_032657.1,44265727,46441777,46441778,c,ca,1
NC_037335.1,NC_032657.1,44304193,46554623,46554624,t,tN,1
NC_037335.1,NC_032657.1,44310268,46486321,46486322,t,ta,1
NC_037335.1,NC_032657.1,44310268,46560699,46560700,t,ta,1
NC_037335.1,NC_032657.1,44312910,46488964,46488965,T,TN,1
NC_037335.1,NC_032657.1,44322322,46572756,46572767,t,taaaaaaaaaaa,11
NC_037335.1,NC_032657.1,44386800,46636517,46636518,T,TC,1
NC_037335.1,NC_032657.1,44555481,46887502,46887503,T,TY,1
NC_037335.1,NC_032657.1,44574449,46908706,46908707,t,ta,1
NC_037335.1,NC_032657.1,44574529,46908787,46908788,a,ag,1
NC_037335.1,NC_032657.1,44588682,46922945,46922946,T,TW,1
NC_037335.1,NC_032657.1,44763735,47078066,47078067,a,ac,1
NC_037335.1,NC_032657.1,44772111,47086443,47086447,a,atatR,4
NC_037335.1,NC_032657.1,44798436,47112681,47112683,A,AAG,2
NC_037335.1,NC_032657.1,44852177,47166466,47166469,T,TTTC,3
NC_037335.1,NC_032657.1,44924776,47239090,47239108,a,attttgccctttcatactg,18
NC_037335.1,NC_032657.1,44949036,47263328,47263329,T,TC,1
NC_037335.1,NC_032657.1,44964971,47279498,47279499,A,AR,1
NC_037335.1,NC_032657.1,44980733,47295850,47295854,t,ttaaa,4
NC_037335.1,NC_032657.1,44980791,47295912,47295916,a,aatac,4
NC_037335.1,NC_032657.1,45068234,47383578,47383580,T,TAA,2
NC_037335.1,NC_032657.1,45119164,47433272,47433273,t,ta,1
NC_037335.1,NC_032657.1,45119796,47433905,47433909,A,AGATR,4
NC_037335.1,NC_032657.1,45161031,47475149,47475150,G,GA,1
NC_037335.1,NC_032657.1,45181494,47495417,47495418,t,ta,1
NC_037335.1,NC_032657.1,45209106,47524865,47524910,g,gcacgactgaagcgacttagcagcagcagcagcagaatgaagaTCT,45
NC_037335.1,NC_032657.1,45225297,47541103,47541104,t,tg,1
NC_037335.1,NC_032657.1,45227800,47543455,47543458,G,GTTR,3
NC_037335.1,NC_032657.1,45228239,47543897,47543898,C,CT,1
NC_037335.1,NC_032657.1,45249362,47565117,47565119,c,ctt,2
NC_037335.1,NC_032657.1,45268191,47583950,47583953,a,acat,3
NC_037335.1,NC_032657.1,45295492,47611248,47611249,A,AR,1
NC_037335.1,NC_032657.1,45301628,47617399,47617401,a,aat,2
NC_037335.1,NC_032657.1,45354111,47670257,47670258,t,ta,1
NC_037335.1,NC_032657.1,45355582,47671729,47671730,g,ga,1
NC_037335.1,NC_032657.1,45379702,47695854,47695855,C,CA,1
NC_037335.1,NC_032657.1,45405991,47722148,47722149,A,AR,1
NC_037335.1,NC_032657.1,45406026,47722184,47722186,C,CAT,2
NC_037335.1,NC_032657.1,45408396,47724557,47724558,A,AM,1
NC_037335.1,NC_032657.1,45420105,47736270,47736271,t,tc,1
NC_037335.1,NC_032657.1,45446818,47764706,47764707,G,GA,1
NC_037335.1,NC_032657.1,45465759,47783286,47783287,G,GA,1
NC_037335.1,NC_032657.1,45546898,47864530,47864531,c,ct,1
NC_037335.1,NC_032657.1,45584648,47902291,47902300,T,TCCTAAAAGA,9
NC_037335.1,NC_032657.1,45586634,47904286,47904288,A,AAC,2
NC_037335.1,NC_032657.1,45604315,47921971,47921972,a,ag,1
NC_037335.1,NC_032657.1,45632670,47950329,47950330,a,at,1
NC_037335.1,NC_032657.1,45658394,47976061,47976062,A,AG,1
NC_037335.1,NC_032657.1,45748923,48066628,48066629,G,GR,1
NC_037335.1,NC_032657.1,45822048,48139774,48139775,t,ta,1
NC_037335.1,NC_032657.1,45840965,48158687,48158694,c,ctttcact,7
NC_037335.1,NC_032657.1,46099269,48320991,48320994,T,TGTC,3
NC_037335.1,NC_032657.1,46111939,48333641,48333644,T,TATA,3
NC_037335.1,NC_032657.1,46154029,48375602,48375603,A,AR,1
NC_037335.1,NC_032657.1,46387122,48644585,48644586,A,AN,1
NC_037335.1,NC_032657.1,46387654,48645118,48645120,a,agg,2
NC_037335.1,NC_032657.1,46511076,48759232,48759233,t,ta,1
NC_037335.1,NC_032657.1,46549907,48797141,48797146,c,cgactg,5
NC_037335.1,NC_032657.1,46591947,48826287,48826290,t,taaa,3
NC_037335.1,NC_032657.1,46607039,48841381,48841383,C,CCA,2
NC_037335.1,NC_032657.1,46616858,48851204,48851210,A,AACAGGG,6
NC_037335.1,NC_032657.1,46771249,49093843,49093845,c,cct,2
NC_037335.1,NC_032657.1,46811024,49133670,49133671,T,TY,1
NC_037335.1,NC_032657.1,46822511,49145158,49145161,C,CGTG,3
NC_037335.1,NC_032657.1,46839084,49161736,49161737,T,TC,1
NC_037335.1,NC_032657.1,46841258,49163914,49163918,T,TAATC,4
NC_037335.1,NC_032657.1,46852558,49175640,49175641,a,at,1
NC_037335.1,NC_032657.1,46859167,49182288,49182289,t,ta,1
NC_037335.1,NC_032657.1,46864040,49187164,49187165,t,ta,1
NC_037335.1,NC_032657.1,46926410,49242728,49242751,a,atgtaaaatatcatgtaataaacg,23
NC_037335.1,NC_032657.1,46948196,49265461,49265463,t,ttc,2
NC_037335.1,NC_032657.1,46954657,49271922,49271924,c,cag,2
NC_037335.1,NC_032657.1,46958544,49275806,49275807,T,TG,1
NC_037335.1,NC_032657.1,46974510,49291769,49291773,a,atttt,4
NC_037335.1,NC_032657.1,46975651,49292915,49292916,G,GS,1
NC_037335.1,NC_032657.1,47090879,49407892,49407893,A,AM,1
NC_037335.1,NC_032657.1,47240799,49558054,49558056,A,AAC,2
NC_037335.1,NC_032657.1,47240907,49558164,49558165,T,TG,1
NC_037335.1,NC_032657.1,47259779,49577039,49577040,T,TC,1
NC_037335.1,NC_032657.1,47295572,49612827,49612830,g,gaac,3
NC_037335.1,NC_032657.1,47343504,49660740,49660741,A,AG,1
NC_037335.1,NC_032657.1,47346681,49663922,49663923,G,GC,1
NC_037335.1,NC_032657.1,47353281,49670511,49670512,a,ag,1
NC_037335.1,NC_032657.1,47390901,49720439,49720443,C,CTGGG,4
NC_037335.1,NC_032657.1,47442089,49774847,49774848,T,TW,1
NC_037335.1,NC_032657.1,47445222,49778008,49778009,t,tg,1
NC_037335.1,NC_032657.1,47459353,49792281,49792282,G,GT,1
NC_037335.1,NC_032657.1,47459953,49792882,49792883,c,ca,1
NC_037335.1,NC_032657.1,47493379,49826319,49826328,g,gggaaacagt,9
NC_037335.1,NC_032657.1,47495542,49828492,49828494,T,TCA,2
NC_037335.1,NC_032657.1,47496974,49829925,49829926,G,GC,1
NC_037335.1,NC_032657.1,47503220,49836158,49836160,C,CTT,2
NC_037335.1,NC_032657.1,47511173,49844106,49844107,C,CK,1
NC_037335.1,NC_032657.1,47652256,49984853,49984856,a,attt,3
NC_037335.1,NC_032657.1,47668269,50000869,50000870,c,ct,1
NC_037335.1,NC_032657.1,47758882,50090809,50090823,G,GGTGTAGCCATGCCC,14
NC_037335.1,NC_032657.1,47759208,50091149,50091173,T,TGATGAGCTTTGGTTATTGGAGACA,24
NC_037335.1,NC_032657.1,47773488,50105451,50105455,A,ATCAG,4
NC_037335.1,NC_032657.1,47780152,50112114,50112115,a,ag,1
NC_037335.1,NC_032657.1,47780933,50112902,50112921,t,tgcagtccaagggactctca,19
NC_037335.1,NC_032657.1,47784450,50116439,50116440,g,gt,1
NC_037335.1,NC_032657.1,47789727,50121718,50121719,C,CY,1
NC_037335.1,NC_032657.1,47800913,50132909,50132910,t,ta,1
NC_037335.1,NC_032657.1,47812093,50144091,50144092,A,AG,1
NC_037335.1,NC_032657.1,47922048,50251533,50251534,A,AM,1
NC_037335.1,NC_032657.1,48082835,50412441,50412442,g,ga,1
NC_037335.1,NC_032657.1,48253505,50583683,50583685,A,AAC,2
NC_037335.1,NC_032657.1,48306676,50651345,50651346,G,GT,1
NC_037335.1,NC_032657.1,48317059,50661729,50661730,c,ca,1
NC_037335.1,NC_032657.1,48436343,50786738,50786739,C,CT,1
NC_037335.1,NC_032657.1,48453923,50804328,50804332,A,ACTKT,4
NC_037335.1,NC_032657.1,48501140,50852486,50852487,a,ag,1
NC_037335.1,NC_032657.1,48517838,50869186,50869196,c,cccgccgtcCG,10
NC_037335.1,NC_032657.1,48530419,50882598,50882599,t,ta,1
NC_037335.1,NC_032657.1,48606276,50958495,50958496,G,GA,1
NC_037335.1,NC_032657.1,48626267,50978492,50978493,t,tc,1
NC_037335.1,NC_032657.1,48672781,51023078,51023079,C,CA,1
NC_037335.1,NC_032657.1,48857103,51211771,51211772,T,TC,1
NC_037335.1,NC_032657.1,48860580,51215062,51215071,G,GTGTTTATGC,9
NC_037335.1,NC_032657.1,48871579,51226237,51226238,T,TC,1
NC_037335.1,NC_032657.1,48882935,51237595,51237601,T,TTCTCTC,6
NC_037335.1,NC_032657.1,48953316,51307366,51307367,g,ga,1
NC_037335.1,NC_032657.1,49032743,51386574,51386580,C,CATAACA,6
NC_037335.1,NC_032657.1,49039044,51392877,51392878,C,CM,1
NC_037335.1,NC_032657.1,49041649,51395483,51395484,T,TG,1
NC_037335.1,NC_032657.1,49085978,51436108,51436112,g,gtccc,4
NC_037335.1,NC_032657.1,49091418,51441552,51441555,A,ATWW,3
NC_037335.1,NC_032657.1,49095579,51445726,51445728,a,aac,2
NC_037335.1,NC_032657.1,49280434,51631709,51631711,g,gta,2
NC_037335.1,NC_032657.1,49327876,51680155,51680156,C,CG,1
NC_037335.1,NC_032657.1,49418703,51776495,51776497,T,TTC,2
NC_037335.1,NC_032657.1,49422261,51780057,51780058,g,ga,1
NC_037335.1,NC_032657.1,49438607,51796405,51796407,t,taa,2
NC_037335.1,NC_032657.1,49474426,51835152,51835153,g,gc,1
NC_037335.1,NC_032657.1,49489437,51850168,51850169,c,ct,1
NC_037335.1,NC_032657.1,49561122,51920790,51920791,c,ct,1
NC_037335.1,NC_032657.1,49562201,51921870,51921871,t,ta,1
NC_037335.1,NC_032657.1,49662843,52022516,52022522,a,aatatat,6
NC_037335.1,NC_032657.1,49684719,52044410,52044414,a,atttg,4
NC_037335.1,NC_032657.1,49685959,52045654,52045655,T,TG,1
NC_037335.1,NC_032657.1,49686522,52046219,52046220,a,at,1
NC_037335.1,NC_032657.1,49700980,52060701,52060702,a,at,1
NC_037335.1,NC_032657.1,49727198,52086624,52086625,t,ta,1
NC_037335.1,NC_032657.1,49736045,52095474,52095476,a,aNN,2
NC_037335.1,NC_032657.1,49745023,52104004,52104005,a,ag,1
NC_037335.1,NC_032657.1,49758312,52118864,52118866,T,TTC,2
NC_037335.1,NC_032657.1,49764020,52124585,52124586,A,AG,1
NC_037335.1,NC_032657.1,49770093,52130757,52130758,c,ca,1
NC_037335.1,NC_032657.1,49782398,52143063,52143067,G,GTGAC,4
NC_037335.1,NC_032657.1,49804372,52165025,52165026,C,CA,1
NC_037335.1,NC_032657.1,49876315,52236854,52236855,T,TY,1
NC_037335.1,NC_032657.1,49927769,52288310,52288311,T,TR,1
NC_037335.1,NC_032657.1,49950739,52312134,52312135,C,CA,1
NC_037335.1,NC_032657.1,49952752,52314148,52314150,t,tta,2
NC_037335.1,NC_032657.1,49956909,52318306,52318307,t,ta,1
NC_037335.1,NC_032657.1,49956912,52318310,52318311,t,ta,1
NC_037335.1,NC_032657.1,49957628,52319027,52319039,a,atacaaaatatac,12
NC_037335.1,NC_032657.1,49960849,52322308,52322309,c,cg,1
NC_037335.1,NC_032657.1,49963304,52324763,52324764,A,AW,1
NC_037335.1,NC_032657.1,49963323,52324783,52324787,C,CAAAG,4
NC_037335.1,NC_032657.1,49964264,52325731,52325734,t,ttta,3
NC_037335.1,NC_032657.1,49980352,52341676,52341680,C,CCTAA,4
NC_037335.1,NC_032657.1,49985296,52346636,52346637,t,tg,1
NC_037335.1,NC_032657.1,49987138,52348479,52348480,t,ta,1
NC_037335.1,NC_032657.1,49987937,52349280,52349281,t,ta,1
NC_037335.1,NC_032657.1,50062816,52424724,52424725,a,ag,1
NC_037335.1,NC_032657.1,50102223,52464115,52464116,t,tc,1
NC_037335.1,NC_032657.1,50121525,52482438,52482442,a,acatt,4
NC_037335.1,NC_032657.1,50129850,52490783,52490784,a,at,1
NC_037335.1,NC_032657.1,50131020,52491954,52491955,T,TG,1
NC_037335.1,NC_032657.1,50132467,52493402,52493408,a,aaaaaat,6
NC_037335.1,NC_032657.1,50145853,52506794,52506795,c,ca,1
NC_037335.1,NC_032657.1,50150066,52511021,52511022,A,AC,1
NC_037335.1,NC_032657.1,50155087,52516046,52516047,g,gt,1
NC_037335.1,NC_032657.1,50157653,52518613,52518616,t,ttag,3
NC_037335.1,NC_032657.1,50157698,52518661,52518663,t,tta,2
NC_037335.1,NC_032657.1,50170730,52531730,52531731,a,at,1
NC_037335.1,NC_032657.1,50189334,52550022,52550025,t,taaa,3
NC_037335.1,NC_032657.1,50192064,52552756,52552757,A,AW,1
NC_037335.1,NC_032657.1,50213763,52574455,52574456,C,CA,1
NC_037335.1,NC_032657.1,50216590,52577286,52577287,a,ag,1
NC_037335.1,NC_032657.1,50254060,52616071,52616074,T,TAAC,3
NC_037335.1,NC_032657.1,50259525,52621539,52621540,a,at,1
NC_037335.1,NC_032657.1,50283693,52645705,52645707,t,taa,2
NC_037335.1,NC_032657.1,50332944,52694964,52694965,A,AN,1
NC_037335.1,NC_032657.1,50355957,52717874,52717876,g,gaa,2
NC_037335.1,NC_032657.1,50356355,52718275,52718282,a,aaaaaaag,7
NC_037335.1,NC_032657.1,50441339,52803276,52803278,A,ATG,2
NC_037335.1,NC_032657.1,50442257,52804196,52804197,C,CY,1
NC_037335.1,NC_032657.1,50444408,52806374,52806375,T,TW,1
NC_037335.1,NC_032657.1,50516969,52878988,52878989,a,ac,1
NC_037335.1,NC_032657.1,50616019,52977583,52977584,A,AG,1
NC_037335.1,NC_032657.1,50650661,53012227,53012228,t,tg,1
NC_037335.1,NC_032657.1,50713622,53075186,53075187,C,CS,1
NC_037335.1,NC_032657.1,50779242,53140686,53140687,C,CM,1
NC_037335.1,NC_032657.1,50783378,53144826,53144828,C,CTT,2
NC_037335.1,NC_032657.1,50791531,53152981,53152982,C,CY,1
NC_037335.1,NC_032657.1,50805723,53167185,53167186,t,ta,1
NC_037335.1,NC_032657.1,50843146,53204612,53204614,T,TCA,2
NC_037335.1,NC_032657.1,50851123,53212591,53212592,g,gt,1
NC_037335.1,NC_032657.1,50854605,53216072,53216073,t,ta,1
NC_037335.1,NC_032657.1,50855380,53216844,53216845,G,GA,1
NC_037335.1,NC_032657.1,50855396,53216861,53216862,T,TG,1
NC_037335.1,NC_032657.1,50855408,53216874,53216875,A,AT,1
NC_037335.1,NC_032657.1,50856130,53217587,53217588,G,GC,1
NC_037335.1,NC_032657.1,50895828,53228685,53228687,t,tta,2
NC_037335.1,NC_032657.1,50901303,53234163,53234164,t,ta,1
NC_037335.1,NC_032657.1,50911337,53244200,53244201,t,tY,1
NC_037335.1,NC_032657.1,50926062,53258925,53258928,T,TCAG,3
NC_037335.1,NC_032657.1,50929004,53261870,53261872,T,TAA,2
NC_037335.1,NC_032657.1,50930250,53263118,53263132,t,tNNNNNNNNNNNNNN,14
NC_037335.1,NC_032657.1,50932845,53265728,53265730,a,aat,2
NC_037335.1,NC_032657.1,50937892,53270776,53270796,T,TCCCGATTCACAAGATAAATG,20
NC_037335.1,NC_032657.1,51019287,53344658,53344663,c,ccaggg,5
NC_037335.1,NC_032657.1,51019332,53344708,53344709,a,ag,1
NC_037335.1,NC_032657.1,51229995,53555435,53555436,a,at,1
NC_037335.1,NC_032657.1,51251251,53576694,53576696,t,ttN,2
NC_037335.1,NC_032657.1,51269361,53594805,53594806,g,gt,1
NC_037335.1,NC_032657.1,51279492,53604580,53604581,t,ta,1
NC_037335.1,NC_032657.1,51280712,53605801,53605804,T,TKGG,3
NC_037335.1,NC_032657.1,51300872,53625964,53625965,A,AM,1
NC_037335.1,NC_032657.1,51318868,53643817,53643818,t,tN,1
NC_037335.1,NC_032657.1,51330431,53655539,53655542,t,taaa,3
NC_037335.1,NC_032657.1,51330443,53655554,53655555,t,ta,1
NC_037335.1,NC_032657.1,51334279,53659327,53659330,A,AAAT,3
NC_037335.1,NC_032657.1,51336701,53662315,53662316,c,ca,1
NC_037335.1,NC_032657.1,51339201,53664824,53664825,G,GC,1
NC_037335.1,NC_032657.1,51361602,53687382,53687383,a,ag,1
NC_037335.1,NC_032657.1,51363847,53689779,53689784,g,gttttt,5
NC_037335.1,NC_032657.1,51384735,53716663,53716664,a,at,1
NC_037335.1,NC_032657.1,51411080,53742942,53742943,G,GK,1
NC_037335.1,NC_032657.1,51451970,53783830,53783831,g,gc,1
NC_037335.1,NC_032657.1,51512857,53843946,53843947,g,ga,1
NC_037335.1,NC_032657.1,51516482,53847573,53847575,t,ttc,2
NC_037335.1,NC_032657.1,51519539,53850632,53850633,t,ta,1
NC_037335.1,NC_032657.1,51551550,53882495,53882496,c,ct,1
NC_037335.1,NC_032657.1,51551592,53882538,53882539,t,tg,1
NC_037335.1,NC_032657.1,51556398,53887482,53887483,c,cg,1
NC_037335.1,NC_032657.1,51562061,53893148,53893149,G,GC,1
NC_037335.1,NC_032657.1,51574089,53905184,53905190,C,CATAATT,6
NC_037335.1,NC_032657.1,51618568,53948504,53948506,a,act,2
NC_037335.1,NC_032657.1,51621679,53951617,53951620,t,tagc,3
NC_037335.1,NC_032657.1,51633207,53963154,53963155,a,ac,1
NC_037335.1,NC_032657.1,51633226,53963174,53963176,a,atg,2
NC_037335.1,NC_032657.1,51643525,53973494,53973495,T,TC,1
NC_037335.1,NC_032657.1,51649324,53979295,53979297,t,tac,2
NC_037335.1,NC_032657.1,51761036,54090997,54091002,C,CCTTCA,5
NC_037335.1,NC_032657.1,51831025,54161009,54161011,T,TCA,2
NC_037335.1,NC_032657.1,51855405,54185391,54185411,g,gaacCGGACGGATAACAACCN,20
NC_037335.1,NC_032657.1,51855433,54185439,54185440,T,TA,1
NC_037335.1,NC_032657.1,51855486,54185493,54185495,A,AAT,2
NC_037335.1,NC_032657.1,51908792,54238556,54238558,c,ctg,2
NC_037335.1,NC_032657.1,51908803,54238569,54238571,t,ttc,2
NC_037335.1,NC_032657.1,51908937,54238705,54238706,a,at,1
NC_037335.1,NC_032657.1,51926376,54256155,54256157,A,ATG,2
NC_037335.1,NC_032657.1,52003326,54333109,54333110,T,TG,1
NC_037335.1,NC_032657.1,52015162,54344947,54344952,g,gactga,5
NC_037335.1,NC_032657.1,52042084,54379901,54379902,G,GR,1
NC_037335.1,NC_032657.1,52117743,54455567,54455568,T,TC,1
NC_037335.1,NC_032657.1,52173118,54512703,54512705,T,TGA,2
NC_037335.1,NC_032657.1,52174984,54514569,54514571,a,att,2
NC_037335.1,NC_032657.1,52213911,54553501,54553502,G,GA,1
NC_037335.1,NC_032657.1,52272311,54612076,54612077,a,aR,1
NC_037335.1,NC_032657.1,52283291,54623053,54623054,G,GW,1
NC_037335.1,NC_032657.1,52299181,54638855,54638856,T,TA,1
NC_037335.1,NC_032657.1,52356094,54695776,54695777,T,TA,1
NC_037335.1,NC_032657.1,52357254,54696937,54696939,C,CTA,2
NC_037335.1,NC_032657.1,52432482,54772455,54772456,T,TK,1
NC_037335.1,NC_032657.1,52564037,54904868,54904869,T,TA,1
NC_037335.1,NC_032657.1,52611307,54952281,54952282,a,at,1
NC_037335.1,NC_032657.1,52618094,54959069,54959070,a,at,1
NC_037335.1,NC_032657.1,52633374,54974351,54974352,T,TK,1
NC_037335.1,NC_032657.1,52647890,54988878,54988879,T,TY,1
NC_037335.1,NC_032657.1,52648334,54989323,54989324,A,AC,1
NC_037335.1,NC_032657.1,52675367,55016376,55016378,T,TAA,2
NC_037335.1,NC_032657.1,52676927,55017940,55017971,T,TGGGGCCAACTTTCCTAGGGACTGTTAAGTCC,31
NC_037335.1,NC_032657.1,52682715,55023757,55023758,G,GA,1
NC_037335.1,NC_032657.1,52698445,55039242,55039243,c,ct,1
NC_037335.1,NC_032657.1,52746943,55087991,55087992,A,AT,1
NC_037335.1,NC_032657.1,52753039,55094087,55094088,a,at,1
NC_037335.1,NC_032657.1,52827597,55168632,55168642,c,cttggagaatt,10
NC_037335.1,NC_032657.1,52850416,55191463,55191484,C,CCYCTGAGCTTCCTGGAAGTGG,21
NC_037335.1,NC_032657.1,52862417,55202659,55202669,c,cccaccaggct,10
NC_037335.1,NC_032657.1,52864536,55204706,55204707,t,tg,1
NC_037335.1,NC_032657.1,52879117,55219289,55219296,T,TAAGGGAA,7
NC_037335.1,NC_032657.1,52909589,55249776,55249777,T,TK,1
NC_037335.1,NC_032657.1,52989143,55329298,55329299,g,ga,1
NC_037335.1,NC_032657.1,53020377,55360013,55360017,c,catat,4
NC_037335.1,NC_032657.1,53029303,55368962,55368963,g,gt,1
NC_037335.1,NC_032657.1,53031790,55371450,55371451,a,at,1
NC_037335.1,NC_032657.1,53060414,55400068,55400070,T,TTG,2
NC_037335.1,NC_032657.1,53130493,55469940,55469941,A,AR,1
NC_037335.1,NC_032657.1,53174030,55513692,55513693,c,cg,1
NC_037335.1,NC_032657.1,53233658,55588437,55588438,c,ca,1
NC_037335.1,NC_032657.1,53259586,55614381,55614382,c,ct,1
NC_037335.1,NC_032657.1,53380171,55778791,55778792,A,AG,1
NC_037335.1,NC_032657.1,53498005,55896056,55896057,a,at,1
NC_037335.1,NC_032657.1,53498679,55896731,55896732,A,AC,1
NC_037335.1,NC_032657.1,53524897,55922877,55922878,g,gt,1
NC_037335.1,NC_032657.1,53524911,55922892,55922894,c,caa,2
NC_037335.1,NC_032657.1,53559129,55957114,55957115,T,TK,1
NC_037335.1,NC_032657.1,53563576,55961563,55961564,t,ta,1
NC_037335.1,NC_032657.1,53617395,56015394,56015398,A,ATTMM,4
NC_037335.1,NC_032657.1,53628129,56026132,56026133,T,TY,1
NC_037335.1,NC_032657.1,53697582,56095601,56095603,a,acc,2
NC_037335.1,NC_032657.1,53725793,56123820,56123821,T,TA,1
NC_037335.1,NC_032657.1,53838413,56236968,56236969,A,AR,1
NC_037335.1,NC_032657.1,53905143,56303621,56303629,G,GATCCTAAA,8
NC_037335.1,NC_032657.1,53986558,56384931,56384951,A,AGGGTAGGAGTTCTCGATGGC,20
NC_037335.1,NC_032657.1,53995477,56394053,56394054,T,TY,1
NC_037335.1,NC_032657.1,54135550,56534522,56534523,c,ct,1
NC_037335.1,NC_032657.1,54197205,56596116,56596117,t,ta,1
NC_037335.1,NC_032657.1,54234150,56633537,56633545,t,ttggtgatg,8
NC_037335.1,NC_032657.1,54458899,56858950,56858951,t,tc,1
NC_037335.1,NC_032657.1,54481723,56881770,56881772,c,ctt,2
NC_037335.1,NC_032657.1,54482609,56882658,56882660,A,ACR,2
NC_037335.1,NC_032657.1,54489805,56889849,56889850,g,ga,1
NC_037335.1,NC_032657.1,54509094,56909251,56909252,c,ct,1
NC_037335.1,NC_032657.1,54684146,57099231,57099232,c,ca,1
NC_037335.1,NC_032657.1,54709752,57125009,57125010,a,at,1
NC_037335.1,NC_032657.1,54711438,57126695,57126697,t,ttc,2
NC_037335.1,NC_032657.1,54711533,57126792,57126793,a,ag,1
NC_037335.1,NC_032657.1,54725564,57140534,57140535,A,AC,1
NC_037335.1,NC_032657.1,54738620,57153673,57153677,c,cactg,4
NC_037335.1,NC_032657.1,54742989,57158062,57158063,t,tc,1
NC_037335.1,NC_032657.1,54745070,57160140,57160141,t,ta,1
NC_037335.1,NC_032657.1,54745596,57160668,57160669,A,AC,1
NC_037335.1,NC_032657.1,54745623,57160696,57160697,A,AG,1
NC_037335.1,NC_032657.1,54750314,57165303,57165304,T,TC,1
NC_037335.1,NC_032657.1,54783954,57199087,57199088,a,at,1
NC_037335.1,NC_032657.1,54786043,57201176,57201177,T,TC,1
NC_037335.1,NC_032657.1,54786134,57201268,57201269,A,AG,1
NC_037335.1,NC_032657.1,54815672,57230920,57230921,g,gR,1
NC_037335.1,NC_032657.1,54845924,57268150,57268151,t,tc,1
NC_037335.1,NC_032657.1,54846205,57268428,57268431,C,CAAA,3
NC_037335.1,NC_032657.1,54873875,57296906,57296907,t,tc,1
NC_037335.1,NC_032657.1,54888138,57313051,57313052,g,gt,1
NC_037335.1,NC_032657.1,54891181,57316102,57316103,a,at,1
NC_037335.1,NC_032657.1,54910241,57335178,57335179,t,tg,1
NC_037335.1,NC_032657.1,54911349,57336287,57336292,c,cagtgg,5
NC_037335.1,NC_032657.1,54911370,57336313,57336321,t,tttgggggg,8
NC_037335.1,NC_032657.1,54923518,57349431,57349435,C,CCTGA,4
NC_037335.1,NC_032657.1,54930459,57356382,57356383,G,GT,1
NC_037335.1,NC_032657.1,54932525,57358446,57358447,t,ta,1
NC_037335.1,NC_032657.1,54941973,57368909,57368910,c,ct,1
NC_037335.1,NC_032657.1,54942746,57369683,57369684,a,ag,1
NC_037335.1,NC_032657.1,54948517,57375452,57375453,c,ct,1
NC_037335.1,NC_032657.1,54949385,57376322,57376324,g,gga,2
NC_037335.1,NC_032657.1,54950746,57377678,57377679,g,gc,1
NC_037335.1,NC_032657.1,54967186,57394642,57394643,c,ca,1
NC_037335.1,NC_032657.1,54969407,57396866,57396868,a,aag,2
NC_037335.1,NC_032657.1,54970328,57397773,57397774,c,ca,1
NC_037335.1,NC_032657.1,54970430,57397876,57397877,g,ga,1
NC_037335.1,NC_032657.1,54971212,57398659,57398660,g,ga,1
NC_037335.1,NC_032657.1,54972099,57399547,57399550,a,aaag,3
NC_037335.1,NC_032657.1,54972854,57400305,57400306,t,ta,1
NC_037335.1,NC_032657.1,54973577,57401029,57401030,a,ag,1
NC_037335.1,NC_032657.1,55009206,57436762,57436763,C,CT,1
NC_037335.1,NC_032657.1,55078620,57506723,57506725,T,TTA,2
NC_037335.1,NC_032657.1,55105487,57533511,57533512,a,at,1
NC_037335.1,NC_032657.1,55186081,57630012,57630013,a,ag,1
NC_037335.1,NC_032657.1,55188330,57632263,57632264,A,AG,1
NC_037335.1,NC_032657.1,55236744,57680502,57680518,G,GTAAAGGTGTCGCTGTT,16
NC_037335.1,NC_032657.1,55257346,57701125,57701126,a,ag,1
NC_037335.1,NC_032657.1,55257868,57701648,57701649,c,ca,1
NC_037335.1,NC_032657.1,55291638,57735886,57735887,t,tc,1
NC_037335.1,NC_032657.1,55291643,57735892,57735893,a,ag,1
NC_037335.1,NC_032657.1,55304157,57748407,57748408,T,TW,1
NC_037335.1,NC_032657.1,55339395,57783728,57783734,a,aaaNNNN,6
NC_037335.1,NC_032657.1,55375209,57819551,57819552,t,ta,1
NC_037335.1,NC_032657.1,55375468,57819811,57819812,G,GT,1
NC_037335.1,NC_032657.1,55377352,57821696,57821697,C,CA,1
NC_037335.1,NC_032657.1,55377480,57821825,57821826,T,TA,1
NC_037335.1,NC_032657.1,55377535,57821882,57821883,a,at,1
NC_037335.1,NC_032657.1,55377558,57821906,57821907,c,ca,1
NC_037335.1,NC_032657.1,55379720,57824067,57824068,G,GT,1
NC_037335.1,NC_032657.1,55380245,57824593,57824597,G,GAAGT,4
NC_037335.1,NC_032657.1,55380749,57825101,57825102,g,ga,1
NC_037335.1,NC_032657.1,55380871,57825224,57825225,C,CA,1
NC_037335.1,NC_032657.1,55381207,57825560,57825561,g,ga,1
NC_037335.1,NC_032657.1,55381353,57825706,57825707,c,ct,1
NC_037335.1,NC_032657.1,55381813,57826165,57826166,g,gc,1
NC_037335.1,NC_032657.1,55381844,57826197,57826199,t,ttc,2
NC_037335.1,NC_032657.1,55381852,57826207,57826208,g,gc,1
NC_037335.1,NC_032657.1,55382685,57827040,57827041,A,AT,1
NC_037335.1,NC_032657.1,55386501,57804726,57804727,A,AG,1
NC_037335.1,NC_032657.1,55386758,57804984,57804985,g,gt,1
NC_037335.1,NC_032657.1,55387131,57805358,57805359,a,ac,1
NC_037335.1,NC_032657.1,55387162,57805390,57805391,C,CT,1
NC_037335.1,NC_032657.1,55387255,57805484,57805485,c,ca,1
NC_037335.1,NC_032657.1,55387277,57805507,57805508,T,TG,1
NC_037335.1,NC_032657.1,55387329,57805559,57805560,T,TC,1
NC_037335.1,NC_032657.1,55387357,57805588,57805589,A,AT,1
NC_037335.1,NC_032657.1,55387773,57806003,57806004,G,GA,1
NC_037335.1,NC_032657.1,55387839,57806070,57806071,T,TG,1
NC_037335.1,NC_032657.1,55387952,57806184,57806185,G,GT,1
NC_037335.1,NC_032657.1,55388289,57806519,57806520,T,TG,1
NC_037335.1,NC_032657.1,55388395,57806626,57806627,a,ac,1
NC_037335.1,NC_032657.1,55388664,57806894,57806895,A,AT,1
NC_037335.1,NC_032657.1,55388715,57806945,57806946,G,GC,1
NC_037335.1,NC_032657.1,55388723,57806954,57806955,G,GA,1
NC_037335.1,NC_032657.1,55388768,57807000,57807001,A,AG,1
NC_037335.1,NC_032657.1,55388801,57807034,57807035,A,AG,1
NC_037335.1,NC_032657.1,55388815,57807049,57807050,G,GA,1
NC_037335.1,NC_032657.1,55389210,57807442,57807443,C,CT,1
NC_037335.1,NC_032657.1,55389228,57807461,57807462,A,AT,1
NC_037335.1,NC_032657.1,55389258,57807492,57807493,A,AT,1
NC_037335.1,NC_032657.1,55389789,57808021,57808022,C,CT,1
NC_037335.1,NC_032657.1,55390006,57808239,57808240,G,GC,1
NC_037335.1,NC_032657.1,55390559,57808790,57808791,c,ct,1
NC_037335.1,NC_032657.1,55390609,57808841,57808842,c,ct,1
NC_037335.1,NC_032657.1,55390714,57808947,57808948,t,tg,1
NC_037335.1,NC_032657.1,55390752,57808986,57808987,c,ct,1
NC_037335.1,NC_032657.1,55391088,57809323,57809324,t,ta,1
NC_037335.1,NC_032657.1,55392435,57810667,57810668,A,AC,1
NC_037335.1,NC_032657.1,55392484,57810717,57810718,A,AC,1
NC_037335.1,NC_032657.1,55393613,57811847,57811848,g,ga,1
NC_037335.1,NC_032657.1,55395868,57814102,57814106,C,CACAG,4
NC_037335.1,NC_032657.1,55399499,57817736,57817742,a,atgctgc,6
NC_037335.1,NC_032657.1,55436309,57854558,57854559,C,CA,1
NC_037335.1,NC_032657.1,55448853,57867109,57867112,C,CTGT,3
NC_037335.1,NC_032657.1,55492468,57910735,57910745,T,TTTCCACAGTA,10
NC_037335.1,NC_032657.1,55617674,58035993,58035994,C,CT,1
NC_037335.1,NC_032657.1,55632337,58050652,58050654,C,CTG,2
NC_037335.1,NC_032657.1,55668830,58087139,58087142,G,GGTC,3
NC_037335.1,NC_032657.1,55674542,58092852,58092855,c,cttt,3
NC_037335.1,NC_032657.1,55675831,58094144,58094145,T,TC,1
NC_037335.1,NC_032657.1,55689588,58107894,58107895,G,GC,1
NC_037335.1,NC_032657.1,55731594,58149934,58149935,T,TW,1
NC_037335.1,NC_032657.1,55767281,58185627,58185628,T,TW,1
NC_037335.1,NC_032657.1,55787790,58206144,58206145,g,gt,1
NC_037335.1,NC_032657.1,55888630,58313245,58313246,G,GR,1
NC_037335.1,NC_032657.1,55896475,58321085,58321086,c,ct,1
NC_037335.1,NC_032657.1,55900900,58325514,58325516,c,ctt,2
NC_037335.1,NC_032657.1,55902681,58327299,58327300,G,GT,1
NC_037335.1,NC_032657.1,56025291,58450333,58450334,a,at,1
NC_037335.1,NC_032657.1,56030092,58455138,58455139,T,TY,1
NC_037335.1,NC_032657.1,56039772,58464825,58464826,t,ta,1
NC_037335.1,NC_032657.1,56041202,58466255,58466256,a,aW,1
NC_037335.1,NC_032657.1,56056270,58481349,58481350,g,ga,1
NC_037335.1,NC_032657.1,56060578,58485662,58485663,T,TY,1
NC_037335.1,NC_032657.1,56066438,58491523,58491524,C,CY,1
NC_037335.1,NC_032657.1,56105816,58531656,58531659,T,TGAW,3
NC_037335.1,NC_032657.1,56165071,58591016,58591022,a,aagttat,6
NC_037335.1,NC_032657.1,56165081,58591032,58591033,c,ca,1
NC_037335.1,NC_032657.1,56165254,58591206,58591207,a,ac,1
NC_037335.1,NC_032657.1,56611269,59166862,59166863,g,ga,1
NC_037335.1,NC_032657.1,56644277,59199872,59199873,t,tc,1
NC_037335.1,NC_032657.1,56652906,59208503,59208505,A,AAG,2
NC_037335.1,NC_032657.1,56687304,59242908,59242910,c,cag,2
NC_037335.1,NC_032657.1,56694041,59249647,59249648,t,tg,1
NC_037335.1,NC_032657.1,56702793,59259592,59259593,c,ct,1
NC_037335.1,NC_032657.1,56715257,59272058,59272062,t,tNNNN,4
NC_037335.1,NC_032657.1,56740258,59297035,59297036,T,TG,1
NC_037335.1,NC_032657.1,56770507,59326970,59326971,G,GK,1
NC_037335.1,NC_032657.1,56778580,59335312,59335313,A,AG,1
NC_037335.1,NC_032657.1,56780598,59337343,59337344,A,AT,1
NC_037335.1,NC_032657.1,56783763,59340512,59340513,t,tg,1
NC_037335.1,NC_032657.1,56788854,59345693,59345694,t,ta,1
NC_037335.1,NC_032657.1,56794500,59351341,59351343,t,ttc,2
NC_037335.1,NC_032657.1,56799761,59356622,59356623,A,AR,1
NC_037335.1,NC_032657.1,56910737,59467615,59467617,a,act,2
NC_037335.1,NC_032657.1,56952853,59509747,59509748,g,ga,1
NC_037335.1,NC_032657.1,56965351,59522258,59522259,g,ga,1
NC_037335.1,NC_032657.1,56982351,59539266,59539267,a,ag,1
NC_037335.1,NC_032657.1,56993389,59552938,59552939,a,at,1
NC_037335.1,NC_032657.1,57000250,59559778,59559779,g,gt,1
NC_037335.1,NC_032657.1,57000324,59559852,59559853,t,tc,1
NC_037335.1,NC_032657.1,57000367,59559896,59559897,t,tg,1
NC_037335.1,NC_032657.1,57000504,59560034,59560036,a,aag,2
NC_037335.1,NC_032657.1,57034112,59593646,59593647,C,CY,1
NC_037335.1,NC_032657.1,57049781,59609329,59609330,g,gt,1
NC_037335.1,NC_032657.1,57126138,59685509,59685510,t,ta,1
NC_037335.1,NC_032657.1,57165877,59725260,59725261,A,AR,1
NC_037335.1,NC_032657.1,57368729,59929826,59929827,T,TA,1
NC_037335.1,NC_032657.1,57441979,60003084,60003086,T,TGA,2
NC_037335.1,NC_032657.1,57451782,60012883,60012884,T,TY,1
NC_037335.1,NC_032657.1,57494776,60055872,60055875,a,aaac,3
NC_037335.1,NC_032657.1,57500972,60062071,60062075,G,GAGTA,4
NC_037335.1,NC_032657.1,57521792,60082886,60082887,t,ta,1
NC_037335.1,NC_032657.1,57552360,60113457,60113460,G,GATC,3
NC_037335.1,NC_032657.1,57565183,60126269,60126272,a,aaac,3
NC_037335.1,NC_032657.1,57634340,60195333,60195334,T,TK,1
NC_037335.1,NC_032657.1,57703096,60265096,60265099,T,TGTA,3
NC_037335.1,NC_032657.1,57796526,60358518,60358519,t,tc,1
NC_037335.1,NC_032657.1,57809677,60372213,60372214,c,ca,1
NC_037335.1,NC_032657.1,58071602,60634226,60634227,T,TY,1
NC_037335.1,NC_032657.1,58081768,60644391,60644392,T,TY,1
NC_037335.1,NC_032657.1,58088885,60651510,60651520,t,tttcagttcag,10
NC_037335.1,NC_032657.1,58127405,60689111,60689112,a,ag,1
NC_037335.1,NC_032657.1,58133707,60695410,60695417,T,TAAGTGGC,7
NC_037335.1,NC_032657.1,58163681,60726212,60726213,A,AC,1
NC_037335.1,NC_032657.1,58206190,60766418,60766432,t,tNNNNNNNNNNNNNN,14
NC_037335.1,NC_032657.1,58228891,60789138,60789142,c,caact,4
NC_037335.1,NC_032657.1,58240295,60800545,60800546,a,ac,1
NC_037335.1,NC_032657.1,58241962,60802217,60802218,g,gc,1
NC_037335.1,NC_032657.1,58241983,60802239,60802240,a,ac,1
NC_037335.1,NC_032657.1,58245454,60805683,60805684,t,ta,1
NC_037335.1,NC_032657.1,58256334,60816592,60816593,t,ta,1
NC_037335.1,NC_032657.1,58265735,60825807,60825808,T,TG,1
NC_037335.1,NC_032657.1,58284503,60844579,60844581,C,CTA,2
NC_037335.1,NC_032657.1,58300470,60860549,60860550,t,ta,1
NC_037335.1,NC_032657.1,58510314,61065858,61065864,a,aNNNNNN,6
NC_037335.1,NC_032657.1,58616560,61172598,61172599,G,GR,1
NC_037335.1,NC_032657.1,58633865,61190100,61190101,T,TA,1
NC_037335.1,NC_032657.1,58649281,61205513,61205515,A,AMT,2
NC_037335.1,NC_032657.1,58650709,61206943,61206946,C,CTCG,3
NC_037335.1,NC_032657.1,58651952,61208192,61208195,T,TCTC,3
NC_037335.1,NC_032657.1,58744395,61300000,61300001,c,ca,1
NC_037335.1,NC_032657.1,58773773,61328278,61328279,A,AR,1
NC_037335.1,NC_032657.1,58784716,61339224,61339226,G,GAC,2
NC_037335.1,NC_032657.1,58853701,61408805,61408813,t,ttaaaaaaa,8
NC_037335.1,NC_032657.1,58872249,61528697,61528699,a,aat,2
NC_037335.1,NC_032657.1,58919082,61576379,61576380,a,at,1
NC_037335.1,NC_032657.1,58975613,61632828,61632832,T,TGTGA,4
NC_037335.1,NC_032657.1,59006455,61663914,61663915,g,gt,1
NC_037335.1,NC_032657.1,59073006,61727986,61727987,C,CT,1
NC_037335.1,NC_032657.1,59200905,61855900,61855901,T,TA,1
NC_037335.1,NC_032657.1,59289336,61944421,61944425,t,tataY,4
NC_037335.1,NC_032657.1,59317325,61972405,61972406,C,CY,1
NC_037335.1,NC_032657.1,59414857,62069943,62069944,G,GC,1
NC_037335.1,NC_032657.1,59439671,62094758,62094759,t,tY,1
NC_037335.1,NC_032657.1,59490336,62145440,62145441,A,AW,1
NC_037335.1,NC_032657.1,59532691,62188300,62188311,T,TGAAAAAAAGCC,11
NC_037335.1,NC_032657.1,59543718,62199337,62199338,T,TA,1
NC_037335.1,NC_032657.1,59560503,62216070,62216071,t,tg,1
NC_037335.1,NC_032657.1,59586661,62242230,62242231,T,TC,1
NC_037335.1,NC_032657.1,59603108,62258682,62258686,A,ACTGT,4
NC_037335.1,NC_032657.1,59628051,62283695,62283696,c,ca,1
NC_037335.1,NC_032657.1,59634508,62290154,62290161,A,ACGANNNN,7
NC_037335.1,NC_032657.1,59732545,62388209,62388210,G,GA,1
NC_037335.1,NC_032657.1,59908490,62564150,62564151,C,CY,1
NC_037335.1,NC_032657.1,59956268,62611850,62611851,G,GC,1
NC_037335.1,NC_032657.1,59981684,62637071,62637073,g,ggt,2
NC_037335.1,NC_032657.1,60012513,62667926,62667927,T,TC,1
NC_037335.1,NC_032657.1,60044583,62720005,62720006,C,CA,1
NC_037335.1,NC_032657.1,60064482,62913221,62913222,C,CM,1
NC_037335.1,NC_032657.1,60093133,62942142,62942143,C,CA,1
NC_037335.1,NC_032657.1,60093133,62863415,62863416,C,CA,1
NC_037335.1,NC_032657.1,60093312,62942321,62942324,t,tttc,3
NC_037335.1,NC_032657.1,60094065,62864351,62864352,G,GA,1
NC_037335.1,NC_032657.1,60094489,62943500,62943501,T,TA,1
NC_037335.1,NC_032657.1,60094489,62864776,62864777,T,TA,1
NC_037335.1,NC_032657.1,60094511,62943523,62943526,G,GGAC,3
NC_037335.1,NC_032657.1,60095482,62944493,62944494,T,TG,1
NC_037335.1,NC_032657.1,60095877,62944889,62944899,t,tcttgtGAGtg,10
NC_037335.1,NC_032657.1,60096437,62945456,62945458,C,CTT,2
NC_037335.1,NC_032657.1,60096897,62945918,62945919,t,ta,1
NC_037335.1,NC_032657.1,60152341,62889976,62889977,G,GC,1
NC_037335.1,NC_032657.1,60155880,62893514,62893515,A,AC,1
NC_037335.1,NC_032657.1,60156685,62894320,62894321,c,ca,1
NC_037335.1,NC_032657.1,60160683,62898318,62898322,C,CATGG,4
NC_037335.1,NC_032657.1,60179518,62895856,62895858,T,TGA,2
NC_037335.1,NC_032657.1,60229435,62988313,62988314,A,AT,1
NC_037335.1,NC_032657.1,60307696,63060746,63060748,a,att,2
NC_037335.1,NC_032657.1,60336955,63090015,63090021,c,ctttttt,6
NC_037335.1,NC_032657.1,60416254,63169340,63169341,a,ac,1
NC_037335.1,NC_032657.1,60416469,63169556,63169559,g,gctt,3
NC_037335.1,NC_032657.1,60423551,63176633,63176634,A,AC,1
NC_037335.1,NC_032657.1,60450450,63203559,63203560,C,CM,1
NC_037335.1,NC_032657.1,60451588,63204698,63204700,G,GAS,2
NC_037335.1,NC_032657.1,60453669,63206780,63206781,C,CT,1
NC_037335.1,NC_032657.1,60476059,63236512,63236521,t,tagcagcagc,9
NC_037335.1,NC_032657.1,60492703,63253167,63253172,A,AGTGAC,5
NC_037335.1,NC_032657.1,60492705,63253174,63253176,A,AAT,2
NC_037335.1,NC_032657.1,60505923,63266419,63266420,t,ta,1
NC_037335.1,NC_032657.1,60507026,63267523,63267525,C,CAT,2
NC_037335.1,NC_032657.1,60531998,63292508,63292509,A,AT,1
NC_037335.1,NC_032657.1,60532174,63292687,63292688,a,aN,1
NC_037335.1,NC_032657.1,60548224,63308742,63308743,T,TC,1
NC_037335.1,NC_032657.1,60571872,63332988,63332991,T,TTTG,3
NC_037335.1,NC_032657.1,60636283,63397405,63397406,T,TK,1
NC_037335.1,NC_032657.1,60650460,63411706,63411707,T,TY,1
NC_037335.1,NC_032657.1,60686862,63448106,63448107,G,GA,1
NC_037335.1,NC_032657.1,60865908,63630896,63630898,a,aNN,2
NC_037335.1,NC_032657.1,60928314,63693859,63693860,T,TK,1
NC_037335.1,NC_032657.1,60943902,63723787,63723788,T,TC,1
NC_037335.1,NC_032657.1,60952929,63732819,63732820,A,AR,1
NC_037335.1,NC_032657.1,60997927,63778255,63778256,G,GS,1
NC_037335.1,NC_032657.1,61042054,63822391,63822392,C,CT,1
NC_037335.1,NC_032657.1,61060762,63841281,63841306,G,GGTCTGCATCTGAGTTCACATAGAAT,25
NC_037335.1,NC_032657.1,61100517,63881069,63881071,t,ttc,2
NC_037335.1,NC_032657.1,61166283,63946840,63946841,T,TG,1
NC_037335.1,NC_032657.1,61166313,63946871,63946872,G,GR,1
NC_037335.1,NC_032657.1,61166439,63946999,63947001,G,GGC,2
NC_037335.1,NC_032657.1,61168752,63949314,63949315,A,AW,1
NC_037335.1,NC_032657.1,61311036,64083966,64083968,c,caa,2
NC_037335.1,NC_032657.1,61311575,64084507,64084508,g,gt,1
NC_037335.1,NC_032657.1,61316480,64089708,64089715,t,tatgtgtg,7
NC_037335.1,NC_032657.1,61479945,64249235,64249236,G,GC,1
NC_037335.1,NC_032657.1,61698185,64476153,64476154,a,at,1
NC_037335.1,NC_032657.1,61916370,64700551,64700552,a,at,1
NC_037335.1,NC_032657.1,61983918,64768099,64768101,T,TNN,2
NC_037335.1,NC_032657.1,62008751,64792932,64792933,C,CT,1
NC_037335.1,NC_032657.1,62008761,64792943,64792944,T,TA,1
NC_037335.1,NC_032657.1,62042011,64826191,64826192,t,tW,1
NC_037335.1,NC_032657.1,62205045,64990036,64990037,T,TC,1
NC_037335.1,NC_032657.1,62223758,65008751,65008752,T,TY,1
NC_037335.1,NC_032657.1,62241147,65026144,65026148,a,aaaat,4
NC_037335.1,NC_032657.1,62243764,65028767,65028770,g,gcaa,3
NC_037335.1,NC_032657.1,62296168,65085286,65085291,a,atatat,5
NC_037335.1,NC_032657.1,62306230,65095352,65095353,c,ct,1
NC_037335.1,NC_032657.1,62487348,65294052,65294054,A,ATT,2
NC_037335.1,NC_032657.1,62487386,65294092,65294093,G,GT,1
NC_037335.1,NC_032657.1,62492314,65298495,65298496,G,GM,1
NC_037335.1,NC_032657.1,62655452,65461830,65461831,a,ag,1
NC_037335.1,NC_032657.1,62682325,65489158,65489160,T,TTG,2
NC_037335.1,NC_032657.1,62696820,65503654,65503655,t,tg,1
NC_037335.1,NC_032657.1,62729704,65536539,65536540,c,cM,1
NC_037335.1,NC_032657.1,62784997,65591536,65591537,t,ta,1
NC_037335.1,NC_032657.1,62895627,65702168,65702171,C,CGAA,3
NC_037335.1,NC_032657.1,62944668,65751218,65751219,A,AG,1
NC_037335.1,NC_032657.1,62947069,65753620,65753621,G,GA,1
NC_037335.1,NC_032657.1,62973730,65780295,65780296,t,tc,1
NC_037335.1,NC_032657.1,62981745,65788313,65788315,G,GAA,2
NC_037335.1,NC_032657.1,63107745,65916350,65916353,c,cggg,3
NC_037335.1,NC_032657.1,63338628,66227660,66227668,A,ACCACTAGG,8
NC_037335.1,NC_032657.1,63372706,66261460,66261463,t,ttgg,3
NC_037335.1,NC_032657.1,63415950,66304711,66304716,t,ttaaaa,5
NC_037335.1,NC_032657.1,63456453,66345223,66345244,T,TGCCCTTCTGAGCAGAGGCACA,21
NC_037335.1,NC_032657.1,63510761,66397905,66397907,A,AAC,2
NC_037335.1,NC_032657.1,63513635,66400782,66400792,a,actgatctgat,10
NC_037335.1,NC_032657.1,63538045,66425063,66425064,g,gt,1
NC_037335.1,NC_032657.1,63539758,66426777,66426780,c,ctat,3
NC_037335.1,NC_032657.1,63540430,66427452,66427454,t,tNN,2
NC_037335.1,NC_032657.1,63583793,66470841,66470842,G,GR,1
NC_037335.1,NC_032657.1,63613499,66542642,66542643,T,TG,1
NC_037335.1,NC_032657.1,63620667,66549809,66549815,A,ACTCTAG,6
NC_037335.1,NC_032657.1,63644158,66573315,66573316,T,TC,1
NC_037335.1,NC_032657.1,63695943,66614109,66614116,A,AAGAACGC,7
NC_037335.1,NC_032657.1,63775523,66691592,66691593,A,AT,1
NC_037335.1,NC_032657.1,63825128,66741389,66741403,C,CWWCACAGGACAATA,14
NC_037335.1,NC_032657.1,63836736,66753006,66753007,C,CA,1
NC_037335.1,NC_032657.1,63845901,66762181,66762182,a,ag,1
NC_037335.1,NC_032657.1,64057990,66855918,66855921,C,CTGG,3
NC_037335.1,NC_032657.1,64099155,66897151,66897152,a,ag,1
NC_037335.1,NC_032657.1,64103170,66901170,66901171,g,ga,1
NC_037335.1,NC_032657.1,64123749,66921838,66921839,g,gt,1
NC_037335.1,NC_032657.1,64191835,66991464,66991470,g,gatctta,6
NC_037335.1,NC_032657.1,64199457,66999093,66999094,g,ga,1
NC_037335.1,NC_032657.1,64220879,67022981,67022982,t,ta,1
NC_037335.1,NC_032657.1,64235964,67038068,67038071,g,ggga,3
NC_037335.1,NC_032657.1,64413007,67215141,67215142,C,CM,1
NC_037335.1,NC_032657.1,64601625,67402537,67402538,c,ct,1
NC_037335.1,NC_032657.1,64721327,67539048,67539049,g,ga,1
NC_037335.1,NC_032657.1,64794957,67612680,67612684,c,ctcta,4
NC_037335.1,NC_032657.1,64906386,67724233,67724234,A,AG,1
NC_037335.1,NC_032657.1,65160762,68038626,68038629,A,AGTM,3
NC_037335.1,NC_032657.1,65248039,68125711,68125977,T,TAGGGANNNNNNNNNNNNNNNNNNNNNNNNNNNNNNNNNNNNNNNNNNNNNNNNNNNNNNNNNNNNNNNNNNNNNNNNNNNNNNNNNNNNNNNNNNNNNNNNNNNNNNNNNNNNNNNNNNNNNNNNNNNNNNNNNNNNNNNNNNNNNNNNNNNNNNNNNNNNNNNNNNNNNNNNNNNNNNNNNNNNNNNNNNNNNNNNNNNNNNNNNNNNNNNNNNNNNNNNNNNNNNNNNNNNNNNNNNNNNNNNNNNNNNNNNNNNNGTGAATAG,266
NC_037335.1,NC_032657.1,65256429,68136051,68136056,c,caactg,5
NC_037335.1,NC_032657.1,65258150,68137777,68137781,C,CCAAA,4
NC_037335.1,NC_032657.1,65258298,68137929,68137930,t,tg,1
NC_037335.1,NC_032657.1,65271328,68150950,68150951,a,at,1
NC_037335.1,NC_032657.1,65299949,68179565,68179575,A,AACCAGCGATT,10
NC_037335.1,NC_032657.1,65300436,68180062,68180063,C,CA,1
NC_037335.1,NC_032657.1,65301244,68180860,68180874,A,AGATATTTATATTAG,14
NC_037335.1,NC_032657.1,65301588,68181217,68181221,C,CTATT,4
NC_037335.1,NC_032657.1,65306557,68186180,68186181,g,gc,1
NC_037335.1,NC_032657.1,65310312,68189936,68189940,A,AATAT,4
NC_037335.1,NC_032657.1,65345615,68225160,68225166,t,tNNNNNN,6
NC_037335.1,NC_032657.1,65379351,68262574,68262575,t,tN,1
NC_037335.1,NC_032657.1,65382639,68265852,68265853,g,ga,1
NC_037335.1,NC_032657.1,65382659,68265873,68265874,a,ag,1
NC_037335.1,NC_032657.1,65382666,68265881,68265882,g,ga,1
NC_037335.1,NC_032657.1,65382711,68265927,68265929,a,aag,2
NC_037335.1,NC_032657.1,65384243,68267521,68267526,T,TACATA,5
NC_037335.1,NC_032657.1,65384317,68267600,68267601,G,GR,1
NC_037335.1,NC_032657.1,65384870,68268154,68268156,C,CTA,2
NC_037335.1,NC_032657.1,65395558,68278844,68278845,G,GA,1
NC_037335.1,NC_032657.1,65407080,68290356,68290370,A,ACACCACCACATACG,14
NC_037335.1,NC_032657.1,65407760,68291050,68291055,T,TCAGAG,5
NC_037335.1,NC_032657.1,65409876,68293171,68293172,A,AC,1
NC_037335.1,NC_032657.1,65412893,68296189,68296190,A,AT,1
NC_037335.1,NC_032657.1,65414831,68298134,68298136,a,acc,2
NC_037335.1,NC_032657.1,65415919,68299224,68299225,g,ga,1
NC_037335.1,NC_032657.1,65435650,68320006,68320007,t,ta,1
NC_037335.1,NC_032657.1,65439616,68323958,68323963,C,CACAAT,5
NC_037335.1,NC_032657.1,65449038,68333391,68333393,C,CCT,2
NC_037335.1,NC_032657.1,65450156,68334511,68334512,T,TG,1
NC_037335.1,NC_032657.1,65453004,68337365,68337369,A,ANNNN,4
NC_037335.1,NC_032657.1,65467307,68352074,68352093,A,AATTAAGAAGTAGCCCCGAG,19
NC_037335.1,NC_032657.1,65467789,68352576,68352577,T,TA,1
NC_037335.1,NC_032657.1,65468472,68353259,68353260,T,TG,1
NC_037335.1,NC_032657.1,65468645,68353433,68353435,g,gct,2
NC_037335.1,NC_032657.1,65470056,68354848,68354849,A,AC,1
NC_037335.1,NC_032657.1,65476220,68361015,68361016,g,ga,1
NC_037335.1,NC_032657.1,65479271,68363504,68363507,G,GGAA,3
NC_037335.1,NC_032657.1,65481036,68365276,68365277,t,ta,1
NC_037335.1,NC_032657.1,65509233,68393474,68393478,c,ccagt,4
NC_037335.1,NC_032657.1,65510359,68395020,68395021,G,GT,1
NC_037335.1,NC_032657.1,65510935,68395597,68395599,A,ACT,2
NC_037335.1,NC_032657.1,65533580,68418196,68418197,G,GA,1
NC_037335.1,NC_032657.1,65546595,68431207,68431208,c,ct,1
NC_037335.1,NC_032657.1,65547620,68432233,68432234,c,ct,1
NC_037335.1,NC_032657.1,65554820,68439420,68439421,c,cg,1
NC_037335.1,NC_032657.1,65564612,68534020,68534061,A,AACTAAGATGTGTCAGGTTCTGCCTCTTTTACAACAGGGACT,41
NC_037335.1,NC_032657.1,65568606,68538053,68538054,t,tc,1
NC_037335.1,NC_032657.1,65568627,68538075,68538076,t,tg,1
NC_037335.1,NC_032657.1,65578083,68547535,68547536,t,ta,1
NC_037335.1,NC_032657.1,65578086,68547539,68547540,c,ct,1
NC_037335.1,NC_032657.1,65584507,68553962,68553963,C,CM,1
NC_037335.1,NC_032657.1,65587341,68556797,68556799,t,ttg,2
NC_037335.1,NC_032657.1,65591447,68560921,68560922,g,gt,1
NC_037335.1,NC_032657.1,65592493,68561974,68561975,G,GA,1
NC_037335.1,NC_032657.1,65596334,68565801,68565802,G,GA,1
NC_037335.1,NC_032657.1,65599254,68568723,68568728,A,AGTGGT,5
NC_037335.1,NC_032657.1,65599909,68569383,68569384,C,CT,1
NC_037335.1,NC_032657.1,65606732,68576207,68576210,G,GCTA,3
NC_037335.1,NC_032657.1,65620707,68590183,68590187,C,CCTTT,4
NC_037335.1,NC_032657.1,65620755,68590235,68590238,C,CTTT,3
NC_037335.1,NC_032657.1,65621974,68591457,68591458,t,ta,1
NC_037335.1,NC_032657.1,65622153,68591637,68591638,t,ta,1
NC_037335.1,NC_032657.1,65622730,68592216,68592219,T,TTTC,3
NC_037335.1,NC_032657.1,65673869,68643356,68643357,c,ct,1
NC_037335.1,NC_032657.1,65676077,68645565,68645566,G,GA,1
NC_037335.1,NC_032657.1,65777764,68759894,68759895,G,GC,1
NC_037335.1,NC_032657.1,65789458,68771887,68771888,g,ga,1
NC_037335.1,NC_032657.1,65813273,68795891,68795893,a,aNN,2
NC_037335.1,NC_032657.1,65835806,68818420,68818424,a,agtcM,4
NC_037335.1,NC_032657.1,65861530,68844181,68844182,T,TG,1
NC_037335.1,NC_032657.1,65871592,68854244,68854245,A,AW,1
NC_037335.1,NC_032657.1,65872421,68855075,68855076,a,ag,1
NC_037335.1,NC_032657.1,65872514,68855169,68855170,a,ag,1
NC_037335.1,NC_032657.1,65957180,69095065,69095066,a,ag,1
NC_037335.1,NC_032657.1,65995076,69136109,69136110,c,ca,1
NC_037335.1,NC_032657.1,66025575,69166719,69166720,A,AW,1
NC_037335.1,NC_032657.1,66025674,69166819,69166843,C,CTCTAATTACGCTCAGCNNNNNNNN,24
NC_037335.1,NC_032657.1,66190850,69366128,69366129,C,CM,1
NC_037335.1,NC_032657.1,66224185,69401018,69401021,A,AGTG,3
NC_037335.1,NC_032657.1,66224204,69401040,69401041,T,TG,1
NC_037335.1,NC_032657.1,66228464,69405303,69405305,t,ttc,2
NC_037335.1,NC_032657.1,66235475,69412316,69412317,T,TG,1
NC_037335.1,NC_032657.1,66242566,69419409,69419410,c,ct,1
NC_037335.1,NC_032657.1,66281016,69457629,69457630,a,ag,1
NC_037335.1,NC_032657.1,66281103,69457717,69457719,t,tta,2
NC_037335.1,NC_032657.1,66296022,69472417,69472422,t,tgaccc,5
NC_037335.1,NC_032657.1,66306718,69483121,69483122,t,ta,1
NC_037335.1,NC_032657.1,66310490,69486890,69486901,a,aataaataaaat,11
NC_037335.1,NC_032657.1,66312948,69489366,69489367,A,AC,1
NC_037335.1,NC_032657.1,66314484,69490895,69490896,t,tc,1
NC_037335.1,NC_032657.1,66324096,69500559,69500560,c,cW,1
NC_037335.1,NC_032657.1,66324485,69500949,69500950,T,TA,1
NC_037335.1,NC_032657.1,66324579,69501044,69501047,t,tggc,3
NC_037335.1,NC_032657.1,66337342,69513790,69513791,G,GS,1
NC_037335.1,NC_032657.1,66339540,69515989,69515991,G,GRA,2
NC_037335.1,NC_032657.1,66397444,69573898,69573899,T,TY,1
NC_037335.1,NC_032657.1,66438688,69614949,69614957,g,ggtgtgtgt,8
NC_037335.1,NC_032657.1,66453433,69629170,69629183,C,CATTTAATTAATTT,13
NC_037335.1,NC_032657.1,66456938,69632689,69632690,T,TA,1
NC_037335.1,NC_032657.1,66486558,69662312,69662318,a,aatatat,6
NC_037335.1,NC_032657.1,66547354,69723599,69723600,G,GA,1
NC_037335.1,NC_032657.1,66636884,69812284,69812288,t,tNNNN,4
NC_037335.1,NC_032657.1,66715437,69863135,69863136,G,GA,1
NC_037335.1,NC_032657.1,66724903,69872520,69872521,c,ct,1
NC_037335.1,NC_032657.1,66728888,69920049,69920050,a,ag,1
NC_037335.1,NC_032657.1,66744188,69935352,69935353,g,gt,1
NC_037335.1,NC_032657.1,66860866,69895158,69895160,a,aag,2
NC_037335.1,NC_032657.1,66860866,70053565,70053567,a,aag,2
NC_037335.1,NC_032657.1,66901614,70095854,70095855,g,ga,1
NC_037335.1,NC_032657.1,66917374,70111614,70111615,t,ta,1
NC_037335.1,NC_032657.1,66994444,70191036,70191037,T,TW,1
NC_037335.1,NC_032657.1,67001469,70198060,70198061,A,AW,1
NC_037335.1,NC_032657.1,67011183,70207316,70207317,a,at,1
NC_037335.1,NC_032657.1,67014800,70210932,70210933,G,GC,1
NC_037335.1,NC_032657.1,67028210,70224368,70224371,C,CATA,3
NC_037335.1,NC_032657.1,67028461,70224622,70224623,A,AG,1
NC_037335.1,NC_032657.1,67031159,70227322,70227323,g,ga,1
NC_037335.1,NC_032657.1,67063160,70259540,70259541,t,ta,1
NC_037335.1,NC_032657.1,67094066,70290460,70290461,A,AG,1
NC_037335.1,NC_032657.1,67096759,70293154,70293156,g,gaa,2
NC_037335.1,NC_032657.1,67098954,70295349,70295350,A,AC,1
NC_037335.1,NC_032657.1,67109286,70305685,70305686,t,tc,1
NC_037335.1,NC_032657.1,67137892,70336381,70336391,a,atatatatatt,10
NC_037335.1,NC_032657.1,67191975,70436212,70436213,a,at,1
NC_037335.1,NC_032657.1,67196557,70440798,70440799,A,AG,1
NC_037335.1,NC_032657.1,67197269,70441508,70441509,a,ac,1
NC_037335.1,NC_032657.1,67198357,70442600,70442601,G,GA,1
NC_037335.1,NC_032657.1,67220434,70464450,70464452,c,cca,2
NC_037335.1,NC_032657.1,67310073,70556743,70556744,C,CY,1
NC_037335.1,NC_032657.1,67325206,70571691,70571718,G,GTGAGATTACTGTATAATAAAGTCTTTC,27
NC_037335.1,NC_032657.1,67331820,70578334,70578336,t,tag,2
NC_037335.1,NC_032657.1,67339903,70586421,70586422,G,GT,1
NC_037335.1,NC_032657.1,67359540,70606760,70606763,t,ttgc,3
NC_037335.1,NC_032657.1,67361661,70608741,70608742,A,AR,1
NC_037335.1,NC_032657.1,67574463,70820598,70820607,A,AGAACAAANN,9
NC_037335.1,NC_032657.1,67713083,70955879,70955880,c,ca,1
NC_037335.1,NC_032657.1,67713592,70956389,70956390,g,gc,1
NC_037335.1,NC_032657.1,67726391,70969189,70969193,t,tataN,4
NC_037335.1,NC_032657.1,67728024,70970828,70970829,a,at,1
NC_037335.1,NC_032657.1,67736342,70979155,70979156,C,CY,1
NC_037335.1,NC_032657.1,67739947,70982763,70982764,t,tg,1
NC_037335.1,NC_032657.1,67739966,70982783,70982784,g,ga,1
NC_037335.1,NC_032657.1,67739974,70982792,70982793,t,tg,1
NC_037335.1,NC_032657.1,67740666,70983485,70983487,c,ctg,2
NC_037335.1,NC_032657.1,67750434,70993249,70993253,T,TGCCA,4
NC_037335.1,NC_032657.1,67769771,71012584,71012588,g,gtttt,4
NC_037335.1,NC_032657.1,67786703,71029508,71029509,g,ga,1
NC_037335.1,NC_032657.1,67786709,71029515,71029522,t,tttttttc,7
NC_037335.1,NC_032657.1,67799925,71042761,71042767,a,aNNNNNN,6
NC_037335.1,NC_032657.1,67806764,71049606,71049607,a,ag,1
NC_037335.1,NC_032657.1,67827135,71069980,71069981,c,ct,1
NC_037335.1,NC_032657.1,67970873,71214338,71214340,a,aNN,2
NC_037335.1,NC_032657.1,67982783,71226251,71226252,C,CM,1
NC_037335.1,NC_032657.1,67984128,71227597,71227599,c,cct,2
NC_037335.1,NC_032657.1,68138398,71382430,71382431,C,CA,1
NC_037335.1,NC_032657.1,68143414,71387448,71387449,G,GS,1
NC_037335.1,NC_032657.1,68182613,71426678,71426679,A,AG,1
NC_037335.1,NC_032657.1,68182774,71426840,71426841,C,CT,1
NC_037335.1,NC_032657.1,68184195,71428261,71428262,t,ta,1
NC_037335.1,NC_032657.1,68324672,71514765,71514768,a,atat,3
NC_037335.1,NC_032657.1,68378741,71568947,71568948,G,GC,1
NC_037335.1,NC_032657.1,68380809,71571015,71571016,a,ag,1
NC_037335.1,NC_032657.1,68381634,71571840,71571841,c,ca,1
NC_037335.1,NC_032657.1,68387250,71577456,71577458,a,atc,2
NC_037335.1,NC_032657.1,68390655,71580142,71580143,a,at,1
NC_037335.1,NC_032657.1,68394226,71583711,71583733,g,gtaaagaacctatctgccagtgc,22
NC_037335.1,NC_032657.1,68424335,71613962,71613963,T,TY,1
NC_037335.1,NC_032657.1,68448264,71624872,71624884,A,ACCCAGCACAAGG,12
NC_037335.1,NC_032657.1,68460081,71636703,71636704,a,ac,1
NC_037335.1,NC_032657.1,68513838,71690469,71690471,t,tNN,2
NC_037335.1,NC_032657.1,68576440,71753075,71753076,a,ac,1
NC_037335.1,NC_032657.1,68829844,72038980,72038981,C,CA,1
NC_037335.1,NC_032657.1,68844629,72053767,72053768,a,aW,1
NC_037335.1,NC_032657.1,68949791,72158014,72158015,a,ag,1
NC_037335.1,NC_032657.1,68965951,72174178,72174180,t,ttg,2
NC_037335.1,NC_032657.1,68985181,72193410,72193422,a,aNNNNNNNNNNNN,12
NC_037335.1,NC_032657.1,69020798,72228634,72228635,G,GA,1
NC_037335.1,NC_032657.1,69089247,72292939,72292940,a,ac,1
NC_037335.1,NC_032657.1,69116790,72320487,72320502,A,AACCACCAAGTTATTT,15
NC_037335.1,NC_032657.1,69140707,72344401,72344402,a,at,1
NC_037335.1,NC_032657.1,69155872,72359638,72359639,T,TC,1
NC_037335.1,NC_032657.1,69156751,72360518,72360519,G,GT,1
NC_037335.1,NC_032657.1,69157364,72361132,72361134,A,AAG,2
NC_037335.1,NC_032657.1,69217884,72421549,72421550,G,GA,1
NC_037335.1,NC_032657.1,69454114,72518958,72518960,T,TTC,2
NC_037335.1,NC_032657.1,69507691,72576907,72576913,T,TACNNNN,6
NC_037335.1,NC_032657.1,69508284,72577506,72577507,a,ag,1
NC_037335.1,NC_032657.1,69513118,72582763,72582764,T,TK,1
NC_037335.1,NC_032657.1,69521518,72591165,72591166,C,CA,1
NC_037335.1,NC_032657.1,69604069,72674218,72674221,t,tctc,3
NC_037335.1,NC_032657.1,69604609,72674761,72674768,t,tttcactc,7
NC_037335.1,NC_032657.1,69605507,72675666,72675669,c,ctct,3
NC_037335.1,NC_032657.1,69624207,72694379,72694380,t,tc,1
NC_037335.1,NC_032657.1,69629729,72813530,72813537,G,GTAAGGGC,7
NC_037335.1,NC_032657.1,69630452,72814261,72814266,A,ATAAAT,5
NC_037335.1,NC_032657.1,69633010,72816824,72816828,t,taNNN,4
NC_037335.1,NC_032657.1,69687068,72756322,72756323,A,AC,1
NC_037335.1,NC_032657.1,69690911,72760166,72760167,A,AR,1
NC_037335.1,NC_032657.1,69695450,72764159,72764160,A,AG,1
NC_037335.1,NC_032657.1,69736626,72805340,72805343,a,agag,3
NC_037335.1,NC_032657.1,69736626,72856407,72856410,a,agag,3
NC_037335.1,NC_032657.1,69736736,72856532,72856533,a,ag,1
NC_037335.1,NC_032657.1,69749701,72869496,72869497,t,ta,1
NC_037335.1,NC_032657.1,69827490,72926416,72926421,t,taaaaa,5
NC_037335.1,NC_032657.1,69853221,72952150,72952154,C,CTTCM,4
NC_037335.1,NC_032657.1,69903895,73002940,73002941,C,CT,1
NC_037335.1,NC_032657.1,69941340,73040378,73040380,t,tta,2
NC_037335.1,NC_032657.1,69949535,73048571,73048573,T,TTG,2
NC_037335.1,NC_032657.1,69951912,73050955,73050959,C,CACTT,4
NC_037335.1,NC_032657.1,69956625,73055678,73055679,t,ta,1
NC_037335.1,NC_032657.1,70011820,73110831,73110832,T,TY,1
NC_037335.1,NC_032657.1,70048494,73147507,73147508,t,tg,1
NC_037335.1,NC_032657.1,70103938,73201865,73201883,A,AGATTTCTCAGCCTTAACN,18
NC_037335.1,NC_032657.1,70108185,73206043,73206044,T,TC,1
NC_037335.1,NC_032657.1,70300189,73260989,73260990,a,ag,1
NC_037335.1,NC_032657.1,70307467,73268270,73268271,C,CT,1
NC_037335.1,NC_032657.1,70315585,73276406,73276407,G,GC,1
NC_037335.1,NC_032657.1,70321051,73281834,73281835,A,AC,1
NC_037335.1,NC_032657.1,70343245,73302628,73302629,t,ta,1
NC_037335.1,NC_032657.1,70344352,73425007,73425008,G,GN,1
NC_037335.1,NC_032657.1,70344606,73425261,73425262,A,AT,1
NC_037335.1,NC_032657.1,70345120,73425770,73425771,C,CT,1
NC_037335.1,NC_032657.1,70345135,73425786,73425787,T,TG,1
NC_037335.1,NC_032657.1,70345149,73425801,73425802,C,CA,1
NC_037335.1,NC_032657.1,70345807,73426454,73426455,A,AG,1
NC_037335.1,NC_032657.1,70345920,73426567,73426568,t,tc,1
NC_037335.1,NC_032657.1,70346581,73427228,73427229,a,at,1
NC_037335.1,NC_032657.1,70347320,73427969,73427970,C,CT,1
NC_037335.1,NC_032657.1,70347433,73428083,73428084,t,ta,1
NC_037335.1,NC_032657.1,70358503,73439156,73439159,T,TACC,3
NC_037335.1,NC_032657.1,70358828,73439473,73439474,A,AC,1
NC_037335.1,NC_032657.1,70359334,73439977,73439981,G,GTGTT,4
NC_037335.1,NC_032657.1,70362657,73443267,73443269,c,ctt,2
NC_037335.1,NC_032657.1,70363450,73444054,73444061,g,gaaaaaaa,7
NC_037335.1,NC_032657.1,70363613,73444224,73444225,T,TC,1
NC_037335.1,NC_032657.1,70364136,73444748,73444749,g,ga,1
NC_037335.1,NC_032657.1,70365328,73445943,73445953,t,tcagttcagta,10
NC_037335.1,NC_032657.1,70365482,73446107,73446108,g,gc,1
NC_037335.1,NC_032657.1,70365503,73446129,73446131,c,cag,2
NC_037335.1,NC_032657.1,70365618,73446246,73446247,C,CA,1
NC_037335.1,NC_032657.1,70365662,73446291,73446292,t,ta,1
NC_037335.1,NC_032657.1,70366808,73447439,73447440,t,tc,1
NC_037335.1,NC_032657.1,70368404,73449038,73449042,c,ctttt,4
NC_037335.1,NC_032657.1,70396264,73692298,73692299,a,at,1
NC_037335.1,NC_032657.1,70411066,73707102,73707103,C,CA,1
NC_037335.1,NC_032657.1,70441308,73986652,73986653,C,CY,1
NC_037335.1,NC_032657.1,70489730,74033742,74033743,A,AG,1
NC_037335.1,NC_032657.1,70517648,74061696,74061697,G,GT,1
NC_037335.1,NC_032657.1,70542900,74086964,74086966,T,TTC,2
NC_037335.1,NC_032657.1,70551107,74095172,74095174,G,GAA,2
NC_037335.1,NC_032657.1,70570852,74115697,74115699,t,tga,2
NC_037335.1,NC_032657.1,70573193,74118040,74118041,A,AG,1
NC_037335.1,NC_032657.1,70620435,74165290,74165291,t,ta,1
NC_037335.1,NC_032657.1,70625084,74169926,74169927,T,TA,1
NC_037335.1,NC_032657.1,70639501,74184347,74184348,T,TK,1
NC_037335.1,NC_032657.1,70658466,74203326,74203327,g,gN,1
NC_037335.1,NC_032657.1,70727577,74272426,74272443,g,ggaagcccttggggcCAC,17
NC_037335.1,NC_032657.1,70731361,74276225,74276226,a,at,1
NC_037335.1,NC_032657.1,70732766,74277631,74277633,A,AAT,2
NC_037335.1,NC_032657.1,70749833,74294513,74294514,G,GS,1
NC_037335.1,NC_032657.1,70752012,74296692,74296695,g,ggaa,3
NC_037335.1,NC_032657.1,70756056,74300752,74300755,T,TTCA,3
NC_037335.1,NC_032657.1,70816356,74360968,74360969,T,TA,1
NC_037335.1,NC_032657.1,70818423,74362899,74362900,A,AC,1
NC_037335.1,NC_032657.1,70823875,74368352,74368353,G,GA,1
NC_037335.1,NC_032657.1,70849907,74394134,74394156,A,ACCACGAGGTTCCCCCATCCCGT,22
NC_037335.1,NC_032657.1,70867978,74412252,74412253,t,ta,1
NC_037335.1,NC_032657.1,70931383,74475536,74475537,a,at,1
NC_037335.1,NC_032657.1,70934233,74478401,74478402,T,TC,1
NC_037335.1,NC_032657.1,71062612,74643371,74643372,g,gt,1
NC_037335.1,NC_032657.1,71217998,74810237,74810239,C,CAT,2
NC_037335.1,NC_032657.1,71294351,74886596,74886598,T,TGC,2
NC_037335.1,NC_032657.1,71329603,74921868,74921869,c,cg,1
NC_037335.1,NC_032657.1,71347402,74939998,74940019,t,tcaNNNNNNNNNNNNNNNNNNN,21
NC_037335.1,NC_032657.1,71364355,74957013,74957014,G,GA,1
NC_037335.1,NC_032657.1,71368912,74961284,74961288,a,aNNNN,4
NC_037335.1,NC_032657.1,71507833,75084026,75084027,G,GA,1
NC_037335.1,NC_032657.1,71537424,75113616,75113619,c,cata,3
NC_037335.1,NC_032657.1,71563564,75139687,75139688,g,gc,1
NC_037335.1,NC_032657.1,71595346,75171482,75171485,c,ccaa,3
NC_037335.1,NC_032657.1,71619823,75195980,75195981,t,tg,1
NC_037335.1,NC_032657.1,71625815,75206721,75206722,a,ag,1
NC_037335.1,NC_032657.1,71632467,75213370,75213371,C,CA,1
NC_037335.1,NC_032657.1,71637389,75218290,75218291,g,gt,1
NC_037335.1,NC_032657.1,71825882,75426509,75426511,a,aat,2
NC_037335.1,NC_032657.1,71836270,75436907,75436912,g,gactga,5
NC_037335.1,NC_032657.1,71838580,75439224,75439225,a,at,1
NC_037335.1,NC_032657.1,71838952,75439599,75439600,g,ga,1
NC_037335.1,NC_032657.1,71858062,75460335,75460337,A,AAG,2
NC_037335.1,NC_032657.1,71863402,75465677,75465679,a,aag,2
NC_037335.1,NC_032657.1,71866339,75468616,75468618,A,AAC,2
NC_037335.1,NC_032657.1,71878413,75480678,75480679,a,ag,1
NC_037335.1,NC_032657.1,71897384,75499663,75499664,c,ca,1
NC_037335.1,NC_032657.1,71905027,75507308,75507333,a,accagattatatatatataatctggt,25
NC_037335.1,NC_032657.1,71917099,75519291,75519292,a,at,1
NC_037335.1,NC_032657.1,71924001,75526191,75526192,c,ca,1
NC_037335.1,NC_032657.1,71933344,75535536,75535538,t,taa,2
NC_037335.1,NC_032657.1,72008478,75610665,75610667,c,caa,2
NC_037335.1,NC_032657.1,72076944,75680829,75680830,T,TA,1
NC_037335.1,NC_032657.1,72076986,75680872,75680875,C,CCTT,3
NC_037335.1,NC_032657.1,72090629,75694522,75694524,c,cag,2
NC_037335.1,NC_032657.1,72123367,75727264,75727285,t,ttttaaaaatcaaattttttaa,21
NC_037335.1,NC_032657.1,72130509,75734025,75734026,a,at,1
NC_037335.1,NC_032657.1,72152176,75756156,75756157,g,gt,1
NC_037335.1,NC_032657.1,72152176,75948840,75948841,g,gt,1
NC_037335.1,NC_032657.1,72168533,75965159,75965162,a,aagt,3
NC_037335.1,NC_032657.1,72168533,75772512,75772515,a,aagt,3
NC_037335.1,NC_032657.1,72204665,75808662,75808671,g,gctgctgctc,9
NC_037335.1,NC_032657.1,72224599,76021482,76021486,g,gtgtR,4
NC_037335.1,NC_032657.1,72440087,76248524,76248525,g,gt,1
NC_037335.1,NC_032657.1,72452382,76261973,76261974,A,AR,1
NC_037335.1,NC_032657.1,72463936,76273530,76273532,T,TTG,2
NC_037335.1,NC_032657.1,72464975,76274571,76274574,a,acac,3
NC_037335.1,NC_032657.1,72465010,76274609,76274612,c,cctt,3
NC_037335.1,NC_032657.1,72493810,76303250,76303254,a,aaaac,4
NC_037335.1,NC_032657.1,72493928,76303372,76303385,a,aaaaaaaaaagaag,13
NC_037335.1,NC_032657.1,72493949,76303406,76303410,a,aaaac,4
NC_037335.1,NC_032657.1,72494703,76304164,76304166,t,ttc,2
NC_037335.1,NC_032657.1,72497152,76306612,76306625,t,tgaagtgatgggac,13
NC_037335.1,NC_032657.1,72520812,76330281,76330302,T,TGATTCTCTTCACAAAGAGAGG,21
NC_037335.1,NC_032657.1,72575536,76385028,76385029,C,CT,1
NC_037335.1,NC_032657.1,72577145,76386619,76386620,g,ga,1
NC_037335.1,NC_032657.1,72668398,76477535,76477536,c,ct,1
NC_037335.1,NC_032657.1,72765423,76577448,76577449,g,ga,1
NC_037335.1,NC_032657.1,72828202,76640123,76640125,G,GAT,2
NC_037335.1,NC_032657.1,72828207,76640130,76640134,G,GATCC,4
NC_037335.1,NC_032657.1,72851078,76663235,76663236,A,AC,1
NC_037335.1,NC_032657.1,73064275,76873285,76873286,g,gt,1
NC_037335.1,NC_032657.1,73117363,76926378,76926381,t,tagc,3
NC_037335.1,NC_032657.1,73120522,76929543,76929545,t,taa,2
NC_037335.1,NC_032657.1,73142427,76951449,76951450,a,ac,1
NC_037335.1,NC_032657.1,73547322,77471914,77471915,C,CG,1
NC_037335.1,NC_032657.1,73647354,77571696,77571697,C,CA,1
NC_037335.1,NC_032657.1,73673626,77597967,77597968,A,AG,1
NC_037335.1,NC_032657.1,73709404,77633757,77633758,T,TA,1
NC_037335.1,NC_032657.1,73735704,77660065,77660066,C,CT,1
NC_037335.1,NC_032657.1,73830754,77755062,77755063,C,CM,1
NC_037335.1,NC_032657.1,73845972,77770414,77770415,G,GT,1
NC_037335.1,NC_032657.1,73847699,77772141,77772144,C,CACG,3
NC_037335.1,NC_032657.1,73861299,77785722,77785731,T,TGAAATGGMA,9
NC_037335.1,NC_032657.1,73879019,77803451,77803454,T,TATC,3
NC_037335.1,NC_032657.1,73888211,77812655,77812656,t,tg,1
NC_037335.1,NC_032657.1,73958043,77882096,77882097,c,ca,1
NC_037335.1,NC_032657.1,73961404,77885468,77885472,C,CAGTT,4
NC_037335.1,NC_032657.1,73984927,77908997,77909001,t,tacac,4
NC_037335.1,NC_032657.1,73986224,77910298,77910299,T,TA,1
NC_037335.1,NC_032657.1,74085834,77999001,77999002,T,TC,1
NC_037335.1,NC_032657.1,74100047,78013229,78013232,A,AACC,3
NC_037335.1,NC_032657.1,74181756,78167909,78167911,a,aNN,2
NC_037335.1,NC_032657.1,74218655,78342618,78342619,A,AG,1
NC_037335.1,NC_032657.1,74345807,78467566,78467567,C,CY,1
NC_037335.1,NC_032657.1,74359546,78481318,78481322,t,tNNNN,4
NC_037335.1,NC_032657.1,74391846,78513633,78513634,A,AR,1
NC_037335.1,NC_032657.1,74402554,78524341,78524348,G,GKGGGCAT,7
NC_037335.1,NC_032657.1,74467885,78589687,78589690,t,ttaa,3
NC_037335.1,NC_032657.1,74473141,78594955,78594958,C,CACA,3
NC_037335.1,NC_032657.1,74489797,78611634,78611636,T,TCA,2
NC_037335.1,NC_032657.1,74499189,78621037,78621038,C,CM,1
NC_037335.1,NC_032657.1,74513807,78635628,78635629,G,GR,1
NC_037335.1,NC_032657.1,74517710,78639532,78639536,c,caata,4
NC_037335.1,NC_032657.1,74530595,78652421,78652422,C,CS,1
NC_037335.1,NC_032657.1,74549963,78671791,78671792,C,CT,1
NC_037335.1,NC_032657.1,74559898,78681730,78681731,T,TG,1
NC_037335.1,NC_032657.1,74580691,78702214,78702222,c,ctcctggaa,8
NC_037335.1,NC_032657.1,74581632,78703163,78703164,t,ta,1
NC_037335.1,NC_032657.1,74593399,78714973,78715016,C,CTGGGGTGGAATNNNNNNNNNNNNNNNNNNNNNNNNNNNNNNNN,43
NC_037335.1,NC_032657.1,74606621,78728256,78728257,T,TA,1
NC_037335.1,NC_032657.1,74607055,78728693,78728702,g,gggaaacagt,9
NC_037335.1,NC_032657.1,74610644,78732295,78732302,g,ggattcat,7
NC_037335.1,NC_032657.1,74620981,78740215,78740216,g,gc,1
NC_037335.1,NC_032657.1,74626347,78745590,78745592,t,tta,2
NC_037335.1,NC_032657.1,74688887,78807486,78807487,G,GA,1
NC_037335.1,NC_032657.1,74695156,78814542,78814543,A,AR,1
NC_037335.1,NC_032657.1,74696316,78815703,78815704,G,GR,1
NC_037335.1,NC_032657.1,74720589,78840004,78840005,T,TG,1
NC_037335.1,NC_032657.1,74783187,78902611,78902614,a,aaat,3
NC_037335.1,NC_032657.1,74790485,78909915,78909916,T,TC,1
NC_037335.1,NC_032657.1,74810581,78930065,78930067,C,CAS,2
NC_037335.1,NC_032657.1,74882242,79002368,79002376,G,GAAGAGGCT,8
NC_037335.1,NC_032657.1,74889123,79009355,79009356,T,TY,1
NC_037335.1,NC_032657.1,74928812,79049049,79049052,c,cttt,3
NC_037335.1,NC_032657.1,74972225,79093034,79093035,c,ct,1
NC_037335.1,NC_032657.1,75004065,79124888,79124898,T,TCACAAGTAAA,10
NC_037335.1,NC_032657.1,75006696,79127530,79127531,t,ta,1
NC_037335.1,NC_032657.1,75025026,79145558,79145559,g,ga,1
NC_037335.1,NC_032657.1,75116282,79236560,79236562,t,tNN,2
NC_037335.1,NC_032657.1,75135408,79255707,79255709,c,cct,2
NC_037335.1,NC_032657.1,75179863,79315431,79315432,a,at,1
NC_037335.1,NC_032657.1,75249005,79392666,79392667,T,TC,1
NC_037335.1,NC_032657.1,75315500,79459205,79459215,g,gggttgcctgt,10
NC_037335.1,NC_032657.1,75320662,79464377,79464380,t,tctc,3
NC_037335.1,NC_032657.1,75322613,79466331,79466332,T,TC,1
NC_037335.1,NC_032657.1,75330250,79473969,79473972,A,AGTG,3
NC_037335.1,NC_032657.1,75412472,79634708,79634730,C,CAGAAAAGTTACTGCCAATAGCA,22
NC_037335.1,NC_032657.1,75417523,79639786,79639787,a,at,1
NC_037335.1,NC_032657.1,75422413,79644677,79644679,c,cat,2
NC_037335.1,NC_032657.1,75431400,79653666,79653671,G,GTTTTC,5
NC_037335.1,NC_032657.1,75456252,79678539,79678541,a,act,2
NC_037335.1,NC_032657.1,75552167,79772442,79772443,t,ta,1
NC_037335.1,NC_032657.1,75555486,79775763,79775766,t,tcta,3
NC_037335.1,NC_032657.1,75573571,79793842,79793843,t,ta,1
NC_037335.1,NC_032657.1,75607884,79827842,79827843,A,AN,1
NC_037335.1,NC_032657.1,75644906,79864870,79864873,c,ctct,3
NC_037335.1,NC_032657.1,75672690,79892660,79892666,t,taaaata,6
NC_037335.1,NC_032657.1,75687926,79907904,79907908,c,cRTAA,4
NC_037335.1,NC_032657.1,75771397,79991384,79991385,G,GS,1
NC_037335.1,NC_032657.1,75792092,80012080,80012081,g,ga,1
NC_037335.1,NC_032657.1,75794179,80014168,80014169,T,TW,1
NC_037335.1,NC_032657.1,75807759,80027749,80027753,T,TTAAC,4
NC_037335.1,NC_032657.1,75810479,80030474,80030475,A,AR,1
NC_037335.1,NC_032657.1,75822346,80042343,80042344,c,ct,1
NC_037335.1,NC_032657.1,75829765,80049763,80049766,T,TGTA,3
NC_037335.1,NC_032657.1,75860782,80081173,80081176,T,TTCC,3
NC_037335.1,NC_032657.1,75900394,80120792,80120794,A,AAG,2
NC_037335.1,NC_032657.1,75902596,80122998,80123000,a,act,2
NC_037335.1,NC_032657.1,75943664,80164279,80164280,T,TA,1
NC_037335.1,NC_032657.1,75945435,80166053,80166060,C,CAACAAAA,7
NC_037335.1,NC_032657.1,75981757,80202176,80202186,C,CAGGAGCTNNN,10
NC_037335.1,NC_032657.1,76082706,80303563,80303568,a,aggtct,5
NC_037335.1,NC_032657.1,76083017,80303879,80303880,T,TM,1
NC_037335.1,NC_032657.1,76095029,80315888,80315907,T,TTGTGGATTTGRWWTGTGTK,19
NC_037335.1,NC_032657.1,76142617,80363484,80363485,c,cg,1
NC_037335.1,NC_032657.1,76153172,80374060,80374061,t,tc,1
NC_037335.1,NC_032657.1,76185404,80406290,80406291,C,CY,1
NC_037335.1,NC_032657.1,76258537,80479523,80479530,t,tgttttca,7
NC_037335.1,NC_032657.1,76282198,80503193,80503194,A,AG,1
NC_037335.1,NC_032657.1,76292797,80513796,80513797,a,ag,1
NC_037335.1,NC_032657.1,76293576,80514576,80514577,c,cg,1
NC_037335.1,NC_032657.1,76315151,80536180,80536181,G,GA,1
NC_037335.1,NC_032657.1,76327495,80548527,80548528,c,ct,1
NC_037335.1,NC_032657.1,76350805,80571838,80571841,C,CCAG,3
NC_037335.1,NC_032657.1,76436526,80657571,80657572,G,GT,1
NC_037335.1,NC_032657.1,76496988,80718045,80718046,A,AW,1
NC_037335.1,NC_032657.1,76548050,80769037,80769039,a,aac,2
NC_037335.1,NC_032657.1,76550749,80771734,80771735,c,ct,1
NC_037335.1,NC_032657.1,76561002,80781955,80781956,t,ta,1
NC_037335.1,NC_032657.1,76562156,80783103,80783104,A,AG,1
NC_037335.1,NC_032657.1,76567307,80788254,80788255,T,TG,1
NC_037335.1,NC_032657.1,76590636,80811578,80811583,t,ttaaNN,5
NC_037335.1,NC_032657.1,76626807,80847826,80847912,c,caggagggttcttNNNttttttttttaaactttacataattgtattagttttgccaaatatcaaaatgaatctgccacaggtacaca,86
NC_037335.1,NC_032657.1,76639037,80860132,80860133,a,at,1
NC_037335.1,NC_032657.1,76652170,80873455,80873456,t,tg,1
NC_037335.1,NC_032657.1,76656683,80877969,80877970,A,AW,1
NC_037335.1,NC_032657.1,76665880,80887168,80887170,C,CAT,2
NC_037335.1,NC_032657.1,76667064,80888349,80888350,G,GR,1
NC_037335.1,NC_032657.1,76678732,80900016,80900019,g,gtgt,3
NC_037335.1,NC_032657.1,76702143,80923201,80923202,C,CM,1
NC_037335.1,NC_032657.1,76721790,80942851,80942853,c,cat,2
NC_037335.1,NC_032657.1,76767222,80988227,80988229,a,agt,2
NC_037335.1,NC_032657.1,76771004,80992011,80992019,c,caaaaaaaa,8
NC_037335.1,NC_032657.1,76789349,81010370,81010372,a,aac,2
NC_037335.1,NC_032657.1,76789907,81010930,81010932,c,ctg,2
NC_037335.1,NC_032657.1,76968113,81162148,81162151,c,cctt,3
NC_037335.1,NC_032657.1,76978586,81172625,81172628,C,CCTT,3
NC_037335.1,NC_032657.1,77074225,81266974,81266975,a,at,1
NC_037335.1,NC_032657.1,77081733,81274778,81274780,t,tNN,2
NC_037335.1,NC_032657.1,77186390,81378233,81378235,t,tNN,2
NC_037335.1,NC_032657.1,77267451,81459218,81459224,C,CTATATG,6
NC_037335.1,NC_032657.1,77270446,81462238,81462239,c,ct,1
NC_037335.1,NC_032657.1,77270976,81462769,81462770,g,ga,1
NC_037335.1,NC_032657.1,77364239,81555944,81555947,t,tagc,3
NC_037335.1,NC_032657.1,77376931,81568642,81568661,T,TGAGAAAAACGTGTGCAAKW,19
NC_037335.1,NC_032657.1,77383333,81575067,81575068,G,GS,1
NC_037335.1,NC_032657.1,77450624,81641782,81641783,c,ca,1
NC_037335.1,NC_032657.1,77452418,81643479,81643486,c,ctttcatt,7
NC_037335.1,NC_032657.1,77459374,81650307,81650312,t,tgggag,5
NC_037335.1,NC_032657.1,77533794,81724798,81724799,a,ag,1
NC_037335.1,NC_032657.1,77600737,81792506,81792509,T,TATG,3
NC_037335.1,NC_032657.1,77606347,81814390,81814391,T,TK,1
NC_037335.1,NC_032657.1,77715581,81855417,81855418,C,CY,1
NC_037335.1,NC_032657.1,77755575,81894828,81894830,c,cat,2
NC_037335.1,NC_032657.1,77930694,82077628,82077629,G,GT,1
NC_037335.1,NC_032657.1,78090422,82296461,82296464,T,TTAC,3
NC_037335.1,NC_032657.1,78108018,82313960,82313967,A,ATTCTGGT,7
NC_037335.1,NC_032657.1,78145943,82364736,82364758,C,CGTTTAAACGNNNNNNNNNNNNA,22
NC_037335.1,NC_032657.1,78150263,82369079,82369080,G,GA,1
NC_037335.1,NC_032657.1,78220646,82439470,82439471,A,AC,1
NC_037335.1,NC_032657.1,78329157,82550406,82550407,a,ag,1
NC_037335.1,NC_032657.1,78431832,82653190,82653192,g,ggt,2
NC_037335.1,NC_032657.1,78434541,82655903,82655904,g,ga,1
NC_037335.1,NC_032657.1,78523970,82685449,82685450,t,ta,1
NC_037335.1,NC_032657.1,78537282,82698781,82698784,a,acag,3
NC_037335.1,NC_032657.1,78552105,82713374,82713375,C,CT,1
NC_037335.1,NC_032657.1,78571870,82732569,82732570,a,at,1
NC_037335.1,NC_032657.1,78608178,82768932,82768934,a,aag,2
NC_037335.1,NC_032657.1,78625584,82786155,82786157,A,AAC,2
NC_037335.1,NC_032657.1,78763481,82888033,82888037,A,AAAGG,4
NC_037335.1,NC_032657.1,78763486,82888042,82888076,T,TGACTTTAAACTTTATGATTATNNNNNCCTTTATG,34
NC_037335.1,NC_032657.1,78766853,82891441,82891442,G,GS,1
NC_037335.1,NC_032657.1,78796079,82920715,82920716,g,ga,1
NC_037335.1,NC_032657.1,78799660,82924745,82924746,g,gc,1
NC_037335.1,NC_032657.1,78832754,82958309,82958313,C,CAAAG,4
NC_037335.1,NC_032657.1,78903872,83029442,83029443,g,gt,1
NC_037335.1,NC_032657.1,78909047,83034618,83034622,g,gacac,4
NC_037335.1,NC_032657.1,78933680,83059774,83059775,t,tN,1
NC_037335.1,NC_032657.1,78933864,83059959,83059964,t,ttcttc,5
NC_037335.1,NC_032657.1,79055663,83182440,83182464,A,AGCGCGCGCAGGGGGAGGGCGGGGT,24
NC_037335.1,NC_032657.1,79085604,83212408,83212410,g,gta,2
NC_037335.1,NC_032657.1,79260954,83389117,83389118,T,TA,1
NC_037335.1,NC_032657.1,79262236,83390400,83390404,C,CCGTT,4
NC_037335.1,NC_032657.1,79266479,83394647,83394668,A,AGTGTTTGATGATGGTAGCACC,21
NC_037335.1,NC_032657.1,79267616,83395805,83395806,T,TW,1
NC_037335.1,NC_032657.1,79267945,83396135,83396136,a,ac,1
NC_037335.1,NC_032657.1,79312219,83440435,83440439,a,aaaNN,4
NC_037335.1,NC_032657.1,79367886,83496057,83496063,c,ctttttt,6
NC_037335.1,NC_032657.1,79402814,83530990,83530991,T,TK,1
NC_037335.1,NC_032657.1,79450147,83578323,83578325,G,GTR,2
NC_037335.1,NC_032657.1,79508486,83637116,83637117,c,cN,1
NC_037335.1,NC_032657.1,79739166,83912830,83912831,G,GS,1
NC_037335.1,NC_032657.1,79791564,83965491,83965492,c,ca,1
NC_037335.1,NC_032657.1,80105254,84347602,84347603,a,at,1
NC_037335.1,NC_032657.1,80105256,84347605,84347606,t,ta,1
NC_037335.1,NC_032657.1,80164774,84391283,84391284,g,gc,1
NC_037335.1,NC_032657.1,80222650,84449170,84449171,T,TG,1
NC_037335.1,NC_032657.1,80247736,84474271,84474272,T,TW,1
NC_037335.1,NC_032657.1,80248116,84474651,84474652,C,CT,1
NC_037335.1,NC_032657.1,80248139,84474675,84474699,a,aaaaaaaaaaaaaaagatataattt,24
NC_037335.1,NC_032657.1,80251899,84478459,84478460,A,AN,1
NC_037335.1,NC_032657.1,80254514,84487510,84487511,g,gt,1
NC_037335.1,NC_032657.1,80432493,84722398,84722399,a,ag,1
NC_037335.1,NC_032657.1,80434028,84723934,84723935,c,ca,1
NC_037335.1,NC_032657.1,80473036,84762946,84762947,A,AT,1
NC_037335.1,NC_032657.1,80482532,84772443,84772446,g,gaaa,3
NC_037335.1,NC_032657.1,80512769,84822748,84822752,g,ggttt,4
NC_037335.1,NC_032657.1,80574324,84882035,84882036,G,GC,1
NC_037335.1,NC_032657.1,80580184,84887896,84887898,C,CTG,2
NC_037335.1,NC_032657.1,80585968,84893682,84893686,t,tttta,4
NC_037335.1,NC_032657.1,80585996,84893714,84893715,c,ct,1
NC_037335.1,NC_032657.1,80684362,84995399,84995400,t,tg,1
NC_037335.1,NC_032657.1,80704621,85042569,85042570,G,GA,1
NC_037335.1,NC_032657.1,80712232,85050182,85050183,T,TK,1
NC_037335.1,NC_032657.1,80774193,85113718,85113719,g,ga,1
NC_037335.1,NC_032657.1,80806175,85145489,85145490,t,tg,1
NC_037335.1,NC_032657.1,80822468,85161788,85161789,t,tc,1
NC_037335.1,NC_032657.1,80826390,85165714,85165715,t,tg,1
NC_037335.1,NC_032657.1,80826837,85166162,85166163,a,at,1
NC_037335.1,NC_032657.1,80859177,85198565,85198567,G,GSA,2
NC_037335.1,NC_032657.1,80868355,85207747,85207749,g,gaa,2
NC_037335.1,NC_032657.1,80887909,85227306,85227307,t,ta,1
NC_037335.1,NC_032657.1,80909894,85248832,85248833,a,ac,1
NC_037335.1,NC_032657.1,80914498,85253443,85253446,A,AAAT,3
NC_037335.1,NC_032657.1,80930753,85270499,85270500,t,tN,1
NC_037335.1,NC_032657.1,80937183,85276932,85276933,g,ga,1
NC_037335.1,NC_032657.1,80959588,85299898,85299899,c,ca,1
NC_037335.1,NC_032657.1,80975798,85316114,85316117,G,GCTA,3
NC_037335.1,NC_032657.1,80987668,85328760,85328761,g,gc,1
NC_037335.1,NC_032657.1,81000332,85340405,85340406,g,gc,1
NC_037335.1,NC_032657.1,81001131,85341205,85341206,T,TA,1
NC_037335.1,NC_032657.1,81011419,85351515,85351516,t,tc,1
NC_037335.1,NC_032657.1,81048952,85389054,85389057,T,TCTA,3
NC_037335.1,NC_032657.1,81097626,85437735,85437736,t,tN,1
NC_037335.1,NC_032657.1,81105255,85445364,85445366,C,CCT,2
NC_037335.1,NC_032657.1,81109365,85449476,85449477,T,TA,1
NC_037335.1,NC_032657.1,81111279,85451391,85451392,A,AG,1
NC_037335.1,NC_032657.1,81113737,85453862,85453863,C,CY,1
NC_037335.1,NC_032657.1,81138068,85478192,85478193,g,gt,1
NC_037335.1,NC_032657.1,81144233,85484360,85484361,A,AG,1
NC_037335.1,NC_032657.1,81146592,85486720,85486721,g,ga,1
NC_037335.1,NC_032657.1,81146635,85486764,85486765,c,cN,1
NC_037335.1,NC_032657.1,81220756,85560900,85560906,t,tNNNNNN,6
NC_037335.1,NC_032657.1,81335014,85674832,85674834,G,GGT,2
NC_037335.1,NC_032657.1,81576768,85920243,85920244,c,cg,1
NC_037335.1,NC_032657.1,81593813,85937305,85937307,a,att,2
NC_037335.1,NC_032657.1,81593936,85937430,85937431,T,TA,1
NC_037335.1,NC_032657.1,81593975,85937469,85937470,G,GA,1
NC_037335.1,NC_032657.1,81627796,85971303,85971304,c,ct,1
NC_037335.1,NC_032657.1,81714683,86058152,86058153,g,ga,1
NC_037335.1,NC_032657.1,81714791,86058261,86058262,a,at,1
NC_037335.1,NC_032657.1,81731603,86076990,86076991,t,ta,1
NC_037335.1,NC_032657.1,82099918,86547724,86547728,c,cgtgt,4
NC_037335.1,NC_032657.1,82101331,86549142,86549143,A,AN,1
NC_037335.1,NC_032657.1,82119371,86578275,86578276,A,AC,1
NC_037335.1,NC_032657.1,82124497,86583400,86583402,C,CCT,2
NC_037335.1,NC_032657.1,82170258,86629169,86629170,g,gc,1
NC_037335.1,NC_032657.1,82212633,86671533,86671534,T,TC,1
NC_037335.1,NC_032657.1,82237619,86695653,86695654,C,CA,1
NC_037335.1,NC_032657.1,82254466,86712504,86712505,g,gc,1
NC_037335.1,NC_032657.1,82289882,86747933,86747934,A,AC,1
NC_037335.1,NC_032657.1,82306994,86764721,86764722,G,GA,1
NC_037335.1,NC_032657.1,82327182,86784879,86784880,T,TK,1
NC_037335.1,NC_032657.1,82636550,86810086,86810090,G,GTTGA,4
NC_037335.1,NC_032657.1,82640944,86814488,86814504,a,aaaaaagataatataat,16
NC_037335.1,NC_032657.1,82650287,86823850,86823851,g,gt,1
NC_037335.1,NC_032657.1,82658480,86832048,86832049,t,tc,1
NC_037335.1,NC_032657.1,82677792,86851356,86851358,a,aat,2
NC_037335.1,NC_032657.1,82679247,86852813,86852814,a,ac,1
NC_037335.1,NC_032657.1,82727940,86901542,86901544,G,GGR,2
NC_037335.1,NC_032657.1,82746979,86920578,86920579,a,aG,1
NC_037335.1,NC_032657.1,82748461,86922063,86922064,a,ag,1
NC_037335.1,NC_032657.1,82748971,86922564,86922565,a,ac,1
NC_037335.1,NC_032657.1,82749557,86923151,86923153,t,tgc,2
NC_037335.1,NC_032657.1,82749964,86923560,86923561,a,ac,1
NC_037335.1,NC_032657.1,82750188,86923785,86923786,c,ct,1
NC_037335.1,NC_032657.1,82751330,86924928,86924929,g,gt,1
NC_037335.1,NC_032657.1,82751453,86925052,86925054,a,agt,2
NC_037335.1,NC_032657.1,82751496,86925097,86925098,g,gt,1
NC_037335.1,NC_032657.1,82752543,86926145,86926146,g,gt,1
NC_037335.1,NC_032657.1,82831591,87008304,87008305,c,ct,1
NC_037335.1,NC_032657.1,82835317,87012031,87012034,G,GGAA,3
NC_037335.1,NC_032657.1,82888608,87065332,87065333,G,GR,1
NC_037335.1,NC_032657.1,82922484,87099207,87099208,A,AC,1
NC_037335.1,NC_032657.1,82930654,87107386,87107389,T,TAAG,3
NC_037335.1,NC_032657.1,82938202,87114940,87114941,c,cg,1
NC_037335.1,NC_032657.1,82940836,87117578,87117579,g,ga,1
NC_037335.1,NC_032657.1,82949449,87124653,87124656,t,tctc,3
NC_037335.1,NC_032657.1,82976804,87152012,87152014,G,GTA,2
NC_037335.1,NC_032657.1,82994800,87171073,87171074,g,ga,1
NC_037335.1,NC_032657.1,82994807,87171081,87171082,c,ct,1
NC_037335.1,NC_032657.1,83001693,87177967,87177980,c,cttcactttcactt,13
NC_037335.1,NC_032657.1,83002693,87179035,87179036,G,GR,1
NC_037335.1,NC_032657.1,83027180,87203516,87203521,G,GGAAGC,5
NC_037335.1,NC_032657.1,83034011,87210355,87210362,g,gcacgcca,7
NC_037335.1,NC_032657.1,83041462,87217813,87217814,g,ga,1
NC_037335.1,NC_032657.1,83042252,87218604,87218605,G,GR,1
NC_037335.1,NC_032657.1,83044658,87221014,87221015,G,GR,1
NC_037335.1,NC_032657.1,83048674,87224977,87224978,A,AG,1
NC_037335.1,NC_032657.1,83156301,87333388,87333392,c,cctgt,4
NC_037335.1,NC_032657.1,83203122,87380214,87380217,A,AATG,3
NC_037335.1,NC_032657.1,83279363,87456462,87456468,T,TAGAACA,6
NC_037335.1,NC_032657.1,83279365,87456470,87456473,T,TAAC,3
NC_037335.1,NC_032657.1,83314151,87490578,87490589,t,ttatggcttgca,11
NC_037335.1,NC_032657.1,83314158,87490596,87490603,A,ACGATCTT,7
NC_037335.1,NC_032657.1,83322693,87499169,87499170,c,ca,1
NC_037335.1,NC_032657.1,83324284,87500768,87500773,a,aaaaag,5
NC_037335.1,NC_032657.1,83343821,87520313,87520315,c,cta,2
NC_037335.1,NC_032657.1,83379750,87612345,87612346,A,AW,1
NC_037335.1,NC_032657.1,83381433,87614027,87614029,a,aac,2
NC_037335.1,NC_032657.1,83406919,87639426,87639429,a,aagg,3
NC_037335.1,NC_032657.1,83409014,87641524,87641525,C,CT,1
NC_037335.1,NC_032657.1,83415561,87648072,87648075,T,TTTC,3
NC_037335.1,NC_032657.1,83441235,87673760,87673761,G,GT,1
NC_037335.1,NC_032657.1,83448370,87680905,87680908,c,cttt,3
NC_037335.1,NC_032657.1,83606875,87772128,87772129,g,gt,1
NC_037335.1,NC_032657.1,83618349,87783603,87783604,g,ga,1
NC_037335.1,NC_032657.1,83659475,87824739,87824753,G,GAAGCACAGAGacta,14
NC_037335.1,NC_032657.1,83701360,87866701,87866706,t,tggcta,5
NC_037335.1,NC_032657.1,83704690,87870037,87870041,t,tNNNN,4
NC_037335.1,NC_032657.1,83735725,87901260,87901262,a,att,2
NC_037335.1,NC_032657.1,83788515,87955548,87955549,t,ta,1
NC_037335.1,NC_032657.1,83815186,87982327,87982329,A,AAC,2
NC_037335.1,NC_032657.1,83823910,87991051,87991052,t,tg,1
NC_037335.1,NC_032657.1,83885481,88052683,88052684,a,ag,1
NC_037335.1,NC_032657.1,84038768,88206027,88206028,C,CT,1
NC_037335.1,NC_032657.1,84040799,88208059,88208060,t,tc,1
NC_037335.1,NC_032657.1,84109956,88277154,88277155,a,ac,1
NC_037335.1,NC_032657.1,84182263,88349017,88349023,a,aatgcgg,6
NC_037335.1,NC_032657.1,84202278,88368569,88368577,T,TAGNNNNNN,8
NC_037335.1,NC_032657.1,84229665,88395852,88395853,G,GR,1
NC_037335.1,NC_032657.1,84316594,88467870,88467871,G,GT,1
NC_037335.1,NC_032657.1,84368889,88539996,88539997,g,gt,1
NC_037335.1,NC_032657.1,84421394,88592256,88592257,G,GA,1
NC_037335.1,NC_032657.1,84422394,88593257,88593258,t,tg,1
NC_037335.1,NC_032657.1,84429611,88600504,88600510,a,aatctgt,6
NC_037335.1,NC_032657.1,84434257,88605157,88605158,a,ac,1
NC_037335.1,NC_032657.1,84439460,88610358,88610370,T,TGATTGAGACTTA,12
NC_037335.1,NC_032657.1,84468992,88639885,88639886,c,ca,1
NC_037335.1,NC_032657.1,84471721,88642615,88642616,a,at,1
NC_037335.1,NC_032657.1,84471904,88642799,88642809,t,ttgggtggcac,10
NC_037335.1,NC_032657.1,84501160,88672075,88672076,A,AT,1
NC_037335.1,NC_032657.1,84510043,88680960,88680965,g,ggtaca,5
NC_037335.1,NC_032657.1,84510045,88680967,88680969,a,atg,2
NC_037335.1,NC_032657.1,84519724,88690645,88690646,T,TC,1
NC_037335.1,NC_032657.1,84652763,88823977,88823978,g,gt,1
NC_037335.1,NC_032657.1,84694761,88865804,88865805,T,TY,1
NC_037335.1,NC_032657.1,84823673,89008137,89008138,A,AC,1
NC_037335.1,NC_032657.1,84828904,89013375,89013376,G,GA,1
NC_037335.1,NC_032657.1,84829190,89013662,89013664,g,gaa,2
NC_037335.1,NC_032657.1,84846368,89030847,89030848,T,TC,1
NC_037335.1,NC_032657.1,84889069,89073557,89073560,T,TTTA,3
NC_037335.1,NC_032657.1,84932257,89116196,89116199,a,aaat,3
NC_037335.1,NC_032657.1,84989487,89238066,89238067,G,GT,1
NC_037335.1,NC_032657.1,85058299,89306763,89306764,a,ac,1
NC_037335.1,NC_032657.1,85146454,89437230,89437232,t,tNN,2
NC_037335.1,NC_032657.1,85218164,89508450,89508451,G,GA,1
NC_037335.1,NC_032657.1,85234384,89524671,89524673,c,ctg,2
NC_037335.1,NC_032657.1,85242779,89533068,89533069,C,CY,1
NC_037335.1,NC_032657.1,85244656,89534946,89534952,t,tgtccaa,6
NC_037335.1,NC_032657.1,85252133,89542428,89542434,G,GGCCTGC,6
NC_037335.1,NC_032657.1,85303078,89593345,89593349,C,CAAGT,4
NC_037335.1,NC_032657.1,85307452,89597865,89597866,c,ct,1
NC_037335.1,NC_032657.1,85313906,89604321,89604322,T,TC,1
NC_037335.1,NC_032657.1,85324907,89615327,89615338,A,ATtacatggtat,11
NC_037335.1,NC_032657.1,85339914,89630347,89630350,t,tagc,3
NC_037335.1,NC_032657.1,85339962,89630398,89630399,c,ct,1
NC_037335.1,NC_032657.1,85339968,89630405,89630408,c,ccct,3
NC_037335.1,NC_032657.1,85366261,89656704,89656705,T,TC,1
NC_037335.1,NC_032657.1,85376130,89666590,89666591,T,TC,1
NC_037335.1,NC_032657.1,85382785,89673244,89673245,G,GT,1
NC_037335.1,NC_032657.1,85421278,89711422,89711423,c,cg,1
NC_037335.1,NC_032657.1,85562736,89834172,89834173,a,ac,1
NC_037335.1,NC_032657.1,85578516,89849956,89849957,g,ga,1
NC_037335.1,NC_032657.1,85806197,90091505,90091506,C,CT,1
NC_037335.1,NC_032657.1,85846923,90131898,90131899,G,GT,1
NC_037335.1,NC_032657.1,85879237,90164216,90164218,t,tac,2
NC_037335.1,NC_032657.1,85893373,90178353,90178363,A,ATGTATATGTT,10
NC_037335.1,NC_032657.1,85928444,90213434,90213435,A,AC,1
NC_037335.1,NC_032657.1,85966765,90251242,90251243,T,TG,1
NC_037335.1,NC_032657.1,85971135,90255595,90255596,G,GA,1
NC_037335.1,NC_032657.1,85981236,90265691,90265693,t,ttg,2
NC_037335.1,NC_032657.1,86001744,90286204,90286210,G,GGTGGTT,6
NC_037335.1,NC_032657.1,86013705,90298147,90298149,C,CCG,2
NC_037335.1,NC_032657.1,86013741,90298185,90298186,a,at,1
NC_037335.1,NC_032657.1,86065699,90349937,90349938,A,AT,1
NC_037335.1,NC_032657.1,86078323,90362563,90362564,g,ga,1
NC_037335.1,NC_032657.1,86091030,90375271,90375277,g,gtggggt,6
NC_037335.1,NC_032657.1,86119305,90403554,90403555,G,GA,1
NC_037335.1,NC_032657.1,86127345,90411612,90411614,C,CCT,2
NC_037335.1,NC_032657.1,86129599,90413871,90413872,C,CY,1
NC_037335.1,NC_032657.1,86237565,90530519,90530520,T,TA,1
NC_037335.1,NC_032657.1,86286514,90580481,90580482,a,aN,1
NC_037335.1,NC_032657.1,86288625,90582593,90582594,c,ca,1
NC_037335.1,NC_032657.1,86288638,90582607,90582609,c,caa,2
NC_037335.1,NC_032657.1,86319622,90613596,90613597,T,TK,1
NC_037335.1,NC_032657.1,86412352,90715834,90715835,A,AG,1
NC_037335.1,NC_032657.1,86575846,90891954,90891956,a,act,2
NC_037335.1,NC_032657.1,86585060,90901170,90901181,a,aNNNNNNNNNNN,11
NC_037335.1,NC_032657.1,86617919,90933916,90933938,G,GNNNNNNNNNNNNNNNNNNNNNN,22
NC_037335.1,NC_032657.1,86654806,90970828,90970829,G,GR,1
NC_037335.1,NC_032657.1,86662109,90978131,90978132,t,ta,1
NC_037335.1,NC_032657.1,86673348,90988918,90988922,C,CTGTY,4
NC_037335.1,NC_032657.1,86814778,91120926,91120927,A,AT,1
NC_037335.1,NC_032657.1,86834123,91140243,91140244,a,ag,1
NC_037335.1,NC_032657.1,86905122,91211255,91211257,a,aNN,2
NC_037335.1,NC_032657.1,86917982,91224036,91224037,G,GA,1
NC_037335.1,NC_032657.1,86920128,91226183,91226193,t,tNNNNNNNNNN,10
NC_037335.1,NC_032657.1,87054456,91360679,91360680,c,ct,1
NC_037335.1,NC_032657.1,87073114,91379303,91379310,g,gggggggt,7
NC_037335.1,NC_032657.1,87117005,91422946,91422948,C,CTT,2
NC_037335.1,NC_032657.1,87131141,91465852,91465853,t,tg,1
NC_037335.1,NC_032657.1,87156796,91435384,91435385,T,TR,1
NC_037335.1,NC_032657.1,87235079,91558707,91558712,C,CTCTTT,5
NC_037335.1,NC_032657.1,87265711,91589351,91589361,t,ttctgtgtgtg,10
NC_037335.1,NC_032657.1,87265844,91589495,91589496,c,ct,1
NC_037335.1,NC_032657.1,87280661,91616420,91616426,A,AATGGGT,6
NC_037335.1,NC_032657.1,87289651,91640719,91640721,a,aag,2
NC_037335.1,NC_032657.1,87307035,91657986,91657987,a,at,1
NC_037335.1,NC_032657.1,87380792,91742680,91742681,A,AT,1
NC_037335.1,NC_032657.1,87388287,91750178,91750206,T,TGANNNNNNNNNNNNNNNAATACTGGTGC,28
NC_037335.1,NC_032657.1,87411805,91773723,91773735,g,gaagaaatcaaaa,12
NC_037335.1,NC_032657.1,87415126,91777056,91777058,a,aat,2
NC_037335.1,NC_032657.1,87415163,91777095,91777097,g,gaa,2
NC_037335.1,NC_032657.1,87427550,91789544,91789546,t,tNN,2
NC_037335.1,NC_032657.1,87433021,91795016,91795017,g,gt,1
NC_037335.1,NC_032657.1,87446401,91808397,91808399,a,aat,2
NC_037335.1,NC_032657.1,87454615,91816075,91816076,a,at,1
NC_037335.1,NC_032657.1,87460300,91821762,91821764,t,tag,2
NC_037335.1,NC_032657.1,87497764,91859161,91859162,g,ga,1
NC_037335.1,NC_032657.1,87500629,91862028,91862029,a,at,1
NC_037335.1,NC_032657.1,87514413,91875837,91875842,G,GATATA,5
NC_037335.1,NC_032657.1,87522038,91883497,91883498,a,ag,1
NC_037335.1,NC_032657.1,87545351,91927019,91927020,T,TK,1
NC_037335.1,NC_032657.1,87577412,91959100,91959101,G,GT,1
NC_037335.1,NC_032657.1,87577665,91959354,91959356,T,TCY,2
NC_037335.1,NC_032657.1,87578198,91959890,91959891,A,AR,1
NC_037335.1,NC_032657.1,87578399,91960092,91960093,T,TC,1
NC_037335.1,NC_032657.1,87588309,91970008,91970009,a,at,1
NC_037335.1,NC_032657.1,87599304,91981148,91981149,a,at,1
NC_037335.1,NC_032657.1,87603634,91985479,91985480,A,AC,1
NC_037335.1,NC_032657.1,87607871,91989721,91989735,a,aaaagTCTGAAAAGG,14
NC_037335.1,NC_032657.1,87612623,91994487,91994488,G,GA,1
NC_037335.1,NC_032657.1,87618248,92000110,92000111,A,AY,1
NC_037335.1,NC_032657.1,87620081,92001943,92001944,G,GY,1
NC_037335.1,NC_032657.1,87622715,92004571,92004572,c,ct,1
NC_037335.1,NC_032657.1,87622831,92004688,92004690,t,tag,2
NC_037335.1,NC_032657.1,87623829,92005688,92005689,t,tW,1
NC_037335.1,NC_032657.1,87625431,92007296,92007297,a,at,1
NC_037335.1,NC_032657.1,87630839,92013119,92013120,A,AG,1
NC_037335.1,NC_032657.1,87634194,92016478,92016479,T,TC,1
NC_037335.1,NC_032657.1,87639528,92021813,92021814,a,ac,1
NC_037335.1,NC_032657.1,87640701,92022987,92022988,t,tc,1
NC_037335.1,NC_032657.1,87643008,92025295,92025296,c,ca,1
NC_037335.1,NC_032657.1,87655640,92037939,92037944,G,GTTTTK,5
NC_037335.1,NC_032657.1,87661808,92044111,92044112,G,GA,1
NC_037335.1,NC_032657.1,87669088,92051387,92051389,A,ATG,2
NC_037335.1,NC_032657.1,87672955,92055242,92055243,t,ta,1
NC_037335.1,NC_032657.1,87673352,92055640,92055641,g,gR,1
NC_037335.1,NC_032657.1,87682494,92064779,92064780,c,ct,1
NC_037335.1,NC_032657.1,87684174,92066460,92066461,A,AC,1
NC_037335.1,NC_032657.1,87684694,92066981,92066982,t,tg,1
NC_037335.1,NC_032657.1,87684879,92067167,92067171,t,taaag,4
NC_037335.1,NC_032657.1,87688504,92070788,92070789,t,tg,1
NC_037335.1,NC_032657.1,87690141,92072426,92072427,g,ga,1
NC_037335.1,NC_032657.1,87804942,92478547,92478548,g,ga,1
NC_037335.1,NC_032657.1,87842768,92516436,92516437,T,TG,1
NC_037335.1,NC_032657.1,87865224,92538161,92538162,T,TY,1
NC_037335.1,NC_032657.1,87874039,92546974,92546978,T,TAGAC,4
NC_037335.1,NC_032657.1,88018359,92605968,92605970,c,cat,2
NC_037335.1,NC_032657.1,88026283,92614743,92614752,a,agatagatag,9
NC_037335.1,NC_032657.1,88026293,92614762,92614772,t,tatagatatag,10
NC_037335.1,NC_032657.1,88031364,92619846,92619847,T,TG,1
NC_037335.1,NC_032657.1,88036550,92625033,92625034,A,AG,1
NC_037335.1,NC_032657.1,88044513,92632997,92633002,a,atcagt,5
NC_037335.1,NC_032657.1,88049487,92638344,92638345,G,GS,1
NC_037335.1,NC_032657.1,88050766,92639624,92639625,A,AW,1
NC_037335.1,NC_032657.1,88052713,92641571,92641572,A,AC,1
NC_037335.1,NC_032657.1,88054209,92643067,92643069,c,cat,2
NC_037335.1,NC_032657.1,88078991,92669424,92669425,C,CA,1
NC_037335.1,NC_032657.1,88105001,92695322,92695323,t,ta,1
NC_037335.1,NC_032657.1,88124559,92714760,92714763,t,ttaa,3
NC_037335.1,NC_032657.1,88127421,92717626,92717627,G,GA,1
NC_037335.1,NC_032657.1,88129091,92719296,92719297,C,CG,1
NC_037335.1,NC_032657.1,88137426,92727815,92727820,T,TCTTGA,5
NC_037335.1,NC_032657.1,88138038,92728426,92728427,G,GT,1
NC_037335.1,NC_032657.1,88192478,92786685,92786690,T,TATGCA,5
NC_037335.1,NC_032657.1,88193172,92787389,92787390,g,gc,1
NC_037335.1,NC_032657.1,88193513,92787731,92787732,A,AG,1
NC_037335.1,NC_032657.1,88194088,92788308,92788309,g,ga,1
NC_037335.1,NC_032657.1,88194869,92789093,92789094,A,AT,1
NC_037335.1,NC_032657.1,88196864,92791088,92791090,c,cag,2
NC_037335.1,NC_032657.1,88199295,92793521,92793522,A,AM,1
NC_037335.1,NC_032657.1,88211201,92805456,92805457,A,AR,1
NC_037335.1,NC_032657.1,88213648,92807901,92807919,t,tNNNNNNNtatatatataa,18
NC_037335.1,NC_032657.1,88215525,92859870,92859874,g,gaact,4
NC_037335.1,NC_032657.1,88219371,92863734,92863735,a,ag,1
NC_037335.1,NC_032657.1,88223544,92867907,92867908,C,CT,1
NC_037335.1,NC_032657.1,88223845,92868209,92868210,t,tK,1
NC_037335.1,NC_032657.1,88229798,92874162,92874165,a,aaag,3
NC_037335.1,NC_032657.1,88230890,92875257,92875261,C,CACTT,4
NC_037335.1,NC_032657.1,88255831,92900230,92900231,T,TA,1
NC_037335.1,NC_032657.1,88625842,93384441,93384443,T,TCA,2
NC_037335.1,NC_032657.1,88642526,93401692,93401693,T,TG,1
NC_037335.1,NC_032657.1,88660955,93420120,93420140,G,GTGACCATGGCTTTTCCTCCA,20
NC_037335.1,NC_032657.1,88661245,93420430,93420432,g,gtt,2
NC_037335.1,NC_032657.1,88759584,93524936,93524937,g,gR,1
NC_037335.1,NC_032657.1,88780805,93546158,93546161,T,TCTY,3
NC_037335.1,NC_032657.1,88841267,93606736,93606738,G,GCA,2
NC_037335.1,NC_032657.1,88961390,93736545,93736546,t,tg,1
NC_037335.1,NC_032657.1,89055135,93830299,93830300,G,GT,1
NC_037335.1,NC_032657.1,89147556,93925025,93925026,a,ac,1
NC_037335.1,NC_032657.1,89152788,93930410,93930411,C,CA,1
NC_037335.1,NC_032657.1,89262920,94064843,94064847,c,ctctt,4
NC_037335.1,NC_032657.1,89326328,94128236,94128237,t,tc,1
NC_037335.1,NC_032657.1,89922472,94726742,94726743,t,ta,1
NC_037335.1,NC_032657.1,89995468,94800785,94800786,c,cN,1
NC_037335.1,NC_032657.1,90000632,94805949,94805950,A,AC,1
NC_037335.1,NC_032657.1,90033305,94838639,94838640,G,GA,1
NC_037335.1,NC_032657.1,90042198,94847531,94847542,C,CTTTTGACCACA,11
NC_037335.1,NC_032657.1,90057578,94862919,94862920,T,TA,1
NC_037335.1,NC_032657.1,90103616,94909149,94909151,A,AGM,2
NC_037335.1,NC_032657.1,90120117,94925691,94925693,a,att,2
NC_037335.1,NC_032657.1,90147379,94952961,94952962,t,tc,1
NC_037335.1,NC_032657.1,90147778,94953361,94953362,c,ca,1
NC_037335.1,NC_032657.1,90148440,94954023,94954028,a,attact,5
NC_037335.1,NC_032657.1,90176556,94982140,94982142,A,AAT,2
NC_037335.1,NC_032657.1,90206892,95012553,95012554,t,ta,1
NC_037335.1,NC_032657.1,90216736,95022398,95022404,t,tttttta,6
NC_037335.1,NC_032657.1,90233131,95038807,95038816,g,gggaaacagt,9
NC_037335.1,NC_032657.1,90291847,95097574,95097578,t,tgtca,4
NC_037335.1,NC_032657.1,90291851,95097582,95097583,g,gc,1
NC_037335.1,NC_032657.1,90480852,95288205,95288206,G,GT,1
NC_037335.1,NC_032657.1,90496007,95302393,95302394,c,ct,1
NC_037335.1,NC_032657.1,90745199,95566409,95566410,g,ga,1
NC_037335.1,NC_032657.1,90872141,95698473,95698474,t,tc,1
NC_037335.1,NC_032657.1,90892121,95718455,95718456,G,GC,1
NC_037335.1,NC_032657.1,90900713,95726862,95726867,G,GTTATA,5
NC_037335.1,NC_032657.1,90976724,95803816,95803818,a,aRG,2
NC_037335.1,NC_032657.1,90985696,95812790,95812795,g,gagtcc,5
NC_037335.1,NC_032657.1,90997544,95824654,95824655,T,TA,1
NC_037335.1,NC_032657.1,91024675,95852656,95852658,T,TNN,2
NC_037335.1,NC_032657.1,91025143,95853125,95853126,G,GA,1
NC_037335.1,NC_032657.1,91025523,95853507,95853508,G,GC,1
NC_037335.1,NC_032657.1,91149148,95977160,95977161,a,ag,1
NC_037335.1,NC_032657.1,91149152,95977165,95977166,a,ag,1
NC_037335.1,NC_032657.1,91338510,96161372,96161373,T,TG,1
NC_037335.1,NC_032657.1,91338530,96161393,96161394,A,AT,1
NC_037335.1,NC_032657.1,91338591,96161455,96161456,T,TK,1
NC_037335.1,NC_032657.1,91355308,96178173,96178174,c,ct,1
NC_037335.1,NC_032657.1,91378067,96200933,96200934,c,ct,1
NC_037335.1,NC_032657.1,91386472,96209344,96209345,g,ga,1
NC_037335.1,NC_032657.1,91386491,96209364,96209365,a,ac,1
NC_037335.1,NC_032657.1,91392816,96215820,96215841,C,CTTATTCCTCCTCATGCCAGTG,21
NC_037335.1,NC_032657.1,91405329,96228357,96228358,c,ct,1
NC_037335.1,NC_032657.1,91420229,96243257,96243261,g,gctat,4
NC_037335.1,NC_032657.1,91424542,96247574,96247582,T,TTACATGTG,8
NC_037335.1,NC_032657.1,91496871,96319710,96319711,t,ta,1
NC_037335.1,NC_032657.1,91520435,96343281,96343284,t,ttgg,3
NC_037335.1,NC_032657.1,91597449,96400624,96400625,t,tc,1
NC_037335.1,NC_032657.1,91618067,96421243,96421244,T,TY,1
NC_037335.1,NC_032657.1,91709768,96512666,96512670,t,ttgta,4
NC_037335.1,NC_032657.1,91726491,96528150,96528151,T,TA,1
NC_037335.1,NC_032657.1,91736972,96538589,96538590,t,ta,1
NC_037335.1,NC_032657.1,91744379,96545999,96546000,c,ca,1
NC_037335.1,NC_032657.1,91752886,96557439,96557440,A,AR,1
NC_037335.1,NC_032657.1,91764618,96569173,96569174,c,ct,1
NC_037335.1,NC_032657.1,91794487,96599736,96599737,A,AC,1
NC_037335.1,NC_032657.1,91796992,96602241,96602242,A,AR,1
NC_037335.1,NC_032657.1,91804351,96609638,96609639,a,ag,1
NC_037335.1,NC_032657.1,91821668,96626966,96626967,g,ga,1
NC_037335.1,NC_032657.1,91828908,96634206,96634207,t,tg,1
NC_037335.1,NC_032657.1,91830206,96635505,96635506,t,ta,1
NC_037335.1,NC_032657.1,91830499,96635799,96635800,a,ac,1
NC_037335.1,NC_032657.1,91852733,96658027,96658033,c,caaaaca,6
NC_037335.1,NC_032657.1,91856350,96661646,96661649,c,cagg,3
NC_037335.1,NC_032657.1,91907750,96713081,96713082,t,ta,1
NC_037335.1,NC_032657.1,91930752,96736079,96736080,A,AC,1
NC_037335.1,NC_032657.1,91931857,96737184,96737185,a,at,1
NC_037335.1,NC_032657.1,91949525,96754837,96754839,c,cct,2
NC_037335.1,NC_032657.1,91975111,96780551,96780554,t,tgtg,3
NC_037335.1,NC_032657.1,91978330,96783733,96783740,c,cttttttt,7
NC_037335.1,NC_032657.1,91987666,96793093,96793094,g,ga,1
NC_037335.1,NC_032657.1,92000860,96806298,96806300,C,CTT,2
NC_037335.1,NC_032657.1,92037428,96842161,96842162,g,ga,1
NC_037335.1,NC_032657.1,92040393,96845125,96845151,C,CTTCCCAAACTAGTTTTTCAGAATCTT,26
NC_037335.1,NC_032657.1,92046641,96851399,96851400,A,AG,1
NC_037335.1,NC_032657.1,92068765,96873526,96873527,C,CW,1
NC_037335.1,NC_032657.1,92071336,96876108,96876113,g,gactga,5
NC_037335.1,NC_032657.1,92072254,96877031,96877032,a,aN,1
NC_037335.1,NC_032657.1,92072297,96877075,96877079,g,gccta,4
NC_037335.1,NC_032657.1,92077810,96882609,96882610,t,ta,1
NC_037335.1,NC_032657.1,92104937,96918110,96918111,a,at,1
NC_037335.1,NC_032657.1,92104937,96946831,96946832,a,at,1
NC_037335.1,NC_032657.1,92139368,96981278,96981279,a,ac,1
NC_037335.1,NC_032657.1,92147693,96989650,96989672,G,GTCTCATGGAAGTTGAACTTCCA,22
NC_037335.1,NC_032657.1,92148171,96990150,96990151,t,ta,1
NC_037335.1,NC_032657.1,92148566,96990546,96990547,a,aT,1
NC_037335.1,NC_032657.1,92149704,96991686,96991689,t,tctc,3
NC_037335.1,NC_032657.1,92150000,96991985,96991986,a,ag,1
NC_037335.1,NC_032657.1,92156329,96998312,96998313,g,gc,1
NC_037335.1,NC_032657.1,92166792,97008776,97008777,A,AT,1
NC_037335.1,NC_032657.1,92173534,97015508,97015509,a,ag,1
NC_037335.1,NC_032657.1,92174544,97016519,97016529,g,gactgaactga,10
NC_037335.1,NC_032657.1,92192899,97034835,97034838,a,aaaM,3
NC_037335.1,NC_032657.1,92276150,97117933,97117934,c,ct,1
NC_037335.1,NC_032657.1,92302713,97143887,97143891,t,tttta,4
NC_037335.1,NC_032657.1,92322318,97164189,97164190,g,gR,1
NC_037335.1,NC_032657.1,92417584,97269400,97269401,A,AG,1
NC_037335.1,NC_032657.1,92418690,97270507,97270508,t,ta,1
NC_037335.1,NC_032657.1,92435719,97288125,97288126,A,AG,1
NC_037335.1,NC_032657.1,92454512,97306908,97306909,t,tc,1
NC_037335.1,NC_032657.1,92471006,97323748,97323749,t,ta,1
NC_037335.1,NC_032657.1,92513611,97366337,97366347,a,aNNNNNNNNNN,10
NC_037335.1,NC_032657.1,92519532,97372612,97372613,g,ga,1
NC_037335.1,NC_032657.1,92541337,97394417,97394418,t,tg,1
NC_037335.1,NC_032657.1,92545530,97398411,97398416,g,gtaTAA,5
NC_037335.1,NC_032657.1,92553836,97406737,97406739,t,ttg,2
NC_037335.1,NC_032657.1,92614958,97467674,97467678,t,tgata,4
NC_037335.1,NC_032657.1,92615490,97468211,97468212,c,ct,1
NC_037335.1,NC_032657.1,92616238,97468960,97468961,g,ga,1
NC_037335.1,NC_032657.1,92743595,97596336,97596337,g,gt,1
NC_037335.1,NC_032657.1,92768367,97621113,97621115,t,ttg,2
NC_037335.1,NC_032657.1,92776826,97629577,97629581,a,aNNNN,4
NC_037335.1,NC_032657.1,92868677,97768199,97768200,t,tc,1
NC_037335.1,NC_032657.1,92892243,97791786,97791788,a,aat,2
NC_037335.1,NC_032657.1,92894787,97794331,97794337,c,ctgtatg,6
NC_037335.1,NC_032657.1,92910870,97810425,97810426,c,ca,1
NC_037335.1,NC_032657.1,92912240,97811796,97811797,A,AR,1
NC_037335.1,NC_032657.1,92913033,97812583,97812587,g,gtgtt,4
NC_037335.1,NC_032657.1,92913849,97813403,97813404,T,TK,1
NC_037335.1,NC_032657.1,92914408,97813961,97813963,A,AAT,2
NC_037335.1,NC_032657.1,92914477,97814033,97814034,C,CT,1
NC_037335.1,NC_032657.1,92918378,97817686,97817687,a,ac,1
NC_037335.1,NC_032657.1,92919203,97818511,97818524,A,ASATACTACCCTTG,13
NC_037335.1,NC_032657.1,92925922,97825244,97825245,A,AY,1
NC_037335.1,NC_032657.1,92958668,97860289,97860291,A,ATC,2
NC_037335.1,NC_032657.1,92960474,97862097,97862099,g,gaa,2
NC_037335.1,NC_032657.1,93009756,97911531,97911532,t,tg,1
NC_037335.1,NC_032657.1,93027951,97929730,97929731,A,AG,1
NC_037335.1,NC_032657.1,93032837,97934603,97934604,c,ct,1
NC_037335.1,NC_032657.1,93038278,97940125,97940126,a,ac,1
NC_037335.1,NC_032657.1,93039721,97941570,97941571,A,AC,1
NC_037335.1,NC_032657.1,93044410,97946260,97946261,c,ct,1
NC_037335.1,NC_032657.1,93057892,97960221,97960224,T,TAGG,3
NC_037335.1,NC_032657.1,93065064,97967338,97967339,c,ct,1
NC_037335.1,NC_032657.1,93069341,97971617,97971618,c,ct,1
NC_037335.1,NC_032657.1,93078203,97980357,97980358,g,ga,1
NC_037335.1,NC_032657.1,93134222,98036414,98036419,A,AGTGGT,5
NC_037335.1,NC_032657.1,93149979,98079704,98079706,t,tgc,2
NC_037335.1,NC_032657.1,93159059,98088836,98088837,t,tg,1
NC_037335.1,NC_032657.1,93159059,98064703,98064704,t,ta,1
NC_037335.1,NC_032657.1,93163548,98093325,98093326,T,TY,1
NC_037335.1,NC_032657.1,93169039,98098818,98098819,a,ag,1
NC_037335.1,NC_032657.1,93175454,98105234,98105235,g,gt,1
NC_037335.1,NC_032657.1,93184257,98114039,98114040,A,AT,1
NC_037335.1,NC_032657.1,93184900,98114683,98114685,a,aat,2
NC_037335.1,NC_032657.1,93222930,98154131,98154132,g,gt,1
NC_037335.1,NC_032657.1,93247021,98178046,98178047,c,ct,1
NC_037335.1,NC_032657.1,93248845,98179868,98179869,A,AW,1
NC_037335.1,NC_032657.1,93253103,98185402,98185403,g,ga,1
NC_037335.1,NC_032657.1,93255323,98187622,98187623,A,AG,1
NC_037335.1,NC_032657.1,93259322,98191556,98191557,t,ta,1
NC_037335.1,NC_032657.1,93264810,98197046,98197048,C,CAG,2
NC_037335.1,NC_032657.1,93286545,98218854,98218856,C,CGT,2
NC_037335.1,NC_032657.1,93292348,98224661,98224662,G,GT,1
NC_037335.1,NC_032657.1,93295369,98227677,98227678,t,tg,1
NC_037335.1,NC_032657.1,93404499,98336983,98336984,t,tg,1
NC_037335.1,NC_032657.1,93407278,98339764,98339765,c,ca,1
NC_037335.1,NC_032657.1,93407601,98340088,98340090,a,aNN,2
NC_037335.1,NC_032657.1,93476267,98408738,98408739,T,TG,1
NC_037335.1,NC_032657.1,93548462,98482024,98482029,g,gactga,5
NC_037335.1,NC_032657.1,93548581,98482148,98482151,t,tttc,3
NC_037335.1,NC_032657.1,93568989,98502990,98502991,T,TC,1
NC_037335.1,NC_032657.1,93572372,98506374,98506379,A,AAAAAC,5
NC_037335.1,NC_032657.1,93572865,98506872,98506873,C,CT,1
NC_037335.1,NC_032657.1,93581473,98515483,98515485,g,gct,2
NC_037335.1,NC_032657.1,93654808,98588819,98588822,C,CTGT,3
NC_037335.1,NC_032657.1,93659236,98593254,98593256,A,AGC,2
NC_037335.1,NC_032657.1,93760763,98672014,98672044,T,TCATGTAACCATGCAGGATTTTGTCATGTTA,30
NC_037335.1,NC_032657.1,93801961,98713240,98713245,G,GTTATA,5
NC_037335.1,NC_032657.1,93803879,98715153,98715158,t,ttaaaa,5
NC_037335.1,NC_032657.1,93805152,98716431,98716435,C,CAGGA,4
NC_037335.1,NC_032657.1,93805437,98716719,98716720,c,ct,1
NC_037335.1,NC_032657.1,93809977,98723288,98723289,A,AT,1
NC_037335.1,NC_032657.1,93824093,98737408,98737409,T,TA,1
NC_037335.1,NC_032657.1,93877197,98790525,98790526,C,CY,1
NC_037335.1,NC_032657.1,93882523,98795852,98795853,c,ct,1
NC_037335.1,NC_032657.1,93884693,98798024,98798025,A,AR,1
NC_037335.1,NC_032657.1,93987539,98901232,98901250,A,ACTGACAGAGAtaacagag,18
NC_037335.1,NC_032657.1,93999450,98913161,98913162,a,at,1
NC_037335.1,NC_032657.1,94053734,98968096,98968097,c,ca,1
NC_037335.1,NC_032657.1,94088907,99064697,99064700,t,ttcc,3
NC_037335.1,NC_032657.1,94091348,99067141,99067142,c,cg,1
NC_037335.1,NC_032657.1,94589587,99354451,99354453,g,ggc,2
NC_037335.1,NC_032657.1,94699581,99474239,99474240,g,gc,1
NC_037335.1,NC_032657.1,94736820,99511493,99511494,t,tg,1
NC_037335.1,NC_032657.1,94736834,99511508,99511511,g,gggt,3
NC_037335.1,NC_032657.1,94757596,99532124,99532125,g,gt,1
NC_037335.1,NC_032657.1,94775402,99549932,99549934,C,CCY,2
NC_037335.1,NC_032657.1,94795526,99570060,99570061,C,CT,1
NC_037335.1,NC_032657.1,94827067,99601604,99601607,T,TTTG,3
NC_037335.1,NC_032657.1,94878094,99653183,99653184,A,AG,1
NC_037335.1,NC_032657.1,94940425,99722167,99722168,A,AC,1
NC_037335.1,NC_032657.1,94985159,99766930,99766931,g,ga,1
NC_037335.1,NC_032657.1,94992115,99773888,99773889,t,ta,1
NC_037335.1,NC_032657.1,95052408,99835102,99835103,T,TA,1
NC_037335.1,NC_032657.1,95055343,99838040,99838041,A,AG,1
NC_037335.1,NC_032657.1,95101378,99884087,99884090,t,tctc,3
NC_037335.1,NC_032657.1,95234967,100031721,100031723,A,ACT,2
NC_037335.1,NC_032657.1,95237263,100034019,100034020,t,tc,1
NC_037335.1,NC_032657.1,95241228,100037985,100037986,t,ta,1
NC_037335.1,NC_032657.1,95241328,100038086,100038088,A,AAT,2
NC_037335.1,NC_032657.1,95254227,100050974,100050975,A,AG,1
NC_037335.1,NC_032657.1,95267512,100064262,100064264,a,att,2
NC_037335.1,NC_032657.1,95297519,100101365,100101367,A,AAG,2
NC_037335.1,NC_032657.1,95311914,100115762,100115763,T,TC,1
NC_037335.1,NC_032657.1,95364456,100167948,100167949,t,tg,1
NC_037335.1,NC_032657.1,95398026,100213906,100213907,A,AC,1
NC_037335.1,NC_032657.1,95399500,100215382,100215383,T,TK,1
NC_037335.1,NC_032657.1,95414753,100230217,100230218,t,ta,1
NC_037335.1,NC_032657.1,95416196,100241617,100241619,a,act,2
NC_037335.1,NC_032657.1,95430742,100256262,100256266,t,ttaaa,4
NC_037335.1,NC_032657.1,95431599,100257132,100257133,c,ca,1
NC_037335.1,NC_032657.1,95455469,100280980,100280981,T,TC,1
NC_037335.1,NC_032657.1,95460507,100282457,100282459,g,gat,2
NC_037335.1,NC_032657.1,95534857,100356829,100356830,T,TY,1
NC_037335.1,NC_032657.1,95544493,100366468,100366472,C,CTCTA,4
NC_037335.1,NC_032657.1,95662126,100621158,100621167,T,TNNNNNNNNN,9
NC_037335.1,NC_032657.1,95695169,100654223,100654225,T,TTA,2
NC_037335.1,NC_032657.1,95712957,100537444,100537452,T,TAGGGACTC,8
NC_037335.1,NC_032657.1,95713138,100537633,100537634,t,tc,1
NC_037335.1,NC_032657.1,95714293,100538789,100538816,G,GAGTCCCYGTCTGACAYGCCTGCTCTTT,27
NC_037335.1,NC_032657.1,95715415,100539939,100539940,G,GT,1
NC_037335.1,NC_032657.1,95726517,100551045,100551053,a,aNNNNNNNN,8
NC_037335.1,NC_032657.1,95731977,100556513,100556514,c,ca,1
NC_037335.1,NC_032657.1,95733345,100557795,100557796,A,AR,1
NC_037335.1,NC_032657.1,95750630,100575082,100575083,C,CT,1
NC_037335.1,NC_032657.1,95761487,100585946,100585947,A,AG,1
NC_037335.1,NC_032657.1,95768484,100592707,100592708,g,ga,1
NC_037335.1,NC_032657.1,95770874,100595098,100595109,C,CATTCCAGGACG,11
NC_037335.1,NC_032657.1,95797363,100802961,100802962,G,GC,1
NC_037335.1,NC_032657.1,95809087,100814687,100814688,c,ca,1
NC_037335.1,NC_032657.1,95840004,100845723,100845724,T,TG,1
NC_037335.1,NC_032657.1,95912913,100918427,100918428,a,ag,1
NC_037335.1,NC_032657.1,96177909,101282121,101282122,t,tK,1
NC_037335.1,NC_032657.1,96195798,101300017,101300019,t,taa,2
NC_037335.1,NC_032657.1,96195835,101300056,101300057,t,ta,1
NC_037335.1,NC_032657.1,96264687,101368929,101368930,c,ca,1
NC_037335.1,NC_032657.1,96320163,101424671,101424672,C,CS,1
NC_037335.1,NC_032657.1,96349464,101453932,101453933,T,TC,1
NC_037335.1,NC_032657.1,96423103,101530266,101530267,t,tc,1
NC_037335.1,NC_032657.1,96447114,101554279,101554280,G,GA,1
NC_037335.1,NC_032657.1,96470470,27860042,27860043,g,gt,1
NC_037335.1,NC_032657.1,96470494,27860067,27860068,c,ct,1
NC_037335.1,NC_032657.1,96480557,101579341,101579346,g,gactga,5
NC_037335.1,NC_032657.1,96616278,101715190,101715194,A,ATWKR,4
NC_037335.1,NC_032657.1,96729124,101827757,101827760,t,ttaa,3
NC_037335.1,NC_032657.1,96798221,101896851,101896853,a,atg,2
NC_037335.1,NC_032657.1,96823764,101922414,101922415,C,CA,1
NC_037335.1,NC_032657.1,96914184,102012834,102012835,G,GT,1
NC_037335.1,NC_032657.1,96930804,102029455,102029458,t,tgca,3
NC_037335.1,NC_032657.1,97169192,102269529,102269531,t,tNN,2
NC_037335.1,NC_032657.1,97274769,102375093,102375094,C,CA,1
NC_037335.1,NC_032657.1,97276170,102376495,102376496,a,at,1
NC_037335.1,NC_032657.1,97309309,102409560,102409561,a,at,1
NC_037335.1,NC_032657.1,97315113,102415367,102415368,C,CY,1
NC_037335.1,NC_032657.1,97356589,102455865,102455866,A,AY,1
NC_037335.1,NC_032657.1,97398151,102497990,102497991,a,ac,1
NC_037335.1,NC_032657.1,97398275,102498116,102498119,C,CAAA,3
NC_037335.1,NC_032657.1,97426480,102526336,102526337,c,cR,1
NC_037335.1,NC_032657.1,97455329,102555189,102555190,a,ac,1
NC_037335.1,NC_032657.1,97591255,102691107,102691108,C,CM,1
NC_037335.1,NC_032657.1,97591349,102691203,102691204,T,TG,1
NC_037335.1,NC_032657.1,97591364,102691219,102691220,T,TG,1
NC_037335.1,NC_032657.1,97591379,102691235,102691236,C,CG,1
NC_037335.1,NC_032657.1,97612837,102712668,102712669,g,gc,1
NC_037335.1,NC_032657.1,97612880,102712712,102712713,g,gt,1
NC_037335.1,NC_032657.1,97851792,102948988,102948989,g,gt,1
NC_037335.1,NC_032657.1,97874080,102973696,102973697,A,AR,1
NC_037335.1,NC_032657.1,97893520,102993099,102993117,A,ATAACCAAAGTTAACTCTG,18
NC_037335.1,NC_032657.1,97912564,103012127,103012129,c,cca,2
NC_037335.1,NC_032657.1,97915920,103015486,103015487,T,TC,1
NC_037335.1,NC_032657.1,98039148,103100808,103100809,C,CA,1
NC_037335.1,NC_032657.1,98072258,103142922,103142923,c,ca,1
NC_037335.1,NC_032657.1,98142311,103196582,103196586,a,aNNNN,4
NC_037335.1,NC_032657.1,98223644,103277814,103277823,C,CTGATGAACA,9
NC_037335.1,NC_032657.1,98253002,103307196,103307197,g,ga,1
NC_037335.1,NC_032657.1,98264224,103318420,103318425,C,CCTTGA,5
NC_037335.1,NC_032657.1,98269404,103323606,103323624,C,CTGGCTTCAGTTACCTCGA,18
NC_037335.1,NC_032657.1,98269827,103324047,103324048,T,TK,1
NC_037335.1,NC_032657.1,98290124,103344353,103344354,C,CS,1
NC_037335.1,NC_032657.1,98307821,103362123,103362125,t,tgc,2
NC_037335.1,NC_032657.1,98320135,103374284,103374285,a,at,1
NC_037335.1,NC_032657.1,98377579,103431445,103431446,a,at,1
NC_037335.1,NC_032657.1,98393593,103447465,103447466,t,tg,1
NC_037335.1,NC_032657.1,98795414,103849171,103849177,t,tNNNNNN,6
NC_037335.1,NC_032657.1,98824845,103878564,103878565,A,AR,1
NC_037335.1,NC_032657.1,98832241,103885961,103885965,G,GCAGA,4
NC_037335.1,NC_032657.1,98850001,103903736,103903737,G,GR,1
NC_037335.1,NC_032657.1,98857529,103911270,103911271,A,AK,1
NC_037335.1,NC_032657.1,98870134,103925166,103925167,C,CY,1
NC_037335.1,NC_032657.1,98876048,103931082,103931083,G,GS,1
NC_037335.1,NC_032657.1,98916386,103971276,103971277,G,GR,1
NC_037335.1,NC_032657.1,98962801,104017767,104017768,a,ac,1
NC_037335.1,NC_032657.1,99116894,104184424,104184425,g,ga,1
NC_037335.1,NC_032657.1,99190322,104221102,104221104,a,atg,2
NC_037335.1,NC_032657.1,99247711,104281537,104281538,c,ca,1
NC_037335.1,NC_032657.1,99251360,104285187,104285197,A,ATAGAATTTTG,10
NC_037335.1,NC_032657.1,99256962,104290799,104290800,T,TG,1
NC_037335.1,NC_032657.1,99297715,104331544,104331545,G,GK,1
NC_037335.1,NC_032657.1,99302630,104336462,104336463,A,AW,1
NC_037335.1,NC_032657.1,99324538,104358372,104358373,T,TG,1
NC_037335.1,NC_032657.1,99325313,104359147,104359148,a,at,1
NC_037335.1,NC_032657.1,99329586,104363286,104363287,c,cM,1
NC_037335.1,NC_032657.1,99345027,104378722,104378723,C,CT,1
NC_037335.1,NC_032657.1,99365564,104399256,104399258,C,CCT,2
NC_037335.1,NC_032657.1,99375683,104409376,104409377,G,GC,1
NC_037335.1,NC_032657.1,99402355,104436062,104436066,c,ctgtg,4
NC_037335.1,NC_032657.1,99411321,104445030,104445034,C,CTCTT,4
NC_037335.1,NC_032657.1,99428488,104461990,104461993,t,ttta,3
NC_037335.1,NC_032657.1,99451776,104485278,104485288,C,CMTTTTACTGG,10
NC_037335.1,NC_032657.1,99492734,104526722,104526724,C,CAT,2
NC_037335.1,NC_032657.1,99504537,104538530,104538531,G,GT,1
NC_037335.1,NC_032657.1,99544408,104578431,104578432,A,AC,1
NC_037335.1,NC_032657.1,99609380,104650216,104650217,G,GR,1
NC_037335.1,NC_032657.1,99633077,104673920,104673922,C,CAT,2
NC_037335.1,NC_032657.1,99646888,104687798,104687799,G,GA,1
NC_037335.1,NC_032657.1,99695217,104736160,104736161,A,AC,1
NC_037335.1,NC_032657.1,99695237,104736181,104736183,A,AAT,2
NC_037335.1,NC_032657.1,99696046,104736992,104736993,c,ca,1
NC_037335.1,NC_032657.1,99702044,104742978,104742981,A,ATAG,3
NC_037335.1,NC_032657.1,99723025,104763960,104763961,T,TK,1
NC_037335.1,NC_032657.1,99723441,104764377,104764378,c,ct,1
NC_037335.1,NC_032657.1,99740290,104781256,104781257,A,AT,1
NC_037335.1,NC_032657.1,99826137,104865693,104865694,T,TG,1
NC_037335.1,NC_032657.1,99831853,104871410,104871411,a,at,1
NC_037335.1,NC_032657.1,99844648,104884212,104884215,a,attt,3
NC_037335.1,NC_032657.1,99944605,104984179,104984182,a,acac,3
NC_037335.1,NC_032657.1,99949326,104988902,104988918,g,gaaaatgaaacttttaa,16
NC_037335.1,NC_032657.1,100001255,105043000,105043001,A,AW,1
NC_037335.1,NC_032657.1,100002562,105044308,105044309,A,AC,1
NC_037335.1,NC_032657.1,100005894,105047101,105047102,T,TY,1
NC_037335.1,NC_032657.1,100027837,105064701,105064702,T,TN,1
NC_037335.1,NC_032657.1,100095950,105115355,105115356,T,TC,1
NC_037335.1,NC_032657.1,100123086,105142495,105142496,a,aM,1
NC_037335.1,NC_032657.1,100173700,105204650,105204664,a,aNNNNNNNNNNNNNN,14
NC_037335.1,NC_032657.1,100173841,105204805,105204810,c,ctcagt,5
NC_037335.1,NC_032657.1,100174043,105205012,105205013,c,ct,1
NC_037335.1,NC_032657.1,100235954,105266712,105266713,t,tg,1
NC_037335.1,NC_032657.1,100278683,105309481,105309482,C,CG,1
NC_037335.1,NC_032657.1,100279975,105310776,105310777,t,tc,1
NC_037335.1,NC_032657.1,100280482,105311284,105311285,A,AT,1
NC_037335.1,NC_032657.1,100310507,105341357,105341359,a,aag,2
NC_037335.1,NC_032657.1,100310801,105341652,105341654,c,ctt,2
NC_037335.1,NC_032657.1,100311689,105342495,105342496,t,tc,1
NC_037335.1,NC_032657.1,100312794,105343600,105343601,a,at,1
NC_037335.1,NC_032657.1,100313172,105343978,105343979,c,ca,1
NC_037335.1,NC_032657.1,100318513,105349316,105349317,A,AN,1
NC_037335.1,NC_032657.1,100334488,105365310,105365314,T,TTAAC,4
NC_037335.1,NC_032657.1,100339499,105371287,105371307,A,AAGGAGTAATCAGAGAACAAR,20
NC_037335.1,NC_032657.1,100363122,105394933,105394935,T,TTC,2
NC_037335.1,NC_032657.1,100366587,105398402,105398403,t,tg,1
NC_037335.1,NC_032657.1,100404267,105436087,105436088,A,AG,1
NC_037335.1,NC_032657.1,100418259,105449979,105449980,a,aN,1
NC_037335.1,NC_032657.1,100469350,105539405,105539406,T,TC,1
NC_037335.1,NC_032657.1,100511996,105581667,105581669,G,GYC,2
NC_037335.1,NC_032657.1,100562025,105652309,105652310,g,ga,1
NC_037335.1,NC_032657.1,100564332,105650000,105650003,a,aagg,3
NC_037335.1,NC_032657.1,100565366,105648964,105648965,t,tg,1
NC_037335.1,NC_032657.1,100595770,105762263,105762316,g,ggaactACCGGTAGTAAGGANNNNNNNNNNNNNNNNNNNNNNNNNNNNNNNNNN,53
NC_037335.1,NC_032657.1,100653385,105868255,105868287,t,tNNNNNNNNNNNNNNNNNNNNNNNNNNNNNNNN,32
NC_037335.1,NC_032657.1,100659200,105874103,105874108,T,TCTTTC,5
NC_037335.1,NC_032657.1,100666485,105881390,105881391,c,ct,1
NC_037335.1,NC_032657.1,100666487,105881393,105881394,a,at,1
NC_037335.1,NC_032657.1,100685390,105900302,105900303,T,TG,1
NC_037335.1,NC_032657.1,100706519,105920990,105921007,A,AACCCATTNNNNNNNNAG,17
NC_037335.1,NC_032657.1,100715365,105929849,105929863,a,actgactcgatggac,14
NC_037335.1,NC_032657.1,100718921,105933422,105933425,g,gcaa,3
NC_037335.1,NC_032657.1,100725613,105940118,105940121,C,CTGA,3
NC_037335.1,NC_032657.1,100725646,105940154,105940166,T,TAATGTATTAGTA,12
NC_037335.1,NC_032657.1,100753058,105968093,105968117,t,ttgcatcTTNNNNNNNNNNNNNNNN,24
NC_037335.1,NC_032657.1,100795917,106010961,106010962,t,tc,1
NC_037335.1,NC_032657.1,100815016,106030053,106030054,G,GA,1
NC_037335.1,NC_032657.1,100884459,106099446,106099447,t,ta,1
NC_037335.1,NC_032657.1,100949902,106165074,106165077,A,AAAC,3
NC_037335.1,NC_032657.1,101070156,106280157,106280158,g,ga,1
NC_037335.1,NC_032657.1,101202980,106384221,106384226,t,taagtg,5
NC_037335.1,NC_032657.1,101352746,106535711,106535712,C,CM,1
NC_037335.1,NC_032657.1,101414462,106597684,106597711,T,TCTACACAGCCTGCAGGCACAGTAAGAA,27
NC_037335.1,NC_032657.1,101437542,106620790,106620791,t,ta,1
NC_037335.1,NC_032657.1,101640023,106812170,106812171,A,AC,1
NC_037335.1,NC_032657.1,101709082,106881027,106881029,a,atc,2
NC_037335.1,NC_032657.1,101810923,106984616,106984617,c,ca,1
NC_037335.1,NC_032657.1,101921607,107095167,107095169,C,CAG,2
NC_037335.1,NC_032657.1,101923778,107097342,107097343,C,CM,1
NC_037335.1,NC_032657.1,101923810,107097375,107097376,C,CT,1
NC_037335.1,NC_032657.1,101923817,107097383,107097384,G,GC,1
NC_037335.1,NC_032657.1,101973667,107147171,107147173,a,aNN,2
NC_037335.1,NC_032657.1,101989428,107162934,107162936,a,aag,2
NC_037335.1,NC_032657.1,101996221,107169729,107169731,G,GAK,2
NC_037335.1,NC_032657.1,101997470,107170984,107170985,a,at,1
NC_037335.1,NC_032657.1,102013933,107187087,107187088,G,GT,1
NC_037335.1,NC_032657.1,102016648,107189804,107189805,t,ta,1
NC_037335.1,NC_032657.1,102136711,107422738,107422739,c,ca,1
NC_037335.1,NC_032657.1,102283656,107574839,107574853,a,atatatatatatatg,14
NC_037335.1,NC_032657.1,102301145,107592432,107592433,a,ac,1
NC_037335.1,NC_032657.1,102411886,107732420,107732421,A,AT,1
NC_037335.1,NC_032657.1,102426858,107747396,107747397,T,TG,1
NC_037335.1,NC_032657.1,102433023,107753568,107753569,A,AG,1
NC_037335.1,NC_032657.1,102435884,107756434,107756435,T,TW,1
NC_037335.1,NC_032657.1,102435893,107756444,107756445,T,TC,1
NC_037335.1,NC_032657.1,102620432,107938487,107938490,A,AAAT,3
NC_037335.1,NC_032657.1,102624420,107942473,107942484,T,TTCTGACAACGC,11
NC_037335.1,NC_032657.1,102634338,107952406,107952407,G,GC,1
NC_037335.1,NC_032657.1,102637079,107955131,107955135,c,ccgtt,4
NC_037335.1,NC_032657.1,102664496,107982560,107982569,a,agagagagag,9
NC_037335.1,NC_032657.1,102664996,107983069,107983070,T,TC,1
NC_037335.1,NC_032657.1,102666957,107985031,107985034,A,AGTG,3
NC_037335.1,NC_032657.1,102707690,108025799,108025800,t,tc,1
NC_037335.1,NC_032657.1,102737069,108055264,108055265,C,CT,1
NC_037335.1,NC_032657.1,102760710,108078891,108078892,c,cg,1
NC_037335.1,NC_032657.1,102766455,108084638,108084639,T,TC,1
NC_037335.1,NC_032657.1,102770490,108088659,108088660,C,CA,1
NC_037335.1,NC_032657.1,102819415,108137589,108137590,C,CY,1
NC_037335.1,NC_032657.1,102850930,108169470,108169488,t,tagcagcagcagcagcagc,18
NC_037335.1,NC_032657.1,102877227,108195784,108195785,G,GR,1
NC_037335.1,NC_032657.1,103246516,108568965,108568966,T,TG,1
NC_037335.1,NC_032657.1,103252313,108574764,108574767,C,CCAT,3
NC_037335.1,NC_032657.1,103267802,108590250,108590251,g,ga,1
NC_037335.1,NC_032657.1,103269058,108591508,108591509,c,ct,1
NC_037335.1,NC_032657.1,103269568,108592021,108592022,g,ga,1
NC_037335.1,NC_032657.1,103291920,108614383,108614385,a,aat,2
NC_037335.1,NC_032657.1,103314362,108636861,108636862,T,TA,1
NC_037335.1,NC_032657.1,103319184,108641686,108641687,T,TG,1
NC_037335.1,NC_032657.1,103322523,108645026,108645027,a,ac,1
NC_037335.1,NC_032657.1,103325905,108648410,108648411,A,AY,1
NC_037335.1,NC_032657.1,103458539,108783675,108783676,C,CT,1
NC_037335.1,NC_032657.1,103660299,108985102,108985104,t,tag,2
NC_037335.1,NC_032657.1,103736049,109060882,109060883,t,tc,1
NC_037335.1,NC_032657.1,103736984,109061812,109061813,T,TK,1
NC_037335.1,NC_032657.1,103764596,109090743,109090745,c,cgt,2
NC_037335.1,NC_032657.1,103768620,109094771,109094772,a,ag,1
NC_037335.1,NC_032657.1,103774367,109100519,109100520,t,tc,1
NC_037335.1,NC_032657.1,103830193,109156494,109156496,C,CTG,2
NC_037335.1,NC_032657.1,103845022,109171324,109171325,T,TC,1
NC_037335.1,NC_032657.1,103861824,109188128,109188133,a,atcagt,5
NC_037335.1,NC_032657.1,103930660,109256966,109256968,t,tNN,2
NC_037335.1,NC_032657.1,104019029,109346131,109346132,g,gc,1
NC_037335.1,NC_032657.1,104019887,109346990,109346991,t,tc,1
NC_037335.1,NC_032657.1,104066863,109393994,109393995,a,ac,1
NC_037335.1,NC_032657.1,104094871,109422007,109422008,A,AG,1
NC_037335.1,NC_032657.1,104102811,109429942,109429974,c,ctNNNNNNNNNNNNatatatatatatatatatt,32
NC_037335.1,NC_032657.1,104110220,109437384,109437386,C,CAG,2
NC_037335.1,NC_032657.1,104133176,109460343,109460344,g,ga,1
NC_037335.1,NC_032657.1,104177684,109504867,109504868,T,TC,1
NC_037335.1,NC_032657.1,104181266,109508452,109508453,G,GC,1
NC_037335.1,NC_032657.1,104181304,109508492,109508493,G,GA,1
NC_037335.1,NC_032657.1,104194339,109573947,109573948,C,CY,1
NC_037335.1,NC_032657.1,104250484,109630524,109630525,C,CA,1
NC_037335.1,NC_032657.1,104256215,109636255,109636256,A,AG,1
NC_037335.1,NC_032657.1,104263400,109643441,109643442,G,GC,1
NC_037335.1,NC_032657.1,104406011,109800182,109800183,T,TY,1
NC_037335.1,NC_032657.1,104433340,109827518,109827533,a,actgatctgatctgat,15
NC_037335.1,NC_032657.1,104439702,109833923,109833924,G,GR,1
NC_037335.1,NC_032657.1,104486756,109880995,109880997,C,CAT,2
NC_037335.1,NC_032657.1,104501325,109895550,109895551,t,ta,1
NC_037335.1,NC_032657.1,104522495,109916738,109916739,G,GK,1
NC_037335.1,NC_032657.1,104552918,109947165,109947168,t,taaa,3
NC_037335.1,NC_032657.1,104568953,109963203,109963204,g,gc,1
NC_037335.1,NC_032657.1,104574925,109969178,109969179,t,ta,1
NC_037335.1,NC_032657.1,104607667,110002486,110002489,A,AAAG,3
NC_037335.1,NC_032657.1,104613041,110007863,110007864,G,GR,1
NC_037335.1,NC_032657.1,104642789,110037567,110037568,T,TW,1
NC_037335.1,NC_032657.1,104655319,110050120,110050121,g,ga,1
NC_037335.1,NC_032657.1,104655323,110050125,110050126,c,ca,1
NC_037335.1,NC_032657.1,104673936,110068740,110068741,c,ca,1
NC_037335.1,NC_032657.1,104676780,110071585,110071590,C,CGAGTT,5
NC_037335.1,NC_032657.1,104679433,110074242,110074243,a,at,1
NC_037335.1,NC_032657.1,104727870,110122688,110122689,G,GS,1
NC_037335.1,NC_032657.1,104755360,110150192,110150193,G,GA,1
NC_037335.1,NC_032657.1,104762855,110157692,110157693,a,ag,1
NC_037335.1,NC_032657.1,104968748,110356478,110356480,t,tNN,2
NC_037335.1,NC_032657.1,104975310,110363626,110363627,A,AT,1
NC_037335.1,NC_032657.1,105162713,110551258,110551268,G,GAGATNNNNNN,10
NC_037335.1,NC_032657.1,105254384,110663295,110663296,A,AY,1
NC_037335.1,NC_032657.1,105353664,110722491,110722492,c,ct,1
NC_037335.1,NC_032657.1,105508495,110877998,110877999,G,GA,1
NC_037335.1,NC_032657.1,105647527,111016207,111016214,c,ctttcact,7
NC_037335.1,NC_032657.1,106066437,111435770,111435771,g,gc,1
NC_037335.1,NC_032657.1,106138718,111508003,111508004,C,CA,1
NC_037335.1,NC_032657.1,106138762,111508048,111508049,g,ga,1
NC_037335.1,NC_032657.1,106162062,111532662,111532663,T,TK,1
NC_037335.1,NC_032657.1,106249932,111610068,111610070,T,TAA,2
NC_037335.1,NC_032657.1,106291458,111651615,111651616,c,ct,1
NC_037335.1,NC_032657.1,106432098,111797576,111797577,c,ct,1
NC_037335.1,NC_032657.1,106655784,112021270,112021271,g,ga,1
NC_037335.1,NC_032657.1,106732679,112099251,112099255,t,tgata,4
NC_037335.1,NC_032657.1,106732766,112099342,112099343,c,ca,1
NC_037335.1,NC_032657.1,106762706,112129287,112129289,A,AWT,2
NC_037335.1,NC_032657.1,106832257,112199116,112199117,T,TY,1
NC_037335.1,NC_032657.1,106835108,112201968,112201969,t,tg,1
NC_037335.1,NC_032657.1,106967268,112334682,112334683,A,AT,1
NC_037335.1,NC_032657.1,107038080,112405540,112405541,C,CT,1
NC_037335.1,NC_032657.1,107051153,112418612,112418613,A,AC,1
NC_037335.1,NC_032657.1,107134125,112501676,112501677,A,AW,1
NC_037335.1,NC_032657.1,107158800,112526356,112526357,t,tK,1
NC_037335.1,NC_032657.1,107170904,112538465,112538466,T,TW,1
NC_037335.1,NC_032657.1,107211077,112578772,112578774,t,tta,2
NC_037335.1,NC_032657.1,107483078,112852803,112852804,a,aN,1
NC_037335.1,NC_032657.1,107499627,112869351,112869352,T,TR,1
NC_037335.1,NC_032657.1,107501091,112870815,112870820,a,aaaaac,5
NC_037335.1,NC_032657.1,107600446,112969265,112969268,t,tctg,3
NC_037335.1,NC_032657.1,107600550,112969372,112969386,t,ttcacagtccaactc,14
NC_037335.1,NC_032657.1,107687123,113061804,113061813,t,ttNNNNNNNN,9
NC_037335.1,NC_032657.1,107688312,113063002,113063003,A,AT,1
NC_037335.1,NC_032657.1,107718035,113092759,113092760,c,ca,1
NC_037335.1,NC_032657.1,107802074,113176825,113176827,c,ctt,2
NC_037335.1,NC_032657.1,107877791,113234984,113234985,t,ta,1
NC_037335.1,NC_032657.1,107966411,113323717,113323719,t,tNN,2
NC_037335.1,NC_032657.1,108113912,113471212,113471213,C,CY,1
NC_037335.1,NC_032657.1,108203909,113585125,113585126,c,ct,1
NC_037335.1,NC_032657.1,108208349,113589561,113589562,C,CR,1
NC_037335.1,NC_032657.1,108209275,113590488,113590489,A,AR,1
NC_037335.1,NC_032657.1,108221465,113602674,113602675,T,TC,1
NC_037335.1,NC_032657.1,108223337,113604550,113604551,g,gt,1
NC_037335.1,NC_032657.1,108241110,113622343,113622347,t,ttttg,4
NC_037335.1,NC_032657.1,108242022,113623259,113623260,t,ta,1
NC_037335.1,NC_032657.1,108344062,113727094,113727095,g,gt,1
NC_037335.1,NC_032657.1,108514037,113920947,113920949,T,TTG,2
NC_037335.1,NC_032657.1,108600398,114014693,114014710,t,tacaANNNNNNNNNNNNN,17
NC_037335.1,NC_032657.1,108654524,114068611,114068630,c,caacagactggttccaaata,19
NC_037335.1,NC_032657.1,108656237,114070343,114070349,C,CAAAACN,6
NC_037335.1,NC_032657.1,108667848,114082029,114082030,C,CA,1
NC_037335.1,NC_032657.1,108707182,114121297,114121300,C,CCTT,3
NC_037335.1,NC_032657.1,108794437,114207631,114207632,T,TC,1
NC_037335.1,NC_032657.1,108794554,114207749,114207750,T,TR,1
NC_037335.1,NC_032657.1,108795554,114208799,114208800,c,ca,1
NC_037335.1,NC_032657.1,108806129,114219386,114219387,T,TG,1
NC_037335.1,NC_032657.1,108844471,114257742,114257743,t,tg,1
NC_037335.1,NC_032657.1,108987221,114443306,114443307,C,CA,1
NC_037335.1,NC_032657.1,109039925,114496014,114496016,c,cgt,2
NC_037335.1,NC_032657.1,109049343,114505434,114505435,G,GA,1
NC_037335.1,NC_032657.1,109051505,114507597,114507598,c,ct,1
NC_037335.1,NC_032657.1,109051509,114507602,114507604,a,aac,2
NC_037335.1,NC_032657.1,109066744,114522839,114522840,g,gt,1
NC_037335.1,NC_032657.1,109117321,114573287,114573297,C,CGGTCAAACAY,10
NC_037335.1,NC_032657.1,109233622,114689842,114689843,C,CA,1
NC_037335.1,NC_032657.1,109262204,114718428,114718430,A,AAG,2
NC_037335.1,NC_032657.1,109273113,114729341,114729342,G,GR,1
NC_037335.1,NC_032657.1,109398670,114887659,114887660,A,AC,1
NC_037335.1,NC_032657.1,109402328,114891511,114891512,C,CM,1
NC_037335.1,NC_032657.1,109426260,114915441,114915442,A,AG,1
NC_037335.1,NC_032657.1,109441340,114930520,114930521,t,tc,1
NC_037335.1,NC_032657.1,109484384,114973592,114973593,g,gt,1
NC_037335.1,NC_032657.1,109486157,114975367,114975368,C,CT,1
NC_037335.1,NC_032657.1,109494433,114983658,114983659,T,TA,1
NC_037335.1,NC_032657.1,109495180,114984406,114984407,C,CT,1
NC_037335.1,NC_032657.1,109500238,114990143,114990145,a,aag,2
NC_037335.1,NC_032657.1,109500748,114990655,114990656,c,ct,1
NC_037335.1,NC_032657.1,109501507,114991415,114991416,T,TA,1
NC_037335.1,NC_032657.1,109526959,115016863,115016864,C,CT,1
NC_037335.1,NC_032657.1,109527995,115017900,115017901,A,AG,1
NC_037335.1,NC_032657.1,109559463,115048134,115048135,A,AR,1
NC_037335.1,NC_032657.1,109566557,115055230,115055231,G,GA,1
NC_037335.1,NC_032657.1,109566861,115055535,115055537,c,cta,2
NC_037335.1,NC_032657.1,109813472,115147926,115147928,A,AAC,2
NC_037335.1,NC_032657.1,109850118,115184302,115184303,C,CS,1
NC_037335.1,NC_032657.1,109856776,115190962,115190963,T,TC,1
NC_037335.1,NC_032657.1,109862262,115195832,115195833,A,AC,1
NC_037335.1,NC_032657.1,109873991,115207588,115207589,C,CG,1
NC_037335.1,NC_032657.1,109883761,115217358,115217378,T,TGTTCCAGACGCTCTCTGCAC,20
NC_037335.1,NC_032657.1,110067250,115400553,115400554,a,at,1
NC_037335.1,NC_032657.1,110091729,115425035,115425036,t,tg,1
NC_037335.1,NC_032657.1,110093774,115427091,115427092,c,cA,1
NC_037335.1,NC_032657.1,110096186,115429500,115429501,T,TC,1
NC_037335.1,NC_032657.1,110099222,115432537,115432541,A,ACCTG,4
NC_037335.1,NC_032657.1,110100405,115433724,115433725,C,CG,1
NC_037335.1,NC_032657.1,110100817,115434137,115434138,T,TA,1
NC_037335.1,NC_032657.1,110116548,115449854,115449855,t,ta,1
NC_037335.1,NC_032657.1,110134908,115468117,115468118,C,CG,1
NC_037335.1,NC_032657.1,110186178,115567160,115567170,G,GNNNNNNNNNN,10
NC_037335.1,NC_032657.1,110216631,115597263,115597270,T,TTGAACAA,7
NC_037335.1,NC_032657.1,110272052,115661713,115661715,C,CAG,2
NC_037335.1,NC_032657.1,110307029,115696773,115696774,A,AG,1
NC_037335.1,NC_032657.1,110445572,115830342,115830344,G,GAC,2
NC_037335.1,NC_032657.1,110460551,115845324,115845329,a,aNNNNN,5
NC_037335.1,NC_032657.1,110482543,115867327,115867329,t,taa,2
NC_037335.1,NC_032657.1,110484778,115869564,115869584,G,GTGTCTAAGtgtctaaacaac,20
NC_037335.1,NC_032657.1,110512020,115896825,115896826,C,CG,1
NC_037335.1,NC_032657.1,110512071,115896878,115896879,T,TA,1
NC_037335.1,NC_032657.1,110541241,115926051,115926052,A,AG,1
NC_037335.1,NC_032657.1,110545320,115930132,115930134,C,CAG,2
NC_037335.1,NC_032657.1,110551943,115936758,115936760,C,CAA,2
NC_037335.1,NC_032657.1,110556453,115941268,115941270,C,CAT,2
NC_037335.1,NC_032657.1,110557981,115942760,115942761,T,TA,1
NC_037335.1,NC_032657.1,110559292,115944027,115944035,C,CTGCTCGCG,8
NC_037335.1,NC_032657.1,110602166,115986905,115986906,C,CM,1
NC_037335.1,NC_032657.1,110603107,115987847,115987860,c,catgaaagtgaaaa,13
NC_037335.1,NC_032657.1,110662756,116054404,116054408,C,CATAG,4
NC_037335.1,NC_032657.1,110672814,116064477,116064478,G,GS,1
NC_037335.1,NC_032657.1,110772993,116139908,116139929,G,GGGAAGGGGCTGAGRAGATACR,21
NC_037335.1,NC_032657.1,110789845,116157328,116157330,T,TTG,2
NC_037335.1,NC_032657.1,110814306,116181617,116181620,a,attN,3
NC_037335.1,NC_032657.1,110898706,116266945,116266946,G,GN,1
NC_037335.1,NC_032657.1,110901585,116269825,116269826,a,at,1
NC_037335.1,NC_032657.1,110901585,116310644,116310645,a,at,1
NC_037335.1,NC_032657.1,110901936,116270177,116270181,T,TCAAG,4
NC_037335.1,NC_032657.1,110901936,116310996,116311000,T,TCAAG,4
NC_037335.1,NC_032657.1,110913130,116325223,116325224,T,TG,1
NC_037335.1,NC_032657.1,110920281,116332301,116332302,T,TY,1
NC_037335.1,NC_032657.1,110920402,116332425,116332426,T,TC,1
NC_037335.1,NC_032657.1,110935799,116347823,116347825,t,tNN,2
NC_037335.1,NC_032657.1,111009545,116460994,116460995,G,GT,1
NC_037335.1,NC_032657.1,111058055,116509562,116509563,C,CS,1
NC_037335.1,NC_032657.1,111070353,116522469,116522470,g,gt,1
NC_037335.1,NC_032657.1,111072180,116524282,116524286,G,GGGCK,4
NC_037335.1,NC_032657.1,111072185,116524291,116524292,G,GR,1
NC_037335.1,NC_032657.1,111093335,116545238,116545239,G,GA,1
NC_037335.1,NC_032657.1,111094361,116546265,116546266,a,ac,1
NC_037335.1,NC_032657.1,111118903,116570754,116570758,C,CTGTT,4
NC_037335.1,NC_032657.1,111126399,116578257,116578258,T,TC,1
NC_037335.1,NC_032657.1,111126404,116578263,116578266,T,TTGA,3
NC_037335.1,NC_032657.1,111132763,116584629,116584630,c,ca,1
NC_037335.1,NC_032657.1,111149362,116600903,116600904,T,TG,1
NC_037335.1,NC_032657.1,111212257,116664768,116664770,A,AAT,2
NC_037335.1,NC_032657.1,111221775,116672924,116672925,C,CA,1
NC_037335.1,NC_032657.1,111224874,116676024,116676025,C,CY,1
NC_037335.1,NC_032657.1,111240020,116691182,116691183,g,gc,1
NC_037335.1,NC_032657.1,111242060,116693225,116693226,A,AG,1
NC_037335.1,NC_032657.1,111252264,116703432,116703433,G,GR,1
NC_037335.1,NC_032657.1,111257945,116709114,116709116,c,cag,2
NC_037335.1,NC_032657.1,111287999,116739177,116739178,G,GT,1
NC_037335.1,NC_032657.1,111297977,116749046,116749047,T,TG,1
NC_037335.1,NC_032657.1,111304088,116755150,116755160,g,ggtgtgtgtgt,10
NC_037335.1,NC_032657.1,111307535,116758630,116758631,G,GA,1
NC_037335.1,NC_032657.1,111309838,116760931,116760932,G,GT,1
NC_037335.1,NC_032657.1,111311724,116762271,116762273,a,atg,2
NC_037335.1,NC_032657.1,111312379,116762928,116762929,T,TK,1
NC_037335.1,NC_032657.1,111313888,116764439,116764440,T,TG,1
NC_037335.1,NC_032657.1,111318720,116769313,116769314,C,CT,1
NC_037335.1,NC_032657.1,111338370,116789127,116789128,G,GT,1
NC_037335.1,NC_032657.1,111415705,116892181,116892182,A,AG,1
NC_037335.1,NC_032657.1,111424155,116900632,116900633,t,tg,1
NC_037335.1,NC_032657.1,111435178,116911588,116911589,G,GC,1
