Reference ID,Query ID,Reference POS,Query POS,Query END,REF,ALT,SVLEN
NC_037340.1,NC_032662.1,291569,101847,101849,C,CTG,2
NC_037340.1,NC_032662.1,291908,102189,102190,C,CA,1
NC_037340.1,NC_032662.1,326486,136765,136766,G,GA,1
NC_037340.1,NC_032662.1,326941,137223,137230,g,gaagacaa,7
NC_037340.1,NC_032662.1,333559,142623,142629,c,caaaaaa,6
NC_037340.1,NC_032662.1,341962,151227,151228,A,AC,1
NC_037340.1,NC_032662.1,343117,152379,152380,a,ag,1
NC_037340.1,NC_032662.1,345050,154315,154316,G,GC,1
NC_037340.1,NC_032662.1,356875,165951,165952,C,CA,1
NC_037340.1,NC_032662.1,358040,167118,167119,G,GA,1
NC_037340.1,NC_032662.1,448718,256037,256039,c,ctt,2
NC_037340.1,NC_032662.1,458167,265487,265489,c,ctg,2
NC_037340.1,NC_032662.1,490130,297453,297455,a,aNN,2
NC_037340.1,NC_032662.1,511397,318720,318721,t,tY,1
NC_037340.1,NC_032662.1,522431,329756,329758,t,ttc,2
NC_037340.1,NC_032662.1,565873,373204,373206,t,tNN,2
NC_037340.1,NC_032662.1,579644,386979,386980,a,at,1
NC_037340.1,NC_032662.1,659421,513879,513880,t,tN,1
NC_037340.1,NC_032662.1,766587,621299,621301,a,aNN,2
NC_037340.1,NC_032662.1,789756,644470,644472,a,aag,2
NC_037340.1,NC_032662.1,865942,745084,745096,A,ACAGCATATAGCT,12
NC_037340.1,NC_032662.1,875222,753616,753617,t,tN,1
NC_037340.1,NC_032662.1,876781,755176,755178,T,TAW,2
NC_037340.1,NC_032662.1,877786,756183,756184,C,CT,1
NC_037340.1,NC_032662.1,877786,775749,775750,C,CT,1
NC_037340.1,NC_032662.1,878451,776416,776417,G,GA,1
NC_037340.1,NC_032662.1,880111,778075,778076,t,tc,1
NC_037340.1,NC_032662.1,908957,806927,806930,a,actt,3
NC_037340.1,NC_032662.1,915012,812988,812990,T,TAC,2
NC_037340.1,NC_032662.1,934797,832787,832791,A,AGAGM,4
NC_037340.1,NC_032662.1,935518,833513,833514,C,CY,1
NC_037340.1,NC_032662.1,980696,880752,880755,A,AAGG,3
NC_037340.1,NC_032662.1,991635,891685,891686,A,AT,1
NC_037340.1,NC_032662.1,1001553,901603,901604,G,GC,1
NC_037340.1,NC_032662.1,1006862,906915,906917,A,AAK,2
NC_037340.1,NC_032662.1,1007385,907440,907441,t,ta,1
NC_037340.1,NC_032662.1,1007889,907945,907946,A,AC,1
NC_037340.1,NC_032662.1,1009034,911223,911224,G,GA,1
NC_037340.1,NC_032662.1,1010594,912784,912787,a,aacc,3
NC_037340.1,NC_032662.1,1011357,913550,913551,A,AG,1
NC_037340.1,NC_032662.1,1020906,923105,923106,c,cg,1
NC_037340.1,NC_032662.1,1027723,929925,929926,T,TY,1
NC_037340.1,NC_032662.1,1035431,937636,937637,A,AW,1
NC_037340.1,NC_032662.1,1106162,1008524,1008526,t,taa,2
NC_037340.1,NC_032662.1,1110993,1013357,1013358,t,ta,1
NC_037340.1,NC_032662.1,1111610,1013968,1013970,g,gca,2
NC_037340.1,NC_032662.1,1113771,1016132,1016160,A,AANNNNNNNNNNNNAGAAGCACGCTGCGT,28
NC_037340.1,NC_032662.1,1121121,1023507,1023508,T,TA,1
NC_037340.1,NC_032662.1,1129326,1031715,1031717,C,CAG,2
NC_037340.1,NC_032662.1,1138738,1041124,1041129,A,ATAAAC,5
NC_037340.1,NC_032662.1,1139146,1041537,1041539,t,tgc,2
NC_037340.1,NC_032662.1,1141869,1044267,1044271,C,CCTTT,4
NC_037340.1,NC_032662.1,1150487,1052920,1052921,a,ag,1
NC_037340.1,NC_032662.1,1173351,1075791,1075801,T,TTAACAAGGAC,10
NC_037340.1,NC_032662.1,1173354,1075804,1075811,A,AGTTCTTG,7
NC_037340.1,NC_032662.1,1176057,1078513,1078514,A,AC,1
NC_037340.1,NC_032662.1,1203112,1105480,1105481,g,ga,1
NC_037340.1,NC_032662.1,1225044,1127396,1127477,c,ccaggcctccctgtccatcaccaactcccggataaAAANNNNNNNNNNNNNNNNNNNNNNNNNNNNNNNNNNNNNNNNNNNN,81
NC_037340.1,NC_032662.1,1276252,1194422,1194423,g,ga,1
NC_037340.1,NC_032662.1,1306693,1224867,1224868,t,ta,1
NC_037340.1,NC_032662.1,1364442,1282621,1282641,T,TTTAGGATAGATGANNNGTCA,20
NC_037340.1,NC_032662.1,1400039,1318243,1318245,A,AGG,2
NC_037340.1,NC_032662.1,1487538,1406456,1406462,A,AGAACAT,6
NC_037340.1,NC_032662.1,1581501,1500704,1500706,C,CAA,2
NC_037340.1,NC_032662.1,1593153,1512353,1512354,t,ta,1
NC_037340.1,NC_032662.1,1593929,1513129,1513130,T,TA,1
NC_037340.1,NC_032662.1,1624886,1544085,1544094,A,ATTACTAGTC,9
NC_037340.1,NC_032662.1,1627234,1546442,1546461,t,tcagacTCCTGTCTGACagg,19
NC_037340.1,NC_032662.1,1645629,1564861,1564881,C,CAAGCANNNNNNNNNNNNTCT,20
NC_037340.1,NC_032662.1,1647412,1566664,1566665,a,at,1
NC_037340.1,NC_032662.1,1650789,1570042,1570043,T,TG,1
NC_037340.1,NC_032662.1,1661479,1580667,1580668,g,gt,1
NC_037340.1,NC_032662.1,1663012,1582201,1582202,g,gc,1
NC_037340.1,NC_032662.1,1676158,1595350,1595351,a,ac,1
NC_037340.1,NC_032662.1,1744027,1662582,1662583,t,tg,1
NC_037340.1,NC_032662.1,1767907,1686450,1686452,C,CTT,2
NC_037340.1,NC_032662.1,1773352,1691906,1691907,T,TW,1
NC_037340.1,NC_032662.1,1782162,1700717,1700719,T,TTC,2
NC_037340.1,NC_032662.1,1803384,1721943,1721944,t,tY,1
NC_037340.1,NC_032662.1,1856754,1775225,1775226,t,ta,1
NC_037340.1,NC_032662.1,1945008,1863659,1863660,c,ca,1
NC_037340.1,NC_032662.1,1946077,1864730,1864731,a,at,1
NC_037340.1,NC_032662.1,2063968,1982745,1982746,C,CT,1
NC_037340.1,NC_032662.1,2065317,1984093,1984094,A,AR,1
NC_037340.1,NC_032662.1,2066893,1985670,1985672,a,agt,2
NC_037340.1,NC_032662.1,2074609,2082447,2082482,T,TGTATANNNNNNNNNNNNNNNNNNNNNNTATATATA,35
NC_037340.1,NC_032662.1,2077411,2085285,2085286,a,ac,1
NC_037340.1,NC_032662.1,2093955,2101830,2101831,C,CT,1
NC_037340.1,NC_032662.1,2096673,2104520,2104521,t,tg,1
NC_037340.1,NC_032662.1,2101231,2109055,2109058,a,aaat,3
NC_037340.1,NC_032662.1,2109100,2116924,2116925,A,AG,1
NC_037340.1,NC_032662.1,2109100,2033973,2033974,A,AG,1
NC_037340.1,NC_032662.1,2113194,2121018,2121019,T,TA,1
NC_037340.1,NC_032662.1,2113197,2038178,2038179,A,AG,1
NC_037340.1,NC_032662.1,2114023,2039005,2039006,c,ct,1
NC_037340.1,NC_032662.1,2118591,2043570,2043594,C,CTWACTCAAGAATAATTCTGACAAA,24
NC_037340.1,NC_032662.1,2118676,2043679,2043681,C,CCA,2
NC_037340.1,NC_032662.1,2125639,2050697,2050698,G,GA,1
NC_037340.1,NC_032662.1,2134303,2059364,2059373,A,AGTAACACTG,9
NC_037340.1,NC_032662.1,2140994,2066069,2066070,G,GC,1
NC_037340.1,NC_032662.1,2141104,2066180,2066182,C,CTG,2
NC_037340.1,NC_032662.1,2143099,2068183,2068184,g,ga,1
NC_037340.1,NC_032662.1,2251670,2174317,2174318,G,GA,1
NC_037340.1,NC_032662.1,2299170,2221894,2221896,t,tgg,2
NC_037340.1,NC_032662.1,2308047,2230771,2230772,G,GS,1
NC_037340.1,NC_032662.1,2371723,2294466,2294469,A,AAAT,3
NC_037340.1,NC_032662.1,2373232,2295978,2295992,C,CACTCACTGAACACT,14
NC_037340.1,NC_032662.1,2388180,2310949,2310951,T,TTA,2
NC_037340.1,NC_032662.1,2463761,2386542,2386543,T,TA,1
NC_037340.1,NC_032662.1,2476146,2398927,2398928,A,AG,1
NC_037340.1,NC_032662.1,2559920,2482943,2482952,c,catggctgca,9
NC_037340.1,NC_032662.1,2566973,2490005,2490006,c,ct,1
NC_037340.1,NC_032662.1,2606428,2529468,2529470,t,taa,2
NC_037340.1,NC_032662.1,2629550,2553166,2553168,t,tNN,2
NC_037340.1,NC_032662.1,2648379,2571946,2571950,A,ACTAT,4
NC_037340.1,NC_032662.1,2650807,2574378,2574380,a,aag,2
NC_037340.1,NC_032662.1,2656408,2579983,2579984,a,aW,1
NC_037340.1,NC_032662.1,2747054,2670633,2670637,t,tNNNN,4
NC_037340.1,NC_032662.1,2752468,2676048,2676054,a,acctgag,6
NC_037340.1,NC_032662.1,2752663,2676250,2676251,t,tG,1
NC_037340.1,NC_032662.1,2773600,2697191,2697192,c,ct,1
NC_037340.1,NC_032662.1,2824557,2756377,2756378,c,ca,1
NC_037340.1,NC_032662.1,2824609,2756430,2756432,a,att,2
NC_037340.1,NC_032662.1,2830834,2762680,2762681,a,ag,1
NC_037340.1,NC_032662.1,2873411,2805256,2805257,g,ga,1
NC_037340.1,NC_032662.1,2886266,2818112,2818113,G,GK,1
NC_037340.1,NC_032662.1,2898394,2834657,2834658,c,ct,1
NC_037340.1,NC_032662.1,2954492,2934019,2934020,t,ta,1
NC_037340.1,NC_032662.1,2987717,2967275,2967276,T,TK,1
NC_037340.1,NC_032662.1,2993796,2973342,2973344,t,tga,2
NC_037340.1,NC_032662.1,2996265,2975813,2975815,a,aat,2
NC_037340.1,NC_032662.1,3015286,2994817,2994818,T,TY,1
NC_037340.1,NC_032662.1,3030377,2869926,2869927,g,ga,1
NC_037340.1,NC_032662.1,3030544,2870094,2870095,t,tg,1
NC_037340.1,NC_032662.1,3032358,2871909,2871910,T,TA,1
NC_037340.1,NC_032662.1,3036735,2876287,2876288,a,ac,1
NC_037340.1,NC_032662.1,3040926,2877237,2877250,a,aggtcaggtggtct,13
NC_037340.1,NC_032662.1,3360042,3255314,3255316,a,aNN,2
NC_037340.1,NC_032662.1,3391720,3286877,3286884,c,catttttt,7
NC_037340.1,NC_032662.1,3443776,3338770,3338771,C,CT,1
NC_037340.1,NC_032662.1,3451408,3346310,3346311,c,ct,1
NC_037340.1,NC_032662.1,3483944,3378948,3378949,a,at,1
NC_037340.1,NC_032662.1,3514991,3409474,3409475,T,TG,1
NC_037340.1,NC_032662.1,3515000,3409484,3409488,A,ACAAG,4
NC_037340.1,NC_032662.1,3523840,3418342,3418346,g,gtttt,4
NC_037340.1,NC_032662.1,3544000,3438505,3438506,g,ga,1
NC_037340.1,NC_032662.1,3546428,3440930,3440932,c,ctg,2
NC_037340.1,NC_032662.1,3547670,3442163,3442167,g,gagaT,4
NC_037340.1,NC_032662.1,3553925,3448420,3448421,G,GS,1
NC_037340.1,NC_032662.1,3558237,3452733,3452743,A,AAGAAATAAAT,10
NC_037340.1,NC_032662.1,3597133,3491641,3491642,T,TA,1
NC_037340.1,NC_032662.1,3608325,3502835,3502837,C,CCT,2
NC_037340.1,NC_032662.1,3624993,3518002,3518003,t,tc,1
NC_037340.1,NC_032662.1,3636241,3529260,3529261,a,aW,1
NC_037340.1,NC_032662.1,3676601,3569611,3569612,t,tg,1
NC_037340.1,NC_032662.1,3715761,3608788,3608789,C,CY,1
NC_037340.1,NC_032662.1,3722765,3615793,3615794,A,AC,1
NC_037340.1,NC_032662.1,3736524,3629548,3629549,t,ta,1
NC_037340.1,NC_032662.1,3812690,3705703,3705704,T,TA,1
NC_037340.1,NC_032662.1,3820925,3713941,3713942,T,TA,1
NC_037340.1,NC_032662.1,3821640,3714657,3714658,G,GC,1
NC_037340.1,NC_032662.1,3844956,3737979,3737980,T,TS,1
NC_037340.1,NC_032662.1,3940233,3913257,3913261,G,GAACT,4
NC_037340.1,NC_032662.1,4003852,3977888,3977889,a,ag,1
NC_037340.1,NC_032662.1,4016929,3990451,3990452,g,gt,1
NC_037340.1,NC_032662.1,4035814,4009337,4009338,A,AW,1
NC_037340.1,NC_032662.1,4057280,4030830,4030831,a,ag,1
NC_037340.1,NC_032662.1,4058526,4032092,4032093,t,ta,1
NC_037340.1,NC_032662.1,4064686,4038261,4038262,t,tc,1
NC_037340.1,NC_032662.1,4076961,4050482,4050483,C,CT,1
NC_037340.1,NC_032662.1,4084788,4058309,4058311,t,ttc,2
NC_037340.1,NC_032662.1,4093241,4066776,4066777,A,AW,1
NC_037340.1,NC_032662.1,4118849,4092398,4092403,g,gttttc,5
NC_037340.1,NC_032662.1,4138290,4111850,4111851,t,tg,1
NC_037340.1,NC_032662.1,4138310,4111871,4111872,a,ag,1
NC_037340.1,NC_032662.1,4139409,4112970,4112971,G,GR,1
NC_037340.1,NC_032662.1,4163511,4137501,4137502,c,ct,1
NC_037340.1,NC_032662.1,4163631,4137622,4137634,a,attttgttttctt,12
NC_037340.1,NC_032662.1,4164354,4138357,4138363,a,agtcttt,6
NC_037340.1,NC_032662.1,4165503,4139511,4139513,g,ggt,2
NC_037340.1,NC_032662.1,4201360,4175373,4175375,c,caa,2
NC_037340.1,NC_032662.1,4237452,4211473,4211475,T,TTC,2
NC_037340.1,NC_032662.1,4269915,4243854,4243855,c,ca,1
NC_037340.1,NC_032662.1,4676958,4753861,4753862,t,tc,1
NC_037340.1,NC_032662.1,4741993,4818897,4818937,C,CGGNNNNNNNNNNNNNNNNNNNNNNNNNNNNNNNNNNNNNN,40
NC_037340.1,NC_032662.1,4827361,4889647,4889648,T,TC,1
NC_037340.1,NC_032662.1,4827574,4889861,4889862,T,TG,1
NC_037340.1,NC_032662.1,4851600,4913893,4913896,t,tttg,3
NC_037340.1,NC_032662.1,4869997,4932329,4932331,a,act,2
NC_037340.1,NC_032662.1,4959874,5022626,5022627,t,tN,1
NC_037340.1,NC_032662.1,4973488,5036243,5036245,t,taa,2
NC_037340.1,NC_032662.1,4978231,5048808,5048809,T,TC,1
NC_037340.1,NC_032662.1,4997720,5068298,5068299,T,TC,1
NC_037340.1,NC_032662.1,5006313,5076921,5076922,g,gt,1
NC_037340.1,NC_032662.1,5021179,5091789,5091800,a,atatatacatct,11
NC_037340.1,NC_032662.1,5034536,5105156,5105158,c,cct,2
NC_037340.1,NC_032662.1,5034940,5105562,5105563,G,GA,1
NC_037340.1,NC_032662.1,5035833,5106455,5106456,A,AT,1
NC_037340.1,NC_032662.1,5040954,5111576,5111582,c,catatat,6
NC_037340.1,NC_032662.1,5043748,5114403,5114405,a,att,2
NC_037340.1,NC_032662.1,5044804,5115461,5115463,A,AAC,2
NC_037340.1,NC_032662.1,5062563,5133521,5133522,t,ta,1
NC_037340.1,NC_032662.1,5064815,5135773,5135776,g,gaGT,3
NC_037340.1,NC_032662.1,5076268,5147227,5147229,G,GCA,2
NC_037340.1,NC_032662.1,5106441,5177403,5177404,A,AT,1
NC_037340.1,NC_032662.1,5106617,5177577,5177578,g,ga,1
NC_037340.1,NC_032662.1,5120710,5191671,5191672,a,ac,1
NC_037340.1,NC_032662.1,5321576,5349000,5349001,T,TC,1
NC_037340.1,NC_032662.1,5351852,5379275,5379276,g,gc,1
NC_037340.1,NC_032662.1,5385450,5412062,5412117,a,acactgtaaAACACACANNNNNNNNNNNNNNNNNNTCGAACCGCAACTAATGAAct,55
NC_037340.1,NC_032662.1,5433184,5459819,5459820,c,ca,1
NC_037340.1,NC_032662.1,5459557,5486025,5486026,T,TG,1
NC_037340.1,NC_032662.1,5510530,5537059,5537061,a,aag,2
NC_037340.1,NC_032662.1,5510574,5537106,5537107,C,CA,1
NC_037340.1,NC_032662.1,5515051,5541586,5541590,a,aaaac,4
NC_037340.1,NC_032662.1,5574042,5597618,5597628,A,AGCCCCTTCTG,10
NC_037340.1,NC_032662.1,5581239,5604825,5604829,c,cgcca,4
NC_037340.1,NC_032662.1,5592975,5616564,5616568,t,tNNNN,4
NC_037340.1,NC_032662.1,5600857,5624448,5624450,t,tgg,2
NC_037340.1,NC_032662.1,5648203,5674214,5674215,t,tc,1
NC_037340.1,NC_032662.1,5680440,5706456,5706457,t,ta,1
NC_037340.1,NC_032662.1,5681716,5707734,5707735,C,CY,1
NC_037340.1,NC_032662.1,5686427,5712438,5712439,T,TA,1
NC_037340.1,NC_032662.1,5702604,5728614,5728615,t,ta,1
NC_037340.1,NC_032662.1,5718178,5744254,5744263,a,agaagaaaag,9
NC_037340.1,NC_032662.1,5743408,5769562,5769563,T,TC,1
NC_037340.1,NC_032662.1,5760943,5787107,5787108,c,ca,1
NC_037340.1,NC_032662.1,5768817,5794928,5794929,G,GA,1
NC_037340.1,NC_032662.1,5775813,5801924,5801926,c,ctg,2
NC_037340.1,NC_032662.1,5778984,5805096,5805097,g,gt,1
NC_037340.1,NC_032662.1,5782778,5808887,5808888,C,CT,1
NC_037340.1,NC_032662.1,5783613,5809722,5809723,A,AT,1
NC_037340.1,NC_032662.1,5788070,5814177,5814181,T,TCATA,4
NC_037340.1,NC_032662.1,5809651,5835765,5835766,C,CT,1
NC_037340.1,NC_032662.1,5843458,5869607,5869610,t,tttc,3
NC_037340.1,NC_032662.1,5849671,5875822,5875823,t,tc,1
NC_037340.1,NC_032662.1,5854447,5880593,5880594,A,AR,1
NC_037340.1,NC_032662.1,5861939,5888314,5888338,G,GTTNNNNNNNNNNNNNNNNNNNNNN,24
NC_037340.1,NC_032662.1,5886537,5912942,5912944,c,ctt,2
NC_037340.1,NC_032662.1,5913010,6016873,6016874,g,ga,1
NC_037340.1,NC_032662.1,5920438,6026509,6026511,c,cNN,2
NC_037340.1,NC_032662.1,5927005,6033089,6033090,a,at,1
NC_037340.1,NC_032662.1,5930561,6037688,6037689,G,GA,1
NC_037340.1,NC_032662.1,6128563,6204719,6204720,t,tc,1
NC_037340.1,NC_032662.1,6211098,6287212,6287213,A,AG,1
NC_037340.1,NC_032662.1,6211114,6287229,6287230,C,CA,1
NC_037340.1,NC_032662.1,6214382,6290632,6290659,T,TGGTTAGAAGGTCATAAACACACCTGCA,27
NC_037340.1,NC_032662.1,6216533,6292810,6292813,c,cgaa,3
NC_037340.1,NC_032662.1,6291873,6368118,6368119,T,TC,1
NC_037340.1,NC_032662.1,6294855,6371101,6371104,a,aagg,3
NC_037340.1,NC_032662.1,6297263,6373511,6373512,a,at,1
NC_037340.1,NC_032662.1,6307023,6383272,6383278,c,ccatgta,6
NC_037340.1,NC_032662.1,6329408,6405311,6405313,a,acc,2
NC_037340.1,NC_032662.1,6333756,6409657,6409658,a,aG,1
NC_037340.1,NC_032662.1,6339011,6414909,6414911,t,tag,2
NC_037340.1,NC_032662.1,6347975,6423998,6424006,a,atctcaccc,8
NC_037340.1,NC_032662.1,6349804,6425834,6425835,A,AM,1
NC_037340.1,NC_032662.1,6357222,6433255,6433256,a,at,1
NC_037340.1,NC_032662.1,6357696,6433730,6433731,c,ca,1
NC_037340.1,NC_032662.1,6360235,6436270,6436271,t,tc,1
NC_037340.1,NC_032662.1,6375112,6451130,6451131,G,GA,1
NC_037340.1,NC_032662.1,6386341,6462454,6462455,A,AG,1
NC_037340.1,NC_032662.1,6403409,6479526,6479527,A,AC,1
NC_037340.1,NC_032662.1,6474719,6549929,6549930,A,AC,1
NC_037340.1,NC_032662.1,6512229,6587031,6587032,a,ag,1
NC_037340.1,NC_032662.1,6514539,6589337,6589339,A,ACT,2
NC_037340.1,NC_032662.1,6514652,6589452,6589453,T,TA,1
NC_037340.1,NC_032662.1,6559855,6634940,6634941,G,GS,1
NC_037340.1,NC_032662.1,6578345,6653435,6653436,a,ag,1
NC_037340.1,NC_032662.1,6580897,6655988,6655989,t,tc,1
NC_037340.1,NC_032662.1,6588863,6663949,6663953,a,aaaNN,4
NC_037340.1,NC_032662.1,6589071,6664166,6664168,C,CTT,2
NC_037340.1,NC_032662.1,6595752,6670852,6670877,c,caaatcctgaaagatagWaaaaaaaa,25
NC_037340.1,NC_032662.1,6622141,6697566,6697567,C,CA,1
NC_037340.1,NC_032662.1,6631320,6706745,6706754,a,aaaaTAAANN,9
NC_037340.1,NC_032662.1,6642203,6717640,6717642,a,aNN,2
NC_037340.1,NC_032662.1,6670846,6746269,6746271,T,TTC,2
NC_037340.1,NC_032662.1,6673586,6749009,6749010,C,CM,1
NC_037340.1,NC_032662.1,6673722,6749146,6749148,a,aag,2
NC_037340.1,NC_032662.1,6677821,6753248,6753249,t,ta,1
NC_037340.1,NC_032662.1,6687282,6762749,6762750,T,TC,1
NC_037340.1,NC_032662.1,6689195,6764665,6764666,C,CM,1
NC_037340.1,NC_032662.1,6689406,6764873,6764874,c,ct,1
NC_037340.1,NC_032662.1,6692285,6767753,6767754,t,tg,1
NC_037340.1,NC_032662.1,6694108,6769577,6769580,g,ggaa,3
NC_037340.1,NC_032662.1,6694217,6769689,6769690,G,GC,1
NC_037340.1,NC_032662.1,6698371,6773850,6773851,A,AG,1
NC_037340.1,NC_032662.1,6739719,6815210,6815211,C,CA,1
NC_037340.1,NC_032662.1,6789890,6897600,6897601,g,ga,1
NC_037340.1,NC_032662.1,6849803,6957036,6957039,A,ACAT,3
NC_037340.1,NC_032662.1,6883242,6990483,6990484,g,gt,1
NC_037340.1,NC_032662.1,6888999,6996245,6996246,T,TA,1
NC_037340.1,NC_032662.1,6892251,6999487,6999490,A,AAAR,3
NC_037340.1,NC_032662.1,6894424,7001670,7001671,A,AC,1
NC_037340.1,NC_032662.1,6974428,7081118,7081121,A,ANNN,3
NC_037340.1,NC_032662.1,7001674,7108367,7108368,a,at,1
NC_037340.1,NC_032662.1,7070945,7177641,7177642,A,AG,1
NC_037340.1,NC_032662.1,7079019,7185375,7185376,C,CA,1
NC_037340.1,NC_032662.1,7356680,7462673,7462674,a,ag,1
NC_037340.1,NC_032662.1,7413498,7519496,7519498,t,tga,2
NC_037340.1,NC_032662.1,7490490,7676252,7676253,c,cg,1
NC_037340.1,NC_032662.1,7635586,7835302,7835308,g,gttcaac,6
NC_037340.1,NC_032662.1,7635715,7835437,7835438,c,ct,1
NC_037340.1,NC_032662.1,7636971,7836694,7836696,t,tNN,2
NC_037340.1,NC_032662.1,7959964,8188405,8188406,c,ct,1
NC_037340.1,NC_032662.1,8098749,8334801,8334802,C,CT,1
NC_037340.1,NC_032662.1,8181851,8417807,8417808,c,ct,1
NC_037340.1,NC_032662.1,8210113,8446174,8446176,t,tNN,2
NC_037340.1,NC_032662.1,8222469,8459871,8459872,t,tc,1
NC_037340.1,NC_032662.1,8265102,8501995,8501996,A,AT,1
NC_037340.1,NC_032662.1,8269348,8506242,8506243,g,gt,1
NC_037340.1,NC_032662.1,8269476,8506371,8506372,c,ca,1
NC_037340.1,NC_032662.1,8548590,8789620,8789621,C,CA,1
NC_037340.1,NC_032662.1,8631774,8872599,8872601,G,GAA,2
NC_037340.1,NC_032662.1,8631857,8872684,8872685,C,CA,1
NC_037340.1,NC_032662.1,8643276,8884047,8884048,c,cg,1
NC_037340.1,NC_032662.1,8649054,8889839,8889840,t,ta,1
NC_037340.1,NC_032662.1,8676123,8916912,8916917,T,TTGAAG,5
NC_037340.1,NC_032662.1,8708461,8949254,8949264,t,tatatatacac,10
NC_037340.1,NC_032662.1,8708925,8949728,8949730,a,acg,2
NC_037340.1,NC_032662.1,8712695,8953501,8953502,T,TG,1
NC_037340.1,NC_032662.1,8716291,8957108,8957109,t,tW,1
NC_037340.1,NC_032662.1,8721403,8962212,8962217,a,aacacc,5
NC_037340.1,NC_032662.1,8722462,8963275,8963280,a,aaaaac,5
NC_037340.1,NC_032662.1,8727165,8967794,8967795,C,CG,1
NC_037340.1,NC_032662.1,8727574,8968204,8968209,c,cgtgtg,5
NC_037340.1,NC_032662.1,8731503,8972134,8972137,T,TCTC,3
NC_037340.1,NC_032662.1,8747386,8988017,8988018,C,CT,1
NC_037340.1,NC_032662.1,8755735,8996364,8996365,G,GR,1
NC_037340.1,NC_032662.1,8783901,9024489,9024491,c,ctt,2
NC_037340.1,NC_032662.1,8784182,9024770,9024775,A,AAGTTT,5
NC_037340.1,NC_032662.1,8785176,9025769,9025770,T,TY,1
NC_037340.1,NC_032662.1,8787505,9028099,9028100,G,GC,1
NC_037340.1,NC_032662.1,8788652,9029266,9029267,a,ac,1
NC_037340.1,NC_032662.1,8788668,9029283,9029305,a,atgaacagggaagcccggtgtgc,22
NC_037340.1,NC_032662.1,8788833,9029469,9029493,G,GATTAAGCTGCCTTCATCATATTCT,24
NC_037340.1,NC_032662.1,8789335,9029995,9030001,g,gcgactt,6
NC_037340.1,NC_032662.1,8829082,9060049,9060052,a,aaag,3
NC_037340.1,NC_032662.1,8892414,9122042,9122043,a,ag,1
NC_037340.1,NC_032662.1,8939527,9169399,9169401,C,CTG,2
NC_037340.1,NC_032662.1,8962028,9191984,9191986,A,ATC,2
NC_037340.1,NC_032662.1,8986341,9216293,9216297,t,ttata,4
NC_037340.1,NC_032662.1,8988795,9218751,9218752,t,ta,1
NC_037340.1,NC_032662.1,9017356,9245925,9245926,t,tc,1
NC_037340.1,NC_032662.1,9025549,9254118,9254143,a,agagagagagagagagagattttttt,25
NC_037340.1,NC_032662.1,9153848,9383190,9383191,g,ga,1
NC_037340.1,NC_032662.1,9233216,9462406,9462409,a,aagg,3
NC_037340.1,NC_032662.1,9332746,9562130,9562134,t,tNNNN,4
NC_037340.1,NC_032662.1,9351495,9580882,9580883,C,CT,1
NC_037340.1,NC_032662.1,9392049,9621403,9621405,A,AAG,2
NC_037340.1,NC_032662.1,9458877,9688241,9688243,A,ACT,2
NC_037340.1,NC_032662.1,9497072,9726444,9726445,t,tg,1
NC_037340.1,NC_032662.1,10835928,16613002,16613006,G,GACTA,4
NC_037340.1,NC_032662.1,10836100,16613178,16613179,A,AT,1
NC_037340.1,NC_032662.1,10837928,16615001,16615002,C,CT,1
NC_037340.1,NC_032662.1,10838319,16615393,16615409,G,GATCCACTGGATGTGGC,16
NC_037340.1,NC_032662.1,10838808,16615897,16615898,T,TG,1
NC_037340.1,NC_032662.1,10844978,16622073,16622074,t,ta,1
NC_037340.1,NC_032662.1,10846172,16623266,16623267,A,AR,1
NC_037340.1,NC_032662.1,10848220,16625312,16625313,g,ga,1
NC_037340.1,NC_032662.1,10851352,16628455,16628456,g,gt,1
NC_037340.1,NC_032662.1,10854108,16631210,16631218,c,ctccttttt,8
NC_037340.1,NC_032662.1,10854524,16631634,16631635,G,GC,1
NC_037340.1,NC_032662.1,10856631,16633741,16633742,t,tc,1
NC_037340.1,NC_032662.1,10856916,16634027,16634028,G,GT,1
NC_037340.1,NC_032662.1,10859425,16636447,16636453,G,GTAACAC,6
NC_037340.1,NC_032662.1,10863828,16640855,16640856,t,tg,1
NC_037340.1,NC_032662.1,10866244,16643272,16643274,C,CAG,2
NC_037340.1,NC_032662.1,10866275,16643305,16643308,A,AGTT,3
NC_037340.1,NC_032662.1,10866708,16643741,16643742,A,AT,1
NC_037340.1,NC_032662.1,10867785,16644819,16644823,T,TACTG,4
NC_037340.1,NC_032662.1,10877116,16654157,16654158,G,GA,1
NC_037340.1,NC_032662.1,10877368,16654410,16654412,a,aat,2
NC_037340.1,NC_032662.1,10878292,16655335,16655337,c,cag,2
NC_037340.1,NC_032662.1,10878715,16655759,16655762,C,CTCT,3
NC_037340.1,NC_032662.1,10985605,9747776,9747780,c,ctctt,4
NC_037340.1,NC_032662.1,10985766,9747941,9747988,T,TTGAGCTTACCTTAAGCAAACCGTTAAGCAAACCGTTAAGCAAACCAC,47
NC_037340.1,NC_032662.1,10987700,9749842,9749846,a,aaccc,4
NC_037340.1,NC_032662.1,10990923,9753067,9753068,t,ta,1
NC_037340.1,NC_032662.1,10991067,9753212,9753213,t,tg,1
NC_037340.1,NC_032662.1,10992920,9755088,9755089,g,ga,1
NC_037340.1,NC_032662.1,10994285,9756456,9756457,T,TC,1
NC_037340.1,NC_032662.1,10997192,9774994,9774997,A,AGAG,3
NC_037340.1,NC_032662.1,11001945,9779749,9779794,T,TAGTTATTTTGAATACTCTTGTCCTTTAGCCTCAATACTAGAGTTC,45
NC_037340.1,NC_032662.1,11086845,16671527,16671528,A,AG,1
NC_037340.1,NC_032662.1,11087104,16671787,16671793,C,CGGACAA,6
NC_037340.1,NC_032662.1,11087281,16671970,16671972,a,att,2
NC_037340.1,NC_032662.1,11089537,16674214,16674222,C,CTTCCCCAY,8
NC_037340.1,NC_032662.1,11090698,16675377,16675379,t,taa,2
NC_037340.1,NC_032662.1,11091743,16676424,16676425,t,ta,1
NC_037340.1,NC_032662.1,11092939,16677620,16677621,G,GC,1
NC_037340.1,NC_032662.1,11094086,16678739,16678742,t,tagc,3
NC_037340.1,NC_032662.1,11094224,16678880,16678882,C,CTT,2
NC_037340.1,NC_032662.1,11094421,16679075,16679078,T,TATC,3
NC_037340.1,NC_032662.1,11094480,16679137,16679140,C,CCCG,3
NC_037340.1,NC_032662.1,11094600,16679260,16679263,A,ATGT,3
NC_037340.1,NC_032662.1,11096318,16680978,16680991,g,gtttttttctttcc,13
NC_037340.1,NC_032662.1,11096509,16681182,16681184,T,TTC,2
NC_037340.1,NC_032662.1,11098292,16682966,16682967,t,tg,1
NC_037340.1,NC_032662.1,11099206,16683874,16683876,T,TGA,2
NC_037340.1,NC_032662.1,11100829,16685487,16685490,t,tatg,3
NC_037340.1,NC_032662.1,11101450,16686112,16686122,a,agttcagttct,10
NC_037340.1,NC_032662.1,11102401,16687061,16687063,c,ctg,2
NC_037340.1,NC_032662.1,11106131,16690793,16690794,t,ta,1
NC_037340.1,NC_032662.1,11109109,16693772,16693774,C,CCG,2
NC_037340.1,NC_032662.1,11109338,16694008,16694011,a,aaag,3
NC_037340.1,NC_032662.1,11119531,16704309,16704310,g,gc,1
NC_037340.1,NC_032662.1,11128878,16718835,16718836,T,TA,1
NC_037340.1,NC_032662.1,11128910,16718868,16718869,C,CT,1
NC_037340.1,NC_032662.1,11158201,16748179,16748183,G,GCGAA,4
NC_037340.1,NC_032662.1,11159328,16749310,16749313,G,GGGR,3
NC_037340.1,NC_032662.1,11161654,16751670,16751672,t,ttc,2
NC_037340.1,NC_032662.1,11349996,9809960,9809961,T,TC,1
NC_037340.1,NC_032662.1,11350154,9810119,9810120,A,AG,1
NC_037340.1,NC_032662.1,11350517,9810482,9810483,A,AT,1
NC_037340.1,NC_032662.1,11351026,9810993,9810994,g,ga,1
NC_037340.1,NC_032662.1,11351258,9811226,9811227,g,gt,1
NC_037340.1,NC_032662.1,11378057,9838028,9838029,a,at,1
NC_037340.1,NC_032662.1,11424638,9884855,9884856,C,CA,1
NC_037340.1,NC_032662.1,11428809,9889028,9889033,c,ctgccg,5
NC_037340.1,NC_032662.1,11435682,9896190,9896210,a,agaaatgcaatgccaaagcat,20
NC_037340.1,NC_032662.1,11435878,9896406,9896408,a,aac,2
NC_037340.1,NC_032662.1,11473028,9933560,9933561,T,TG,1
NC_037340.1,NC_032662.1,11531040,9991931,9991932,T,TC,1
NC_037340.1,NC_032662.1,11588146,10042754,10042756,G,GCA,2
NC_037340.1,NC_032662.1,11588191,10042801,10042802,c,ca,1
NC_037340.1,NC_032662.1,11644171,10101255,10101256,a,at,1
NC_037340.1,NC_032662.1,11737774,10195997,10195998,T,TC,1
NC_037340.1,NC_032662.1,12090901,10586476,10586477,C,CM,1
NC_037340.1,NC_032662.1,12243739,10739531,10739533,T,TTG,2
NC_037340.1,NC_032662.1,12333080,10829316,10829317,t,tc,1
NC_037340.1,NC_032662.1,12438998,10935418,10935419,G,GA,1
NC_037340.1,NC_032662.1,12453015,10949399,10949400,A,AC,1
NC_037340.1,NC_032662.1,12565127,11061371,11061372,A,AG,1
NC_037340.1,NC_032662.1,12625605,11122310,11122311,t,ta,1
NC_037340.1,NC_032662.1,12640220,11224206,11224207,A,AC,1
NC_037340.1,NC_032662.1,12640765,11224751,11224752,C,CA,1
NC_037340.1,NC_032662.1,12754472,11340524,11340526,C,CAG,2
NC_037340.1,NC_032662.1,12754604,11340658,11340659,C,CA,1
NC_037340.1,NC_032662.1,12827950,11414187,11414188,G,GC,1
NC_037340.1,NC_032662.1,12844587,11430825,11430839,c,ctagttatttcaaat,14
NC_037340.1,NC_032662.1,12894371,11480624,11480626,A,ACC,2
NC_037340.1,NC_032662.1,13114231,11700005,11700006,t,tg,1
NC_037340.1,NC_032662.1,13351366,11937626,11937627,a,at,1
NC_037340.1,NC_032662.1,13352967,11939228,11939229,G,GT,1
NC_037340.1,NC_032662.1,13353014,11939276,11939277,A,AG,1
NC_037340.1,NC_032662.1,13453415,12053321,12053322,T,TA,1
NC_037340.1,NC_032662.1,13576285,12176043,12176044,C,CG,1
NC_037340.1,NC_032662.1,13576287,12176046,12176048,A,AAG,2
NC_037340.1,NC_032662.1,13845103,12444874,12444881,g,gattttga,7
NC_037340.1,NC_032662.1,13845497,12445275,12445284,t,tttctatttc,9
NC_037340.1,NC_032662.1,13845497,12514032,12514041,t,tttctatttc,9
NC_037340.1,NC_032662.1,13846647,12446434,12446435,c,ct,1
NC_037340.1,NC_032662.1,13979101,12647880,12647881,t,ta,1
NC_037340.1,NC_032662.1,14052920,12721841,12721842,A,AC,1
NC_037340.1,NC_032662.1,14112377,12783899,12783901,T,TAA,2
NC_037340.1,NC_032662.1,14243632,12915381,12915385,t,taaaa,4
NC_037340.1,NC_032662.1,14333410,13005159,13005161,g,gaa,2
NC_037340.1,NC_032662.1,14357445,13029304,13029316,G,GGACGTTNNNNNN,12
NC_037340.1,NC_032662.1,14360917,13032791,13032792,A,AM,1
NC_037340.1,NC_032662.1,14360957,13032832,13032833,T,TK,1
NC_037340.1,NC_032662.1,14419581,13117553,13117719,A,ATATTCCTGTACTAAATGGTAGATTtggaaatctttatttaaaaaacaacacaatcaccaaactaaaaaaaaaaacaaaaacaacttgtCTGTGATTTTCTGATGCAGAGTTGGNNNNNNNNNNNNNNNNNNNNNNNNNNNNNNNNNNNNNNNNNNNNNNNNNNNNT,166
NC_037340.1,NC_032662.1,14641650,13349752,13349753,T,TG,1
NC_037340.1,NC_032662.1,14769829,13481830,13481831,T,TA,1
NC_037340.1,NC_032662.1,14894412,13606360,13606362,a,aNN,2
NC_037340.1,NC_032662.1,14941478,13653432,13653433,c,cg,1
NC_037340.1,NC_032662.1,15306426,14075790,14075792,t,tta,2
NC_037340.1,NC_032662.1,15325893,14095259,14095266,c,caccctcg,7
NC_037340.1,NC_032662.1,15325899,14095272,14095273,t,tc,1
NC_037340.1,NC_032662.1,15325982,14095356,14095357,a,at,1
NC_037340.1,NC_032662.1,15326457,14095832,14095833,g,ga,1
NC_037340.1,NC_032662.1,15329705,14099100,14099102,A,AAT,2
NC_037340.1,NC_032662.1,15330245,14099642,14099643,T,TA,1
NC_037340.1,NC_032662.1,15335400,14104800,14104801,c,ca,1
NC_037340.1,NC_032662.1,15342198,14111596,14111597,c,ct,1
NC_037340.1,NC_032662.1,15368774,14140017,14140018,A,AC,1
NC_037340.1,NC_032662.1,15507017,14277817,14277818,T,TA,1
NC_037340.1,NC_032662.1,15538647,14312266,14312267,C,CT,1
NC_037340.1,NC_032662.1,15669169,14442916,14442917,T,TA,1
NC_037340.1,NC_032662.1,15714813,14488562,14488563,c,ca,1
NC_037340.1,NC_032662.1,15747214,14521028,14521029,A,AT,1
NC_037340.1,NC_032662.1,15755881,14529689,14529690,C,CY,1
NC_037340.1,NC_032662.1,15795521,14569351,14569352,t,tc,1
NC_037340.1,NC_032662.1,15837235,14611071,14611072,C,CY,1
NC_037340.1,NC_032662.1,15838664,14612505,14612506,A,AC,1
NC_037340.1,NC_032662.1,15850099,14623944,14623945,g,gS,1
NC_037340.1,NC_032662.1,15920146,14694010,14694011,T,TY,1
NC_037340.1,NC_032662.1,15957764,14731624,14731625,T,TC,1
NC_037340.1,NC_032662.1,15959821,14733684,14733689,A,AAGATT,5
NC_037340.1,NC_032662.1,15996989,14771082,14771083,T,TG,1
NC_037340.1,NC_032662.1,16066202,14845092,14845094,c,ctt,2
NC_037340.1,NC_032662.1,16110211,14893788,14893789,C,CA,1
NC_037340.1,NC_032662.1,16121935,14905514,14905517,a,aaat,3
NC_037340.1,NC_032662.1,16151350,14934738,14934739,T,TA,1
NC_037340.1,NC_032662.1,16164758,14948255,14948256,g,gc,1
NC_037340.1,NC_032662.1,16220440,15004492,15004493,c,ca,1
NC_037340.1,NC_032662.1,16220453,15004506,15004507,c,ca,1
NC_037340.1,NC_032662.1,16268380,15051237,15051238,a,ac,1
NC_037340.1,NC_032662.1,16283814,15066681,15066684,T,TTGA,3
NC_037340.1,NC_032662.1,16290136,15072999,15073000,T,TK,1
NC_037340.1,NC_032662.1,16316546,15100655,15100656,g,gt,1
NC_037340.1,NC_032662.1,16319012,15103122,15103131,T,TNNNNNNNNN,9
NC_037340.1,NC_032662.1,16323956,15107974,15107975,c,ca,1
NC_037340.1,NC_032662.1,16332430,15116595,15116596,T,TG,1
NC_037340.1,NC_032662.1,16333774,15117946,15117947,c,ct,1
NC_037340.1,NC_032662.1,16335628,15119802,15119803,t,ta,1
NC_037340.1,NC_032662.1,16352493,15136435,15136443,t,tcttccaac,8
NC_037340.1,NC_032662.1,16379163,15163016,15163017,C,CS,1
NC_037340.1,NC_032662.1,16399797,15188208,15188210,t,tta,2
NC_037340.1,NC_032662.1,16403347,15191764,15191765,G,GR,1
NC_037340.1,NC_032662.1,16405440,15193857,15193858,c,ct,1
NC_037340.1,NC_032662.1,16406797,15195215,15195216,G,GA,1
NC_037340.1,NC_032662.1,16407334,15195753,15195757,c,ctctg,4
NC_037340.1,NC_032662.1,16439386,15227112,15227126,g,gcacacacacacaca,14
NC_037340.1,NC_032662.1,16446462,15234201,15234207,T,TGAGAAG,6
NC_037340.1,NC_032662.1,16472600,15260462,15260468,T,TGAGCTG,6
NC_037340.1,NC_032662.1,16484869,15272736,15272737,T,TA,1
NC_037340.1,NC_032662.1,16491924,15279856,15279857,g,ga,1
NC_037340.1,NC_032662.1,16491937,15279870,15279871,g,ga,1
NC_037340.1,NC_032662.1,16507438,15297133,15297135,C,CCM,2
NC_037340.1,NC_032662.1,16514697,15304449,15304450,T,TC,1
NC_037340.1,NC_032662.1,16528082,15317835,15317836,g,gt,1
NC_037340.1,NC_032662.1,16655064,15460880,15460881,G,GA,1
NC_037340.1,NC_032662.1,16698473,15504172,15504175,a,agag,3
NC_037340.1,NC_032662.1,16698604,15504308,15504313,t,taaaga,5
NC_037340.1,NC_032662.1,16698616,15504325,15504329,a,aaaag,4
NC_037340.1,NC_032662.1,16698960,15516655,15516656,g,ga,1
NC_037340.1,NC_032662.1,16719637,15537340,15537341,g,gt,1
NC_037340.1,NC_032662.1,16884239,15702526,15702527,a,aN,1
NC_037340.1,NC_032662.1,16940214,15758425,15758426,C,CA,1
NC_037340.1,NC_032662.1,16966270,15784551,15784552,G,GA,1
NC_037340.1,NC_032662.1,17043926,15862227,15862228,t,ta,1
NC_037340.1,NC_032662.1,17046425,15864727,15864738,T,TAGCCCTCAGTC,11
NC_037340.1,NC_032662.1,17081140,15899461,15899462,g,gc,1
NC_037340.1,NC_032662.1,17089475,15907797,15907798,G,GA,1
NC_037340.1,NC_032662.1,17089767,15908090,15908095,g,gcagca,5
NC_037340.1,NC_032662.1,17092666,15910993,15910994,g,ga,1
NC_037340.1,NC_032662.1,17093879,15912207,15912208,t,ta,1
NC_037340.1,NC_032662.1,17112055,15930394,15930395,c,ct,1
NC_037340.1,NC_032662.1,17121412,15936133,15936136,t,ttaa,3
NC_037340.1,NC_032662.1,17177639,15992459,15992460,t,ta,1
NC_037340.1,NC_032662.1,17207091,16021917,16021919,c,ctt,2
NC_037340.1,NC_032662.1,17210142,16024973,16024975,a,aag,2
NC_037340.1,NC_032662.1,17256991,16071540,16071541,G,GC,1
NC_037340.1,NC_032662.1,17261376,16075924,16075926,G,GGR,2
NC_037340.1,NC_032662.1,17263406,16077959,16077960,T,TY,1
NC_037340.1,NC_032662.1,17264519,16079075,16079076,G,GK,1
NC_037340.1,NC_032662.1,17264532,16079089,16079090,A,AC,1
NC_037340.1,NC_032662.1,17264601,16079159,16079160,T,TY,1
NC_037340.1,NC_032662.1,17265122,16079680,16079681,A,AT,1
NC_037340.1,NC_032662.1,17266088,16080646,16080647,T,TW,1
NC_037340.1,NC_032662.1,17445854,16260392,16260394,t,taa,2
NC_037340.1,NC_032662.1,17452251,16266790,16266791,t,ta,1
NC_037340.1,NC_032662.1,17494647,16309188,16309190,G,GGT,2
NC_037340.1,NC_032662.1,17495922,16310465,16310466,G,GS,1
NC_037340.1,NC_032662.1,17518266,16332810,16332811,C,CG,1
NC_037340.1,NC_032662.1,17518277,16332822,16332823,C,CG,1
NC_037340.1,NC_032662.1,17537877,16386878,16386879,t,tg,1
NC_037340.1,NC_032662.1,17546009,16395069,16395070,a,ac,1
NC_037340.1,NC_032662.1,17549231,16398289,16398290,t,ta,1
NC_037340.1,NC_032662.1,17563744,16412496,16412498,a,atg,2
NC_037340.1,NC_032662.1,17564807,16413560,16413562,A,AAC,2
NC_037340.1,NC_032662.1,17565277,16414032,16414035,A,AATG,3
NC_037340.1,NC_032662.1,17567642,16416394,16416395,C,CT,1
NC_037340.1,NC_032662.1,17587588,16436007,16436008,G,GA,1
NC_037340.1,NC_032662.1,17596367,16444698,16444700,C,CAT,2
NC_037340.1,NC_032662.1,17605433,16453735,16453739,T,TGGTC,4
NC_037340.1,NC_032662.1,17606312,16454619,16454630,C,CTGCTAGTAAGT,11
NC_037340.1,NC_032662.1,17610778,16468889,16468890,A,AT,1
NC_037340.1,NC_032662.1,17610823,16468842,16468843,C,CA,1
NC_037340.1,NC_032662.1,17610827,16468837,16468838,A,AC,1
NC_037340.1,NC_032662.1,17611118,16468546,16468547,a,at,1
NC_037340.1,NC_032662.1,17611235,16468429,16468430,c,ca,1
NC_037340.1,NC_032662.1,17613226,16466433,16466434,A,AG,1
NC_037340.1,NC_032662.1,17617565,16862509,16862512,t,tctc,3
NC_037340.1,NC_032662.1,17618206,16863153,16863154,T,TA,1
NC_037340.1,NC_032662.1,17624892,16869836,16869837,t,tc,1
NC_037340.1,NC_032662.1,17625305,16870250,16870261,C,CCAACTTACTAG,11
NC_037340.1,NC_032662.1,17625350,16870306,16870307,A,AC,1
NC_037340.1,NC_032662.1,17625386,16870343,16870344,T,TG,1
NC_037340.1,NC_032662.1,17646198,16894889,16894892,G,GTGC,3
NC_037340.1,NC_032662.1,17646834,16884935,16884936,t,ta,1
NC_037340.1,NC_032662.1,17671363,16920052,16920053,t,tc,1
NC_037340.1,NC_032662.1,17705847,16954533,16954539,T,TACAAGG,6
NC_037340.1,NC_032662.1,17951205,17199985,17199986,t,tg,1
NC_037340.1,NC_032662.1,17951222,17200003,17200004,g,gt,1
NC_037340.1,NC_032662.1,18032721,17281906,17281908,g,gtt,2
NC_037340.1,NC_032662.1,18035800,17284992,17284993,C,CS,1
NC_037340.1,NC_032662.1,18104553,17353760,17353761,C,CA,1
NC_037340.1,NC_032662.1,18119546,17368754,17368756,c,cca,2
NC_037340.1,NC_032662.1,18129004,17378220,17378227,g,gggAGACC,7
NC_037340.1,NC_032662.1,18141568,17390791,17390792,C,CY,1
NC_037340.1,NC_032662.1,18145422,17394649,17394650,C,CT,1
NC_037340.1,NC_032662.1,18150771,17399999,17400000,T,TY,1
NC_037340.1,NC_032662.1,18313038,17561591,17561592,t,ta,1
NC_037340.1,NC_032662.1,18387298,17635896,17635909,T,TATCCCTCCACTCW,13
NC_037340.1,NC_032662.1,18417200,17665819,17665820,A,AR,1
NC_037340.1,NC_032662.1,18500438,17749895,17749896,G,GC,1
NC_037340.1,NC_032662.1,18501682,17751143,17751161,A,ATGCAAANNNNNNNNNNNN,18
NC_037340.1,NC_032662.1,18509777,17759255,17759256,T,TC,1
NC_037340.1,NC_032662.1,18535504,17784987,17784989,C,CAT,2
NC_037340.1,NC_032662.1,18546446,17795933,17795935,c,cca,2
NC_037340.1,NC_032662.1,18546820,17796311,17796319,c,ccacacaca,8
NC_037340.1,NC_032662.1,18556925,17806425,17806428,C,CACT,3
NC_037340.1,NC_032662.1,18659823,17909368,17909369,A,AG,1
NC_037340.1,NC_032662.1,18701015,17950602,17950603,t,ta,1
NC_037340.1,NC_032662.1,18705757,17955345,17955347,C,CAT,2
NC_037340.1,NC_032662.1,18710241,17959831,17959832,t,ta,1
NC_037340.1,NC_032662.1,18725015,17974613,17974616,t,tgtg,3
NC_037340.1,NC_032662.1,18743238,17992853,17992857,C,CATGA,4
NC_037340.1,NC_032662.1,18745674,17995292,17995293,c,ca,1
NC_037340.1,NC_032662.1,18751024,18000647,18000648,G,GA,1
NC_037340.1,NC_032662.1,18759090,18008716,18008717,a,at,1
NC_037340.1,NC_032662.1,18763466,18013085,18013086,c,ct,1
NC_037340.1,NC_032662.1,18765153,18014773,18014783,A,AGTCTTCAATC,10
NC_037340.1,NC_032662.1,18785477,18035110,18035111,a,at,1
NC_037340.1,NC_032662.1,18904804,18154447,18154448,t,tg,1
NC_037340.1,NC_032662.1,18908887,18158531,18158532,c,ca,1
NC_037340.1,NC_032662.1,18917194,18166838,18166850,G,GAATTGGTATATT,12
NC_037340.1,NC_032662.1,18917313,18166969,18166970,T,TA,1
NC_037340.1,NC_032662.1,19031349,18281009,18281010,g,ga,1
NC_037340.1,NC_032662.1,19203295,18465482,18465484,c,cgg,2
NC_037340.1,NC_032662.1,19271747,18533934,18533935,g,gc,1
NC_037340.1,NC_032662.1,19418441,18680629,18680631,g,gct,2
NC_037340.1,NC_032662.1,19482529,18744721,18744722,a,at,1
NC_037340.1,NC_032662.1,19517164,18779358,18779359,a,ag,1
NC_037340.1,NC_032662.1,19543613,18805815,18805817,C,CTG,2
NC_037340.1,NC_032662.1,19606673,18869804,18869807,t,tagc,3
NC_037340.1,NC_032662.1,19626398,18889536,18889537,A,AC,1
NC_037340.1,NC_032662.1,19784009,19049260,19049261,A,AG,1
NC_037340.1,NC_032662.1,19885852,19151100,19151101,G,GA,1
NC_037340.1,NC_032662.1,19937773,19203044,19203047,t,tttg,3
NC_037340.1,NC_032662.1,19948382,19213666,19213667,a,ag,1
NC_037340.1,NC_032662.1,19948463,19213748,19213766,c,cattaaaaaaacattaaaa,18
NC_037340.1,NC_032662.1,20116083,19381568,19381570,C,CAT,2
NC_037340.1,NC_032662.1,20262728,19528229,19528231,c,ctt,2
NC_037340.1,NC_032662.1,20262825,19528328,19528329,c,ca,1
NC_037340.1,NC_032662.1,20311651,19578153,19578155,t,tNN,2
NC_037340.1,NC_032662.1,20316618,19583123,19583140,A,AGAGCAGGGGAATAATAT,17
NC_037340.1,NC_032662.1,20364798,19631690,19631691,A,AG,1
NC_037340.1,NC_032662.1,20365403,19632296,19632298,g,gtt,2
NC_037340.1,NC_032662.1,20377841,19644733,19644748,G,GCTATATAATGGTTTC,15
NC_037340.1,NC_032662.1,20382499,19649414,19649416,c,cct,2
NC_037340.1,NC_032662.1,20401524,19670000,19670001,t,ta,1
NC_037340.1,NC_032662.1,20402877,19671355,19671360,A,ATATGC,5
NC_037340.1,NC_032662.1,20526982,19802259,19802260,a,at,1
NC_037340.1,NC_032662.1,20621891,19897396,19897397,T,TG,1
NC_037340.1,NC_032662.1,21063986,20339515,20339516,t,tg,1
NC_037340.1,NC_032662.1,21064089,20339620,20339621,g,ga,1
NC_037340.1,NC_032662.1,21245485,20521021,20521022,t,ta,1
NC_037340.1,NC_032662.1,21265582,20541118,20541119,G,GA,1
NC_037340.1,NC_032662.1,21423104,20698638,20698639,g,ga,1
NC_037340.1,NC_032662.1,21681569,20957412,20957413,T,TA,1
NC_037340.1,NC_032662.1,21885322,21160865,21160866,t,tc,1
NC_037340.1,NC_032662.1,22185634,21461530,21461531,C,CA,1
NC_037340.1,NC_032662.1,22363466,21776976,21776977,g,gc,1
NC_037340.1,NC_032662.1,22433080,21846591,21846592,a,ac,1
NC_037340.1,NC_032662.1,22442255,21855767,21855768,A,AW,1
NC_037340.1,NC_032662.1,22479349,21893262,21893263,g,gc,1
NC_037340.1,NC_032662.1,22520153,21934000,21934001,G,GA,1
NC_037340.1,NC_032662.1,22556086,21972059,21972060,C,CT,1
NC_037340.1,NC_032662.1,22622868,22066395,22066396,t,ta,1
NC_037340.1,NC_032662.1,22637992,22081520,22081521,G,GK,1
NC_037340.1,NC_032662.1,22677026,22120554,22120556,A,ANN,2
NC_037340.1,NC_032662.1,22708434,22151964,22151965,A,AN,1
NC_037340.1,NC_032662.1,22734136,22177047,22177048,C,CA,1
NC_037340.1,NC_032662.1,22734142,22177054,22177055,G,GT,1
NC_037340.1,NC_032662.1,22747572,22190425,22190426,C,CN,1
NC_037340.1,NC_032662.1,22880870,22323732,22323733,G,GA,1
NC_037340.1,NC_032662.1,23113779,22557764,22557769,g,gaaata,5
NC_037340.1,NC_032662.1,23114039,22558029,22558039,c,cttttgaactg,10
NC_037340.1,NC_032662.1,23148379,22592380,22592381,G,GA,1
NC_037340.1,NC_032662.1,23151053,22595055,22595057,a,aag,2
NC_037340.1,NC_032662.1,23151099,22595103,22595104,g,ga,1
NC_037340.1,NC_032662.1,23192444,22636546,22636547,a,ag,1
NC_037340.1,NC_032662.1,23192545,22636647,22636649,t,taa,2
NC_037340.1,NC_032662.1,23192710,22636814,22636815,C,CA,1
NC_037340.1,NC_032662.1,23192968,22637072,22637073,c,ca,1
NC_037340.1,NC_032662.1,23193926,22638051,22638053,t,tta,2
NC_037340.1,NC_032662.1,23539450,22995510,22995511,A,AC,1
NC_037340.1,NC_032662.1,23539501,22995563,22995564,C,CT,1
NC_037340.1,NC_032662.1,23539547,22995611,22995612,C,CG,1
NC_037340.1,NC_032662.1,24115674,23574497,23574498,c,ca,1
NC_037340.1,NC_032662.1,24293274,23730325,23730326,C,CA,1
NC_037340.1,NC_032662.1,24327135,23763551,23763553,c,ctt,2
NC_037340.1,NC_032662.1,24434764,23871182,23871183,g,gc,1
NC_037340.1,NC_032662.1,24904837,24341918,24341919,C,CT,1
NC_037340.1,NC_032662.1,24905013,24342088,24342090,g,gAC,2
NC_037340.1,NC_032662.1,24953211,24390288,24390289,C,CM,1
NC_037340.1,NC_032662.1,24953220,24390298,24390299,C,CA,1
NC_037340.1,NC_032662.1,24960036,24397116,24397118,A,ACC,2
NC_037340.1,NC_032662.1,25054315,24491858,24491859,G,GR,1
NC_037340.1,NC_032662.1,25230601,24726597,24726598,T,TC,1
NC_037340.1,NC_032662.1,25430135,24926709,24926710,c,ca,1
NC_037340.1,NC_032662.1,25470823,24967395,24967396,T,TA,1
NC_037340.1,NC_032662.1,25664211,25206970,25206971,C,CY,1
NC_037340.1,NC_032662.1,25792439,25335190,25335191,C,CA,1
NC_037340.1,NC_032662.1,25803956,25346709,25346710,t,ta,1
NC_037340.1,NC_032662.1,25913749,25456366,25456368,t,tNN,2
NC_037340.1,NC_032662.1,25915388,25458007,25458008,t,tc,1
NC_037340.1,NC_032662.1,25928304,25470925,25470926,g,ga,1
NC_037340.1,NC_032662.1,26788291,26332816,26332817,C,CG,1
NC_037340.1,NC_032662.1,26831930,26376455,26376457,t,tNN,2
NC_037340.1,NC_032662.1,27033622,26614774,26614775,t,tY,1
NC_037340.1,NC_032662.1,27164587,26745686,26745687,T,TC,1
NC_037340.1,NC_032662.1,27518115,27096969,27096970,C,CM,1
NC_037340.1,NC_032662.1,27532428,27111280,27111281,T,TY,1
NC_037340.1,NC_032662.1,27541370,27120190,27120191,T,TC,1
NC_037340.1,NC_032662.1,27761537,27339904,27339905,c,ca,1
NC_037340.1,NC_032662.1,27918388,27496756,27496757,t,ta,1
NC_037340.1,NC_032662.1,27918629,27496998,27496999,t,tc,1
NC_037340.1,NC_032662.1,28112519,27695780,27695781,T,TA,1
NC_037340.1,NC_032662.1,28112685,27695948,27695949,A,AT,1
NC_037340.1,NC_032662.1,28242072,27875751,27875752,c,ca,1
NC_037340.1,NC_032662.1,28247596,27881276,27881277,T,TC,1
NC_037340.1,NC_032662.1,28362473,27995655,27995656,T,TC,1
NC_037340.1,NC_032662.1,28575208,28208408,28208409,T,TC,1
NC_037340.1,NC_032662.1,28606619,28239934,28239935,T,TR,1
NC_037340.1,NC_032662.1,28660910,28294226,28294227,T,TY,1
NC_037340.1,NC_032662.1,28736735,28370051,28370052,a,at,1
NC_037340.1,NC_032662.1,28880432,28506862,28506863,a,ag,1
NC_037340.1,NC_032662.1,29083335,28710192,28710193,C,CY,1
NC_037340.1,NC_032662.1,29186465,28814350,28814351,A,AR,1
NC_037340.1,NC_032662.1,29192550,28820436,28820437,a,at,1
NC_037340.1,NC_032662.1,29547711,29183169,29183170,C,CA,1
NC_037340.1,NC_032662.1,29568830,29204290,29204298,C,CANNNNNNN,8
NC_037340.1,NC_032662.1,29746856,29419480,29419481,C,CA,1
NC_037340.1,NC_032662.1,30085367,29819478,29819483,G,GMTCWS,5
NC_037340.1,NC_032662.1,30136656,29870773,29870774,t,ta,1
NC_037340.1,NC_032662.1,30147659,29881715,29881717,g,gtt,2
NC_037340.1,NC_032662.1,30200854,29934913,29934914,G,GA,1
NC_037340.1,NC_032662.1,30347526,30084937,30084939,g,gtt,2
NC_037340.1,NC_032662.1,30529830,30279741,30279742,a,at,1
NC_037340.1,NC_032662.1,30540262,30290049,30290050,G,GS,1
NC_037340.1,NC_032662.1,30590379,30340585,30340586,C,CT,1
NC_037340.1,NC_032662.1,30595116,30345324,30345325,G,GT,1
NC_037340.1,NC_032662.1,30619609,30369818,30369822,g,gacaa,4
NC_037340.1,NC_032662.1,30639268,30389519,30389520,T,TK,1
NC_037340.1,NC_032662.1,30645435,30465884,30465885,g,gt,1
NC_037340.1,NC_032662.1,31113790,30935084,30935085,t,ta,1
NC_037340.1,NC_032662.1,31133466,30954761,30954762,t,tc,1
NC_037340.1,NC_032662.1,31253840,31075072,31075073,g,gt,1
NC_037340.1,NC_032662.1,31419417,31240196,31240197,A,AM,1
NC_037340.1,NC_032662.1,31675239,31497573,31497574,G,GK,1
NC_037340.1,NC_032662.1,31738032,31565355,31565356,c,cg,1
NC_037340.1,NC_032662.1,31829241,31658445,31658446,a,at,1
NC_037340.1,NC_032662.1,31866287,31695490,31695492,a,aNN,2
NC_037340.1,NC_032662.1,31945985,31775105,31775106,T,TC,1
NC_037340.1,NC_032662.1,31977505,31806627,31806628,t,tc,1
NC_037340.1,NC_032662.1,32208078,32056324,32056325,t,tc,1
NC_037340.1,NC_032662.1,32408023,32268863,32268864,g,gt,1
NC_037340.1,NC_032662.1,32493183,32362626,32362629,t,tgcc,3
NC_037340.1,NC_032662.1,32503381,32372826,32372828,A,ATG,2
NC_037340.1,NC_032662.1,32674026,32583686,32583687,A,AT,1
NC_037340.1,NC_032662.1,32765353,32675016,32675017,c,ct,1
NC_037340.1,NC_032662.1,32809061,32718727,32718728,A,AW,1
NC_037340.1,NC_032662.1,32899114,32808407,32808413,a,aaaagtg,6
NC_037340.1,NC_032662.1,32903891,32813191,32813198,T,TACATTAC,7
NC_037340.1,NC_032662.1,32939987,32849292,32849293,t,ta,1
NC_037340.1,NC_032662.1,32943620,32853001,32853002,G,GK,1
NC_037340.1,NC_032662.1,32964883,32874174,32874175,G,GR,1
NC_037340.1,NC_032662.1,32976478,32885843,32885846,t,tatg,3
NC_037340.1,NC_032662.1,32976639,32886007,32886010,t,tacc,3
NC_037340.1,NC_032662.1,32999660,32908862,32908864,t,tga,2
NC_037340.1,NC_032662.1,33031965,32941175,32941179,A,AAAGG,4
NC_037340.1,NC_032662.1,33042181,32951395,32951397,a,aat,2
NC_037340.1,NC_032662.1,33042195,32951411,32951414,C,CACT,3
NC_037340.1,NC_032662.1,33068515,32977738,32977739,A,AC,1
NC_037340.1,NC_032662.1,33072839,32982064,32982065,a,ac,1
NC_037340.1,NC_032662.1,33108070,33017345,33017346,T,TA,1
NC_037340.1,NC_032662.1,33159494,33068723,33068724,C,CA,1
NC_037340.1,NC_032662.1,33159608,33068838,33068839,C,CT,1
NC_037340.1,NC_032662.1,33216616,33125340,33125341,G,GA,1
NC_037340.1,NC_032662.1,33328790,33237285,33237288,a,aaac,3
NC_037340.1,NC_032662.1,33335258,33243750,33243751,t,ta,1
NC_037340.1,NC_032662.1,33337442,33245936,33245938,C,CTG,2
NC_037340.1,NC_032662.1,33352687,33261183,33261184,C,CA,1
NC_037340.1,NC_032662.1,33354264,33262761,33262762,T,TK,1
NC_037340.1,NC_032662.1,33368229,33276456,33276457,C,CT,1
NC_037340.1,NC_032662.1,33373810,33282037,33282038,C,CT,1
NC_037340.1,NC_032662.1,33377344,33285571,33285599,G,GTGACAGCGTCAAGAGCAACTGGTCCAGA,28
NC_037340.1,NC_032662.1,33435364,33343617,33343619,t,ttc,2
NC_037340.1,NC_032662.1,33510817,33419112,33419113,c,ca,1
NC_037340.1,NC_032662.1,33546612,33454932,33454933,T,TK,1
NC_037340.1,NC_032662.1,33571095,33479401,33479402,C,CT,1
NC_037340.1,NC_032662.1,33596277,33504588,33504589,c,ca,1
NC_037340.1,NC_032662.1,33600551,33508786,33508787,T,TK,1
NC_037340.1,NC_032662.1,33616592,33524286,33524316,C,CTTCCACTGTGGCAGGAACTTTCCATCCCAG,30
NC_037340.1,NC_032662.1,33617253,33524977,33524980,A,AAAR,3
NC_037340.1,NC_032662.1,33621392,33529120,33529127,C,CATGACTG,7
NC_037340.1,NC_032662.1,33623977,33531712,33531735,c,cggtgatgccatccagccatctca,23
NC_037340.1,NC_032662.1,33694507,33601663,33601667,A,AATAG,4
NC_037340.1,NC_032662.1,33715770,33622940,33622942,T,TTC,2
NC_037340.1,NC_032662.1,33718800,33625928,33625929,g,gt,1
NC_037340.1,NC_032662.1,33718829,33625958,33625959,t,tc,1
NC_037340.1,NC_032662.1,33762276,33669143,33669144,t,ta,1
NC_037340.1,NC_032662.1,33772915,33679784,33679785,G,GT,1
NC_037340.1,NC_032662.1,33787251,33694119,33694140,T,TNNNNNNNNNNNNTTTCCCTGA,21
NC_037340.1,NC_032662.1,33792328,33699220,33699221,g,ga,1
NC_037340.1,NC_032662.1,33805336,33712230,33712231,A,AC,1
NC_037340.1,NC_032662.1,33853287,33760267,33760268,a,at,1
NC_037340.1,NC_032662.1,33869416,33776399,33776400,G,GC,1
NC_037340.1,NC_032662.1,34132181,34046667,34046669,a,aNN,2
NC_037340.1,NC_032662.1,34263675,34178162,34178164,c,ctt,2
NC_037340.1,NC_032662.1,34316552,34228695,34228696,C,CA,1
NC_037340.1,NC_032662.1,34343825,34255971,34255972,c,ct,1
NC_037340.1,NC_032662.1,34343831,34255978,34255979,c,ct,1
NC_037340.1,NC_032662.1,34346317,34258465,34258466,A,AC,1
NC_037340.1,NC_032662.1,34346976,34259124,34259125,C,CA,1
NC_037340.1,NC_032662.1,34408382,34320775,34320776,a,at,1
NC_037340.1,NC_032662.1,34439086,34351278,34351279,C,CA,1
NC_037340.1,NC_032662.1,34474947,34387145,34387153,g,gtatatata,8
NC_037340.1,NC_032662.1,34506480,34422308,34422309,A,AT,1
NC_037340.1,NC_032662.1,34512309,34428138,34428139,t,tg,1
NC_037340.1,NC_032662.1,34919499,34844893,34844895,a,att,2
NC_037340.1,NC_032662.1,34932417,34857814,34857817,c,catg,3
NC_037340.1,NC_032662.1,34963478,34885637,34885638,A,AG,1
NC_037340.1,NC_032662.1,34964509,34886669,34886670,c,ct,1
NC_037340.1,NC_032662.1,34981701,34903862,34903863,t,tg,1
NC_037340.1,NC_032662.1,34997623,34919842,34919843,T,TY,1
NC_037340.1,NC_032662.1,35097516,35019857,35019865,t,tatatatac,8
NC_037340.1,NC_032662.1,35140498,35065241,35065242,G,GC,1
NC_037340.1,NC_032662.1,35144325,35069069,35069082,a,atatatatatatat,13
NC_037340.1,NC_032662.1,35152177,35076922,35076923,A,AR,1
NC_037340.1,NC_032662.1,35161754,35086500,35086501,G,GY,1
NC_037340.1,NC_032662.1,35274907,35201758,35201760,c,caa,2
NC_037340.1,NC_032662.1,35344312,35271190,35271192,c,caa,2
NC_037340.1,NC_032662.1,35397054,35324050,35324051,A,AG,1
NC_037340.1,NC_032662.1,35399301,35326298,35326302,T,TTGTC,4
NC_037340.1,NC_032662.1,35435184,35362184,35362185,c,ct,1
NC_037340.1,NC_032662.1,35475841,35403216,35403217,G,GR,1
NC_037340.1,NC_032662.1,35514557,35442145,35442146,g,gc,1
NC_037340.1,NC_032662.1,35519514,35447105,35447106,a,ag,1
NC_037340.1,NC_032662.1,35532764,35460354,35460355,T,TG,1
NC_037340.1,NC_032662.1,35550214,35477714,35477715,A,AG,1
NC_037340.1,NC_032662.1,35571980,35499482,35499483,G,GC,1
NC_037340.1,NC_032662.1,35578337,35505040,35505041,A,AC,1
NC_037340.1,NC_032662.1,35584201,35510904,35510905,T,TY,1
NC_037340.1,NC_032662.1,35678702,35605162,35605163,A,AT,1
NC_037340.1,NC_032662.1,35702226,35628695,35628696,a,ac,1
NC_037340.1,NC_032662.1,35715155,35642070,35642082,g,gtgtgtgtgtgta,12
NC_037340.1,NC_032662.1,35782331,35709226,35709227,A,AR,1
NC_037340.1,NC_032662.1,35821972,35748638,35748640,T,TAN,2
NC_037340.1,NC_032662.1,35922001,35848545,35848546,C,CS,1
NC_037340.1,NC_032662.1,35997056,35928814,35928815,t,tc,1
NC_037340.1,NC_032662.1,36028394,35960154,35960155,C,CN,1
NC_037340.1,NC_032662.1,36143794,36075681,36075682,T,TY,1
NC_037340.1,NC_032662.1,36222928,36163497,36163506,t,tgttggtggg,9
NC_037340.1,NC_032662.1,36226472,36167051,36167052,a,at,1
NC_037340.1,NC_032662.1,36228479,36169058,36169059,C,CT,1
NC_037340.1,NC_032662.1,36231975,36172555,36172557,t,taa,2
NC_037340.1,NC_032662.1,36287132,36227717,36227718,T,TG,1
NC_037340.1,NC_032662.1,36288327,36228913,36228914,a,ac,1
NC_037340.1,NC_032662.1,36307652,36248238,36248239,T,TC,1
NC_037340.1,NC_032662.1,36310220,36250807,36250808,C,CG,1
NC_037340.1,NC_032662.1,36310241,36250829,36250830,c,cg,1
NC_037340.1,NC_032662.1,36324436,36264985,36265001,T,TTTAGAGAGCCTTAGTG,16
NC_037340.1,NC_032662.1,36426615,36366708,36366710,t,tNN,2
NC_037340.1,NC_032662.1,36635744,36576295,36576296,t,tc,1
NC_037340.1,NC_032662.1,37151893,37089913,37089915,a,aNN,2
NC_037340.1,NC_032662.1,37298441,37238309,37238310,T,TA,1
NC_037340.1,NC_032662.1,37350851,37290350,37290351,G,GT,1
NC_037340.1,NC_032662.1,37364122,37303045,37303054,a,agacacaagR,9
NC_037340.1,NC_032662.1,37381893,37320836,37320837,G,GR,1
NC_037340.1,NC_032662.1,37413453,37352404,37352405,T,TG,1
NC_037340.1,NC_032662.1,37415341,37354293,37354294,a,ac,1
NC_037340.1,NC_032662.1,37420591,37359544,37359554,C,CAAGTAGGCAT,10
NC_037340.1,NC_032662.1,37538998,37478983,37478984,a,ac,1
NC_037340.1,NC_032662.1,37569113,37510461,37510462,t,tc,1
NC_037340.1,NC_032662.1,37583697,37525045,37525046,T,TW,1
NC_037340.1,NC_032662.1,37600535,37542049,37542050,c,ca,1
NC_037340.1,NC_032662.1,37647602,37589532,37589534,a,aac,2
NC_037340.1,NC_032662.1,37665640,37607433,37607442,C,CAAGCCACTG,9
NC_037340.1,NC_032662.1,37782216,37724302,37724303,T,TA,1
NC_037340.1,NC_032662.1,37821494,37762988,37762989,g,gC,1
NC_037340.1,NC_032662.1,37821499,37762994,37762995,G,GA,1
NC_037340.1,NC_032662.1,37869173,37810675,37810678,T,TTTG,3
NC_037340.1,NC_032662.1,37936765,37878339,37878340,G,GR,1
NC_037340.1,NC_032662.1,37942519,37884096,37884097,A,AG,1
NC_037340.1,NC_032662.1,37945195,37886773,37886774,g,gt,1
NC_037340.1,NC_032662.1,37967484,37909129,37909132,C,CCCA,3
NC_037340.1,NC_032662.1,38105102,38058749,38058750,C,CA,1
NC_037340.1,NC_032662.1,38112317,38065965,38065966,c,ct,1
NC_037340.1,NC_032662.1,38175699,38128531,38128532,G,GA,1
NC_037340.1,NC_032662.1,38307734,38274752,38274753,c,ca,1
NC_037340.1,NC_032662.1,38307757,38274776,38274777,a,aW,1
NC_037340.1,NC_032662.1,38309812,38276832,38276833,C,CA,1
NC_037340.1,NC_032662.1,38313689,38280710,38280711,c,ct,1
NC_037340.1,NC_032662.1,38344370,38311397,38311398,t,ta,1
NC_037340.1,NC_032662.1,38424738,38391927,38391928,G,GT,1
NC_037340.1,NC_032662.1,38457177,38425240,38425241,T,TC,1
NC_037340.1,NC_032662.1,38480030,38448095,38448096,T,TG,1
NC_037340.1,NC_032662.1,38496861,38466411,38466412,G,GC,1
NC_037340.1,NC_032662.1,38497546,38467097,38467098,C,CA,1
NC_037340.1,NC_032662.1,38533205,38502587,38502588,G,GA,1
NC_037340.1,NC_032662.1,38574861,38543923,38543924,G,GS,1
NC_037340.1,NC_032662.1,38668570,38645482,38645483,A,AG,1
NC_037340.1,NC_032662.1,38792716,38769116,38769120,t,tNNNN,4
NC_037340.1,NC_032662.1,38795469,38771873,38771874,t,tW,1
NC_037340.1,NC_032662.1,38795484,38771889,38771891,t,tta,2
NC_037340.1,NC_032662.1,38825466,38801879,38801881,T,TAC,2
NC_037340.1,NC_032662.1,38902415,38879250,38879251,G,GS,1
NC_037340.1,NC_032662.1,38965550,38944566,38944567,T,TK,1
NC_037340.1,NC_032662.1,38997359,38976391,38976392,g,gt,1
NC_037340.1,NC_032662.1,39022831,39001866,39001867,c,ca,1
NC_037340.1,NC_032662.1,39033352,39012388,39012393,g,gactga,5
NC_037340.1,NC_032662.1,39043564,39022616,39022617,A,AG,1
NC_037340.1,NC_032662.1,39108151,39087237,39087238,C,CA,1
NC_037340.1,NC_032662.1,39117085,39096173,39096174,t,ta,1
NC_037340.1,NC_032662.1,39117333,39096422,39096436,g,gtgtgtatatatata,14
NC_037340.1,NC_032662.1,39117357,39096460,39096462,t,taa,2
NC_037340.1,NC_032662.1,39117510,39096615,39096616,g,ga,1
NC_037340.1,NC_032662.1,39125078,39104184,39104185,t,tg,1
NC_037340.1,NC_032662.1,39125087,39104194,39104195,t,tg,1
NC_037340.1,NC_032662.1,39125474,39104582,39104583,G,GR,1
NC_037340.1,NC_032662.1,39197790,39176912,39176913,T,TC,1
NC_037340.1,NC_032662.1,39210926,39190057,39190061,a,aNNNN,4
NC_037340.1,NC_032662.1,39228473,39207606,39207607,T,TG,1
NC_037340.1,NC_032662.1,39229256,39208389,39208390,a,at,1
NC_037340.1,NC_032662.1,39229266,39208400,39208401,t,ta,1
NC_037340.1,NC_032662.1,39229640,39208769,39208770,c,ct,1
NC_037340.1,NC_032662.1,39229732,39208861,39208862,C,CT,1
NC_037340.1,NC_032662.1,39229738,39208868,39208869,G,GA,1
NC_037340.1,NC_032662.1,39229785,39208915,39208916,A,AG,1
NC_037340.1,NC_032662.1,39229838,39208969,39208970,C,CA,1
NC_037340.1,NC_032662.1,39237463,39199868,39199869,G,GR,1
NC_037340.1,NC_032662.1,39237865,39200273,39200274,T,TG,1
NC_037340.1,NC_032662.1,39237997,39200405,39200406,C,CT,1
NC_037340.1,NC_032662.1,39238158,39200566,39200567,G,GA,1
NC_037340.1,NC_032662.1,39238255,39200664,39200665,G,GA,1
NC_037340.1,NC_032662.1,39238335,39200744,39200745,G,GA,1
NC_037340.1,NC_032662.1,39238720,39201130,39201131,A,AT,1
NC_037340.1,NC_032662.1,39238906,39201316,39201317,t,ta,1
NC_037340.1,NC_032662.1,39242949,39205359,39205360,t,ta,1
NC_037340.1,NC_032662.1,39242958,39205369,39205370,t,ta,1
NC_037340.1,NC_032662.1,39243250,39205662,39205665,c,caaa,3
NC_037340.1,NC_032662.1,39244491,39206905,39206906,t,ta,1
NC_037340.1,NC_032662.1,39257697,39220112,39220113,A,AW,1
NC_037340.1,NC_032662.1,39286408,39248831,39248832,t,ta,1
NC_037340.1,NC_032662.1,39311572,39274006,39274007,g,ga,1
NC_037340.1,NC_032662.1,39313489,39275924,39275925,G,GK,1
NC_037340.1,NC_032662.1,39334799,39297230,39297231,C,CG,1
NC_037340.1,NC_032662.1,39334887,39297320,39297321,C,CS,1
NC_037340.1,NC_032662.1,39349547,39311982,39311983,A,AG,1
NC_037340.1,NC_032662.1,39361022,39323460,39323477,T,TGCCATTCTAAATATTTA,17
NC_037340.1,NC_032662.1,39363478,39325940,39325941,C,CM,1
NC_037340.1,NC_032662.1,39365491,39327955,39327956,g,gt,1
NC_037340.1,NC_032662.1,39382465,39344933,39344934,C,CA,1
NC_037340.1,NC_032662.1,39400780,39363253,39363254,c,ct,1
NC_037340.1,NC_032662.1,39509349,39478796,39478797,c,cN,1
NC_037340.1,NC_032662.1,39526153,39495602,39495635,A,AAGNNNNNNNNNNNNNNNNNNNNNNNNNNNNNNN,33
NC_037340.1,NC_032662.1,39675160,39746629,39746630,A,AW,1
NC_037340.1,NC_032662.1,39687632,39759117,39759119,t,tNN,2
NC_037340.1,NC_032662.1,39696187,39767654,39767655,g,gt,1
NC_037340.1,NC_032662.1,39720563,39792030,39792035,C,CCTTCA,5
NC_037340.1,NC_032662.1,39810721,39662360,39662361,g,gc,1
NC_037340.1,NC_032662.1,39839889,39691940,39691942,a,att,2
NC_037340.1,NC_032662.1,39908490,39977744,39977753,c,cactgtttct,9
NC_037340.1,NC_032662.1,40008212,40077485,40077486,A,AW,1
NC_037340.1,NC_032662.1,40212137,40281104,40281105,a,at,1
NC_037340.1,NC_032662.1,40213801,40282769,40282770,T,TR,1
NC_037340.1,NC_032662.1,40216568,40285536,40285537,T,TA,1
NC_037340.1,NC_032662.1,40224507,40293474,40293475,T,TA,1
NC_037340.1,NC_032662.1,40257419,40326288,40326289,G,GA,1
NC_037340.1,NC_032662.1,40391663,40517413,40517414,t,tg,1
NC_037340.1,NC_032662.1,40404648,40530380,40530381,A,AW,1
NC_037340.1,NC_032662.1,40405344,40531077,40531087,A,ACACCATTTCT,10
NC_037340.1,NC_032662.1,40422329,40548094,40548103,A,ANNNNNNNNN,9
NC_037340.1,NC_032662.1,40422667,40548438,40548441,g,gtca,3
NC_037340.1,NC_032662.1,40457340,40583113,40583114,T,TC,1
NC_037340.1,NC_032662.1,40462454,40588228,40588230,t,tNN,2
NC_037340.1,NC_032662.1,40475240,40601018,40601019,C,CY,1
NC_037340.1,NC_032662.1,40510973,40637029,40637030,A,AG,1
NC_037340.1,NC_032662.1,40511039,40637096,40637105,C,CAATAagaga,9
NC_037340.1,NC_032662.1,40518950,40645017,40645018,A,AC,1
NC_037340.1,NC_032662.1,40763887,40889686,40889687,G,GS,1
NC_037340.1,NC_032662.1,40923576,41050358,41050360,C,CWA,2
NC_037340.1,NC_032662.1,41016844,41143456,41143457,G,GA,1
NC_037340.1,NC_032662.1,41048507,41175121,41175123,a,aat,2
NC_037340.1,NC_032662.1,41058089,41184706,41184707,G,GR,1
NC_037340.1,NC_032662.1,41262859,41336430,41336438,C,CCCTCGTTG,8
NC_037340.1,NC_032662.1,41282960,41356543,41356545,A,AAG,2
NC_037340.1,NC_032662.1,41311228,41384821,41384824,t,tagc,3
NC_037340.1,NC_032662.1,41371368,41514523,41514524,A,AN,1
NC_037340.1,NC_032662.1,41397930,41541087,41541088,a,aG,1
NC_037340.1,NC_032662.1,41398001,41541159,41541162,t,ttta,3
NC_037340.1,NC_032662.1,41575840,41686926,41686927,C,CT,1
NC_037340.1,NC_032662.1,41586772,41736790,41736803,g,gtgtgagtgtgtgt,13
NC_037340.1,NC_032662.1,41597837,41747871,41747872,T,TG,1
NC_037340.1,NC_032662.1,41607627,41757659,41757660,t,tY,1
NC_037340.1,NC_032662.1,41677027,41827739,41827742,a,aaac,3
NC_037340.1,NC_032662.1,41714465,41865184,41865189,a,actgtc,5
NC_037340.1,NC_032662.1,41786025,41936238,41936239,g,gt,1
NC_037340.1,NC_032662.1,41862921,41975941,41975942,C,CT,1
NC_037340.1,NC_032662.1,41881127,41994150,41994151,C,CY,1
NC_037340.1,NC_032662.1,41942642,42096743,42096744,C,CY,1
NC_037340.1,NC_032662.1,41959846,42113947,42113948,A,AC,1
NC_037340.1,NC_032662.1,41991496,42145595,42145596,C,CS,1
NC_037340.1,NC_032662.1,42125812,42282607,42282610,t,taaa,3
NC_037340.1,NC_032662.1,42231680,42387793,42387795,C,CTG,2
NC_037340.1,NC_032662.1,42431664,42625242,42625244,t,tac,2
NC_037340.1,NC_032662.1,42431745,42625325,42625327,C,CMT,2
NC_037340.1,NC_032662.1,42575468,42725486,42725487,C,CT,1
NC_037340.1,NC_032662.1,42577816,42727832,42727833,C,CG,1
NC_037340.1,NC_032662.1,42584734,42734750,42734751,C,CG,1
NC_037340.1,NC_032662.1,42602675,42752985,42752986,C,CT,1
NC_037340.1,NC_032662.1,42629735,42780063,42780065,C,CAK,2
NC_037340.1,NC_032662.1,42737557,42914203,42914207,G,GAGAC,4
NC_037340.1,NC_032662.1,42850996,43042895,43042896,g,ga,1
NC_037340.1,NC_032662.1,42850996,43148808,43148809,g,ga,1
NC_037340.1,NC_032662.1,42940650,43239291,43239292,t,tc,1
NC_037340.1,NC_032662.1,42948127,43246769,43246770,C,CA,1
NC_037340.1,NC_032662.1,42981317,43279960,43279961,c,ct,1
NC_037340.1,NC_032662.1,43021970,43320467,43320468,C,CA,1
NC_037340.1,NC_032662.1,43042196,43339793,43339794,A,AC,1
NC_037340.1,NC_032662.1,43044467,43342067,43342068,T,TG,1
NC_037340.1,NC_032662.1,43049745,43347347,43347348,T,TA,1
NC_037340.1,NC_032662.1,43051341,43348945,43348948,T,TTCW,3
NC_037340.1,NC_032662.1,43052809,43350417,43350418,C,CM,1
NC_037340.1,NC_032662.1,43072217,43369830,43369838,G,GGTGGGGAC,8
NC_037340.1,NC_032662.1,43101758,43399382,43399389,G,GGTTATTT,7
NC_037340.1,NC_032662.1,43108620,43504742,43504743,T,TC,1
NC_037340.1,NC_032662.1,43157111,43554475,43554476,g,ga,1
NC_037340.1,NC_032662.1,43276131,43461579,43461580,a,at,1
NC_037340.1,NC_032662.1,43475479,43603362,43603363,g,ga,1
NC_037340.1,NC_032662.1,43482626,43610512,43610519,c,ctgtttgt,7
NC_037340.1,NC_032662.1,43483800,43611671,43611672,A,AT,1
NC_037340.1,NC_032662.1,43506228,43634097,43634098,G,GC,1
NC_037340.1,NC_032662.1,43522877,43650747,43650768,t,tNNNNNNNNNNNNNNNNNNNNN,21
NC_037340.1,NC_032662.1,43556501,43684355,43684356,T,TY,1
NC_037340.1,NC_032662.1,43588510,43731006,43731052,a,aaaattcagtggagaaaagaggctgaaataaggatagctcagtgagg,46
NC_037340.1,NC_032662.1,43658899,43801451,43801452,T,TY,1
NC_037340.1,NC_032662.1,43666111,43808664,43808666,a,aNN,2
NC_037340.1,NC_032662.1,43701808,43844375,43844376,t,tc,1
NC_037340.1,NC_032662.1,43712292,43854861,43854865,t,tNNNN,4
NC_037340.1,NC_032662.1,43720989,43863554,43863555,a,ac,1
NC_037340.1,NC_032662.1,43897868,44040388,44040389,G,GT,1
NC_037340.1,NC_032662.1,43903379,44045908,44045909,C,CY,1
NC_037340.1,NC_032662.1,43903389,44045919,44045920,T,TY,1
NC_037340.1,NC_032662.1,43903720,44046249,44046252,t,tctc,3
NC_037340.1,NC_032662.1,43904257,44046788,44046801,t,ttttcactctccac,13
NC_037340.1,NC_032662.1,43904378,44046922,44046923,t,ta,1
NC_037340.1,NC_032662.1,43914760,44057115,44057125,t,tATGTATATNN,10
NC_037340.1,NC_032662.1,43939164,44081326,44081328,T,TTA,2
NC_037340.1,NC_032662.1,43993286,44136486,44136489,t,ttta,3
NC_037340.1,NC_032662.1,44029428,44172969,44172970,t,tc,1
NC_037340.1,NC_032662.1,44119217,44262754,44262755,g,gc,1
NC_037340.1,NC_032662.1,44120876,44264414,44264415,A,AG,1
NC_037340.1,NC_032662.1,44162277,44306644,44306645,c,ct,1
NC_037340.1,NC_032662.1,44212621,44358018,44358019,t,tg,1
NC_037340.1,NC_032662.1,44329627,44478964,44478965,C,CY,1
NC_037340.1,NC_032662.1,44364730,44519855,44519857,a,aNN,2
NC_037340.1,NC_032662.1,44383880,44539007,44539025,a,aYAYATATATATATATANN,18
NC_037340.1,NC_032662.1,44394733,44549877,44549878,C,CA,1
NC_037340.1,NC_032662.1,44436393,44591441,44591442,C,CM,1
NC_037340.1,NC_032662.1,44438227,44593277,44593280,T,TGAG,3
NC_037340.1,NC_032662.1,44440738,44595791,44595793,t,tNN,2
NC_037340.1,NC_032662.1,44474350,44629328,44629329,T,TC,1
NC_037340.1,NC_032662.1,44502338,44657316,44657317,C,CY,1
NC_037340.1,NC_032662.1,44502406,44657385,44657386,T,TC,1
NC_037340.1,NC_032662.1,44564377,44719537,44719539,t,tta,2
NC_037340.1,NC_032662.1,44583726,44739008,44739020,g,gtgtgtgtgtgtR,12
NC_037340.1,NC_032662.1,44602327,44757656,44757658,G,GGA,2
NC_037340.1,NC_032662.1,44602329,44757660,44757666,T,TCCCCGG,6
NC_037340.1,NC_032662.1,44619191,44774532,44774533,g,ga,1
NC_037340.1,NC_032662.1,44619292,44774634,44774643,A,AGCTMAAGTT,9
NC_037340.1,NC_032662.1,44672317,44827856,44827857,C,CY,1
NC_037340.1,NC_032662.1,44693317,44848750,44848753,C,CTCA,3
NC_037340.1,NC_032662.1,44693808,44849245,44849246,T,TW,1
NC_037340.1,NC_032662.1,44701704,44857132,44857134,c,cca,2
NC_037340.1,NC_032662.1,44784007,44921790,44921791,c,ct,1
NC_037340.1,NC_032662.1,44785612,44923396,44923397,g,ga,1
NC_037340.1,NC_032662.1,44850855,44987033,44987034,g,gt,1
NC_037340.1,NC_032662.1,44884028,45020211,45020230,C,CCCGGCACTATTATGCGAGA,19
NC_037340.1,NC_032662.1,44890370,45026572,45026574,A,AAT,2
NC_037340.1,NC_032662.1,44903462,45045547,45045548,C,CA,1
NC_037340.1,NC_032662.1,44911422,45053509,45053510,T,TC,1
NC_037340.1,NC_032662.1,44911749,45053837,45053839,a,aNN,2
NC_037340.1,NC_032662.1,44981754,45124140,45124146,A,AGGAAGG,6
NC_037340.1,NC_032662.1,44981905,45124296,45124297,T,TN,1
NC_037340.1,NC_032662.1,44985477,45127871,45127872,G,GA,1
NC_037340.1,NC_032662.1,44990714,45133109,45133110,G,GT,1
NC_037340.1,NC_032662.1,45062677,45225768,45225771,c,cctt,3
NC_037340.1,NC_032662.1,45091931,45256773,45256774,A,AM,1
NC_037340.1,NC_032662.1,45093287,45258131,45258132,T,TA,1
NC_037340.1,NC_032662.1,45112567,45277412,45277413,A,AM,1
NC_037340.1,NC_032662.1,45115834,45280682,45280683,G,GT,1
NC_037340.1,NC_032662.1,45116053,45280747,45280749,T,TGG,2
NC_037340.1,NC_032662.1,45117696,45282387,45282396,G,GNNNNNNNNA,9
NC_037340.1,NC_032662.1,45122884,45287583,45287584,A,AM,1
NC_037340.1,NC_032662.1,45123963,45288663,45288664,T,TC,1
NC_037340.1,NC_032662.1,45156290,45320995,45320996,a,at,1
NC_037340.1,NC_032662.1,45159781,45324490,45324491,C,CS,1
NC_037340.1,NC_032662.1,45217187,45391749,45391750,t,ta,1
NC_037340.1,NC_032662.1,45291004,45461064,45461069,A,AAACAG,5
NC_037340.1,NC_032662.1,45336705,45506755,45506756,C,CA,1
NC_037340.1,NC_032662.1,45361159,45531215,45531216,a,at,1
NC_037340.1,NC_032662.1,45392929,45562987,45562988,t,tc,1
NC_037340.1,NC_032662.1,45528518,45714501,45714502,C,CG,1
NC_037340.1,NC_032662.1,45528726,45714711,45714712,T,TC,1
NC_037340.1,NC_032662.1,45551972,45737960,45737964,A,AAAGT,4
NC_037340.1,NC_032662.1,45573848,45759840,45759853,A,ATATATAAAATTGC,13
NC_037340.1,NC_032662.1,45580141,45766147,45766161,T,TTTATACCTGCTAAA,14
NC_037340.1,NC_032662.1,45583229,45769249,45769250,C,CY,1
NC_037340.1,NC_032662.1,45585723,45771744,45771745,A,AC,1
NC_037340.1,NC_032662.1,45586870,45772892,45772893,g,ga,1
NC_037340.1,NC_032662.1,45586870,45812539,45812540,g,ga,1
NC_037340.1,NC_032662.1,45645810,45831772,45831773,c,ct,1
NC_037340.1,NC_032662.1,45665506,45851194,45851195,T,TG,1
NC_037340.1,NC_032662.1,45770092,45942611,45942612,a,ac,1
NC_037340.1,NC_032662.1,45779390,45951914,45951915,T,TA,1
NC_037340.1,NC_032662.1,45787887,45960415,45960417,A,AAC,2
NC_037340.1,NC_032662.1,45839041,46011566,46011567,A,AW,1
NC_037340.1,NC_032662.1,45862337,46034596,46034600,A,ACTGT,4
NC_037340.1,NC_032662.1,45911085,46083347,46083348,c,ca,1
NC_037340.1,NC_032662.1,45919070,46091335,46091336,T,TG,1
NC_037340.1,NC_032662.1,45936720,46109792,46109808,g,gacagaaatgacagaaa,16
NC_037340.1,NC_032662.1,45939508,46112596,46112597,T,TG,1
NC_037340.1,NC_032662.1,45945604,46118733,46118743,C,CTGGTGTCTCA,10
NC_037340.1,NC_032662.1,45946577,46119716,46119720,t,tggtc,4
NC_037340.1,NC_032662.1,45952826,46125967,46125974,A,ANNNNNNN,7
NC_037340.1,NC_032662.1,45953278,46126426,46126427,A,AG,1
NC_037340.1,NC_032662.1,45957513,46130662,46130675,c,cttcactttcacgt,13
NC_037340.1,NC_032662.1,45960118,46133278,46133281,a,acag,3
NC_037340.1,NC_032662.1,45974125,46147292,46147294,c,caa,2
NC_037340.1,NC_032662.1,45995624,46168794,46168797,c,cgga,3
NC_037340.1,NC_032662.1,46006603,46179777,46179780,T,TTTC,3
NC_037340.1,NC_032662.1,46019268,46192450,46192454,G,GGCTA,4
NC_037340.1,NC_032662.1,46019453,46192639,46192640,A,AG,1
NC_037340.1,NC_032662.1,46069495,46242685,46242686,C,CS,1
NC_037340.1,NC_032662.1,46170952,46341093,46341105,A,ACCACCGTCTGYM,12
NC_037340.1,NC_032662.1,46230642,46400807,46400808,C,CS,1
NC_037340.1,NC_032662.1,46243924,46414084,46414086,G,GTA,2
NC_037340.1,NC_032662.1,46243930,46414092,46414093,C,CA,1
NC_037340.1,NC_032662.1,46250276,46420449,46420458,t,tgactagaca,9
NC_037340.1,NC_032662.1,46345859,46516070,46516073,C,CCGT,3
NC_037340.1,NC_032662.1,46390817,46561037,46561042,T,TAANNN,5
NC_037340.1,NC_032662.1,46413997,46584416,46584425,T,TTTGTTTTGA,9
NC_037340.1,NC_032662.1,46464971,46635532,46635533,G,GR,1
NC_037340.1,NC_032662.1,46471023,46641585,46641586,G,GT,1
NC_037340.1,NC_032662.1,46474312,46644876,46644879,A,AAAT,3
NC_037340.1,NC_032662.1,46502750,46674482,46674483,g,gc,1
NC_037340.1,NC_032662.1,46553030,46724406,46724409,C,CCTT,3
NC_037340.1,NC_032662.1,46554233,46725612,46725633,T,TCAAGGAGAACTTAAGAATTAA,21
NC_037340.1,NC_032662.1,46828763,47003811,47003812,a,ac,1
NC_037340.1,NC_032662.1,47123158,47297898,47297900,a,aac,2
NC_037340.1,NC_032662.1,47228029,47402669,47402671,t,taa,2
NC_037340.1,NC_032662.1,47323776,47509317,47509318,t,ta,1
NC_037340.1,NC_032662.1,47474709,47659970,47659971,a,ag,1
NC_037340.1,NC_032662.1,48135612,48371873,48371874,t,ta,1
NC_037340.1,NC_032662.1,48143739,48380001,48380002,G,GA,1
NC_037340.1,NC_032662.1,48176377,48412649,48412650,A,AW,1
NC_037340.1,NC_032662.1,48181187,48417460,48417461,a,ac,1
NC_037340.1,NC_032662.1,48207777,48444475,48444482,c,ccagtATT,7
NC_037340.1,NC_032662.1,48237729,48474435,48474436,T,TA,1
NC_037340.1,NC_032662.1,48237757,48474464,48474465,A,AC,1
NC_037340.1,NC_032662.1,48248033,48484771,48484772,G,GR,1
NC_037340.1,NC_032662.1,48250895,48487634,48487635,T,TC,1
NC_037340.1,NC_032662.1,48319617,48556161,48556163,c,cca,2
NC_037340.1,NC_032662.1,48323520,48560068,48560069,a,at,1
NC_037340.1,NC_032662.1,48323529,48560078,48560079,a,at,1
NC_037340.1,NC_032662.1,48325024,48561574,48561575,A,AG,1
NC_037340.1,NC_032662.1,48370732,48608536,48608537,C,CT,1
NC_037340.1,NC_032662.1,48376388,48614196,48614197,A,AC,1
NC_037340.1,NC_032662.1,48413819,48651633,48651634,A,AG,1
NC_037340.1,NC_032662.1,48424436,48662250,48662251,a,ag,1
NC_037340.1,NC_032662.1,48434258,48671467,48671468,A,AG,1
NC_037340.1,NC_032662.1,48491155,48726618,48726620,t,tca,2
NC_037340.1,NC_032662.1,48541602,48777161,48777163,t,ttg,2
NC_037340.1,NC_032662.1,48558279,48793844,48793845,G,GK,1
NC_037340.1,NC_032662.1,48575283,48810853,48810856,a,actt,3
NC_037340.1,NC_032662.1,48625568,48861590,48861591,t,tc,1
NC_037340.1,NC_032662.1,48655610,48891640,48891641,a,aG,1
NC_037340.1,NC_032662.1,48775345,49011180,49011182,a,aaN,2
NC_037340.1,NC_032662.1,48782818,49018655,49018656,a,at,1
NC_037340.1,NC_032662.1,48782949,49018787,49018793,a,aNNNNNN,6
NC_037340.1,NC_032662.1,48785520,49021366,49021367,t,tg,1
NC_037340.1,NC_032662.1,48798998,49034851,49034852,c,ct,1
NC_037340.1,NC_032662.1,48833797,49069673,49069685,a,actcaacaaagcc,12
NC_037340.1,NC_032662.1,49152390,49391846,49391848,G,GNN,2
NC_037340.1,NC_032662.1,49180246,49419854,49419855,g,ga,1
NC_037340.1,NC_032662.1,49180775,49420384,49420395,t,tttacattgttc,11
NC_037340.1,NC_032662.1,49189427,49429134,49429135,A,AR,1
NC_037340.1,NC_032662.1,49191787,49431495,49431499,A,AAATG,4
NC_037340.1,NC_032662.1,49212523,49451892,49451894,c,cca,2
NC_037340.1,NC_032662.1,49236182,49475534,49475535,A,AT,1
NC_037340.1,NC_032662.1,49238660,49478009,49478011,a,aac,2
NC_037340.1,NC_032662.1,49241748,49481099,49481105,t,tagcagc,6
NC_037340.1,NC_032662.1,49268595,49507949,49507950,g,ga,1
NC_037340.1,NC_032662.1,49324049,49575370,49575371,T,TA,1
NC_037340.1,NC_032662.1,49324287,49575610,49575612,T,TAA,2
NC_037340.1,NC_032662.1,49335026,49586351,49586353,T,TCA,2
NC_037340.1,NC_032662.1,49409316,49843779,49843780,a,ag,1
NC_037340.1,NC_032662.1,49437795,49872263,49872274,C,CACATACTTAAT,11
NC_037340.1,NC_032662.1,49455391,49889869,49889870,t,ta,1
NC_037340.1,NC_032662.1,49573591,50076541,50076542,A,AC,1
NC_037340.1,NC_032662.1,49685774,50188645,50188646,t,tg,1
NC_037340.1,NC_032662.1,49711095,50213971,50213973,t,taa,2
NC_037340.1,NC_032662.1,49711173,50214052,50214053,c,ct,1
NC_037340.1,NC_032662.1,49740741,50243624,50243630,t,tNNNNNN,6
NC_037340.1,NC_032662.1,49780333,50283245,50283247,t,tNN,2
NC_037340.1,NC_032662.1,49884088,50388048,50388049,T,TC,1
NC_037340.1,NC_032662.1,49933253,50437230,50437231,T,TC,1
NC_037340.1,NC_032662.1,50029017,50534731,50534732,a,aN,1
NC_037340.1,NC_032662.1,50037839,50543558,50543559,g,gc,1
NC_037340.1,NC_032662.1,50044636,50550360,50550361,a,at,1
NC_037340.1,NC_032662.1,50050249,50555974,50555975,t,tg,1
NC_037340.1,NC_032662.1,50076713,50605461,50605463,t,tta,2
NC_037340.1,NC_032662.1,50115581,50644269,50644270,t,ta,1
NC_037340.1,NC_032662.1,50128123,50656815,50656818,T,TATC,3
NC_037340.1,NC_032662.1,50145403,50685821,50685822,c,ct,1
NC_037340.1,NC_032662.1,50156570,50697835,50697839,c,ccagt,4
NC_037340.1,NC_032662.1,50241562,50782814,50782836,g,ggctcagatcatgaactccttat,22
NC_037340.1,NC_032662.1,50244714,50785990,50785991,A,AT,1
NC_037340.1,NC_032662.1,50481071,51031027,51031028,c,ct,1
NC_037340.1,NC_032662.1,50481840,51031797,51031798,t,ta,1
NC_037340.1,NC_032662.1,50482079,51032037,51032039,g,gtN,2
NC_037340.1,NC_032662.1,50588098,51137955,51137956,g,gt,1
NC_037340.1,NC_032662.1,50622721,51172463,51172465,C,CTT,2
NC_037340.1,NC_032662.1,50655723,51206046,51206050,t,taaaa,4
NC_037340.1,NC_032662.1,50720877,51271278,51271280,c,ctt,2
NC_037340.1,NC_032662.1,50722523,51272926,51272927,a,at,1
NC_037340.1,NC_032662.1,50796630,51347043,51347044,t,tN,1
NC_037340.1,NC_032662.1,50813020,51363487,51363496,t,tgtttttttg,9
NC_037340.1,NC_032662.1,50897508,51448374,51448375,t,ta,1
NC_037340.1,NC_032662.1,50961540,51512424,51512439,G,GTCCAGGCATGGGGTR,15
NC_037340.1,NC_032662.1,51222270,51759857,51759858,t,tg,1
NC_037340.1,NC_032662.1,51232342,51769935,51769944,c,caaaaaaaaa,9
NC_037340.1,NC_032662.1,51258604,51815208,51815212,a,ataNN,4
NC_037340.1,NC_032662.1,51276348,51832962,51832963,C,CT,1
NC_037340.1,NC_032662.1,51305128,51864749,51864754,a,aaaact,5
NC_037340.1,NC_032662.1,51344631,51904259,51904260,a,aR,1
NC_037340.1,NC_032662.1,51357021,51916649,51916651,T,TAC,2
NC_037340.1,NC_032662.1,51470977,52041074,52041075,T,TC,1
NC_037340.1,NC_032662.1,51496516,52066616,52066618,c,cta,2
NC_037340.1,NC_032662.1,51887195,52446905,52446906,G,GS,1
NC_037340.1,NC_032662.1,51993628,52553343,52553344,T,TG,1
NC_037340.1,NC_032662.1,51994145,52553861,52553862,G,GR,1
NC_037340.1,NC_032662.1,52031731,52590877,52590878,c,cg,1
NC_037340.1,NC_032662.1,52053163,52612219,52612220,C,CA,1
NC_037340.1,NC_032662.1,52055399,52614456,52614457,g,gc,1
NC_037340.1,NC_032662.1,52175333,52734159,52734160,T,TA,1
NC_037340.1,NC_032662.1,52193574,52752400,52752401,G,GC,1
NC_037340.1,NC_032662.1,52202150,52760977,52760978,c,ct,1
NC_037340.1,NC_032662.1,52227646,52786474,52786475,t,ta,1
NC_037340.1,NC_032662.1,52378637,52937435,52937438,a,aaag,3
NC_037340.1,NC_032662.1,52379111,52937912,52937913,t,ta,1
NC_037340.1,NC_032662.1,52379727,52938528,52938530,c,cat,2
NC_037340.1,NC_032662.1,52384078,52942881,52942882,A,AT,1
NC_037340.1,NC_032662.1,52429940,52987339,52987340,c,ct,1
NC_037340.1,NC_032662.1,52485301,53042584,53042585,g,gt,1
NC_037340.1,NC_032662.1,52488483,53045767,53045768,c,ct,1
NC_037340.1,NC_032662.1,52604554,53161838,53161839,a,at,1
NC_037340.1,NC_032662.1,52604813,53162098,53162102,a,atggt,4
NC_037340.1,NC_032662.1,52633264,53190750,53190752,t,tNN,2
NC_037340.1,NC_032662.1,52647889,53205719,53205723,C,CAAAA,4
NC_037340.1,NC_032662.1,52817568,53375444,53375446,t,taa,2
NC_037340.1,NC_032662.1,52842606,53400487,53400488,a,at,1
NC_037340.1,NC_032662.1,52861655,53419662,53419663,C,CG,1
NC_037340.1,NC_032662.1,52947822,53506536,53506537,a,ac,1
NC_037340.1,NC_032662.1,52975799,53534517,53534518,C,CR,1
NC_037340.1,NC_032662.1,53037967,53596691,53596692,t,tN,1
NC_037340.1,NC_032662.1,53053050,53611775,53611776,a,at,1
NC_037340.1,NC_032662.1,53058188,53616915,53616938,T,TACCAAANNNNNNNNNNNNNNNNN,23
NC_037340.1,NC_032662.1,53070288,53629081,53629084,c,cagg,3
NC_037340.1,NC_032662.1,53070463,53629259,53629264,g,gatctR,5
NC_037340.1,NC_032662.1,53148925,53707740,53707742,t,tNN,2
NC_037340.1,NC_032662.1,53215478,53774285,53774288,t,tagc,3
NC_037340.1,NC_032662.1,53220423,53779234,53779236,c,ctt,2
NC_037340.1,NC_032662.1,53226203,53785020,53785021,G,GR,1
NC_037340.1,NC_032662.1,53226373,53785191,53785192,G,GR,1
NC_037340.1,NC_032662.1,53283333,53842364,53842365,G,GC,1
NC_037340.1,NC_032662.1,53365123,53924169,53924176,g,gggagaga,7
NC_037340.1,NC_032662.1,53393017,53952074,53952075,C,CT,1
NC_037340.1,NC_032662.1,53394045,53953103,53953104,a,at,1
NC_037340.1,NC_032662.1,53398433,53957492,53957519,C,CAANNNNNNNNNNNNNNNNNNNNNNNNN,27
NC_037340.1,NC_032662.1,53449835,54009686,54009687,g,gc,1
NC_037340.1,NC_032662.1,53582364,54231026,54231035,a,acctagatag,9
NC_037340.1,NC_032662.1,53746953,54430961,54430962,T,TW,1
NC_037340.1,NC_032662.1,53795156,54472186,54472210,G,GCAAGAGCCAACGCTGACCTTCAGA,24
NC_037340.1,NC_032662.1,53825160,54502208,54502209,A,AC,1
NC_037340.1,NC_032662.1,53958543,54635329,54635330,G,GC,1
NC_037340.1,NC_032662.1,53986154,54662588,54662589,g,gt,1
NC_037340.1,NC_032662.1,54090896,54767336,54767337,A,AR,1
NC_037340.1,NC_032662.1,54091559,54768000,54768001,a,ac,1
NC_037340.1,NC_032662.1,54134128,54810528,54810529,T,TA,1
NC_037340.1,NC_032662.1,54157495,54840318,54840320,T,TAG,2
NC_037340.1,NC_032662.1,54258894,54941308,54941309,G,GC,1
NC_037340.1,NC_032662.1,54297575,54979987,54979989,T,TNN,2
NC_037340.1,NC_032662.1,54332200,55014616,55014617,C,CA,1
NC_037340.1,NC_032662.1,54332723,55015138,55015139,G,GC,1
NC_037340.1,NC_032662.1,54422509,55112823,55112824,A,AC,1
NC_037340.1,NC_032662.1,54449640,55139986,55139987,G,GR,1
NC_037340.1,NC_032662.1,54500496,55190000,55190004,A,AAGTT,4
NC_037340.1,NC_032662.1,54543313,55231821,55231822,A,AC,1
NC_037340.1,NC_032662.1,54558566,55247008,55247009,C,CM,1
NC_037340.1,NC_032662.1,54559589,55248033,55248034,C,CT,1
NC_037340.1,NC_032662.1,54592177,55281294,55281295,G,GA,1
NC_037340.1,NC_032662.1,54621524,55336616,55336626,A,ACTGCTGTTAC,10
NC_037340.1,NC_032662.1,54694107,55408374,55408375,G,GN,1
NC_037340.1,NC_032662.1,54741491,55455617,55455618,G,GK,1
NC_037340.1,NC_032662.1,54786270,55500396,55500397,A,AW,1
NC_037340.1,NC_032662.1,54825222,55539351,55539352,A,AG,1
NC_037340.1,NC_032662.1,54825239,55539369,55539370,A,AG,1
NC_037340.1,NC_032662.1,54888062,55602187,55602192,C,CTATAA,5
NC_037340.1,NC_032662.1,54888199,55602329,55602330,G,GA,1
NC_037340.1,NC_032662.1,54888237,55602368,55602369,G,GN,1
NC_037340.1,NC_032662.1,54900397,55614526,55614527,G,GS,1
NC_037340.1,NC_032662.1,55053770,55775564,55775568,C,CAGGG,4
NC_037340.1,NC_032662.1,55056456,55778253,55778254,C,CM,1
NC_037340.1,NC_032662.1,55103425,55801438,55801443,A,AATGAG,5
NC_037340.1,NC_032662.1,55221460,55919427,55919428,c,ca,1
NC_037340.1,NC_032662.1,55386040,56084147,56084148,A,AG,1
NC_037340.1,NC_032662.1,55426898,56124919,56124934,C,CMTACTTTCCACAATM,15
NC_037340.1,NC_032662.1,55455153,56153101,56153102,G,GC,1
NC_037340.1,NC_032662.1,55469041,56166991,56166992,G,GA,1
NC_037340.1,NC_032662.1,55522261,56220358,56220364,C,CCAAAGG,6
NC_037340.1,NC_032662.1,55560189,56258387,56258388,C,CA,1
NC_037340.1,NC_032662.1,55658840,56357836,56357837,T,TY,1
NC_037340.1,NC_032662.1,55748979,56448063,56448064,G,GK,1
NC_037340.1,NC_032662.1,55759558,56457937,56457938,c,ca,1
NC_037340.1,NC_032662.1,55782791,56479816,56479817,g,gt,1
NC_037340.1,NC_032662.1,55787758,56484814,56484815,C,CY,1
NC_037340.1,NC_032662.1,55894389,56591726,56591727,A,AT,1
NC_037340.1,NC_032662.1,55919678,56616979,56616980,c,ca,1
NC_037340.1,NC_032662.1,55927525,56624833,56624835,g,gtc,2
NC_037340.1,NC_032662.1,56002108,56674870,56674871,G,GT,1
NC_037340.1,NC_032662.1,56004848,56677607,56677614,a,atatatat,7
NC_037340.1,NC_032662.1,56006333,56679098,56679099,G,GA,1
NC_037340.1,NC_032662.1,56116309,56788986,56788987,C,CR,1
NC_037340.1,NC_032662.1,56128451,56801132,56801133,t,tc,1
NC_037340.1,NC_032662.1,56177484,56850019,56850021,c,cca,2
NC_037340.1,NC_032662.1,56180734,56853273,56853274,a,aN,1
NC_037340.1,NC_032662.1,56182181,56854721,56854722,c,ca,1
NC_037340.1,NC_032662.1,56303387,56877093,56877096,C,CACA,3
NC_037340.1,NC_032662.1,56303387,56996761,56996764,C,CACA,3
NC_037340.1,NC_032662.1,56332715,57026093,57026101,a,aNNNNNNNN,8
NC_037340.1,NC_032662.1,56336416,57029802,57029804,t,ttc,2
NC_037340.1,NC_032662.1,56349570,57042958,57042959,C,CY,1
NC_037340.1,NC_032662.1,56361304,57054687,57054688,t,tg,1
NC_037340.1,NC_032662.1,56361925,57055308,57055310,t,taa,2
NC_037340.1,NC_032662.1,56363938,57057321,57057322,C,CA,1
NC_037340.1,NC_032662.1,56371008,57063958,57063959,T,TG,1
NC_037340.1,NC_032662.1,56459074,57152047,57152048,T,TG,1
NC_037340.1,NC_032662.1,56492992,57185951,57185952,T,TG,1
NC_037340.1,NC_032662.1,56497578,57190538,57190539,T,TY,1
NC_037340.1,NC_032662.1,56590246,57282219,57282244,t,tNNNNNNNNNNNNNNNNNNNNNNNNN,25
NC_037340.1,NC_032662.1,56607074,57299072,57299073,A,AC,1
NC_037340.1,NC_032662.1,56643346,57335325,57335326,A,AR,1
NC_037340.1,NC_032662.1,56696703,57387990,57387994,T,TCTGA,4
NC_037340.1,NC_032662.1,56715470,57406759,57406760,g,ga,1
NC_037340.1,NC_032662.1,56752999,57444323,57444325,T,TCA,2
NC_037340.1,NC_032662.1,56799101,57489386,57489388,t,ttg,2
NC_037340.1,NC_032662.1,56834689,57524907,57524908,A,AG,1
NC_037340.1,NC_032662.1,56933204,57624002,57624003,G,GS,1
NC_037340.1,NC_032662.1,57008319,57698480,57698481,C,CG,1
NC_037340.1,NC_032662.1,57253500,57973130,57973131,C,CA,1
NC_037340.1,NC_032662.1,57454114,58170440,58170441,A,AC,1
NC_037340.1,NC_032662.1,57455169,58171496,58171497,G,GA,1
NC_037340.1,NC_032662.1,57475802,58191145,58191146,t,tc,1
NC_037340.1,NC_032662.1,57513152,58262421,58262423,t,taa,2
NC_037340.1,NC_032662.1,57524039,58273562,58273563,G,GA,1
NC_037340.1,NC_032662.1,57619153,58369334,58369336,G,GCT,2
NC_037340.1,NC_032662.1,57706915,58456628,58456629,g,gt,1
NC_037340.1,NC_032662.1,57719448,58469165,58469167,c,cca,2
NC_037340.1,NC_032662.1,57839536,58608733,58608734,G,GT,1
NC_037340.1,NC_032662.1,57886284,58655326,58655327,c,ca,1
NC_037340.1,NC_032662.1,57909209,58678252,58678253,G,GT,1
NC_037340.1,NC_032662.1,57933152,58702202,58702206,G,GCAGT,4
NC_037340.1,NC_032662.1,58047954,58817135,58817136,G,GA,1
NC_037340.1,NC_032662.1,58059970,58829155,58829156,C,CT,1
NC_037340.1,NC_032662.1,58074471,58843658,58843659,g,gt,1
NC_037340.1,NC_032662.1,58088707,58857896,58857897,G,GC,1
NC_037340.1,NC_032662.1,58091307,58860498,58860499,T,TY,1
NC_037340.1,NC_032662.1,58141155,58910509,58910510,c,ca,1
NC_037340.1,NC_032662.1,58145072,58914427,58914430,A,ARAG,3
NC_037340.1,NC_032662.1,58273697,59039775,59039776,C,CA,1
NC_037340.1,NC_032662.1,58294344,59060424,59060425,a,at,1
NC_037340.1,NC_032662.1,58329393,59095486,59095495,C,CTCTGGTTGA,9
NC_037340.1,NC_032662.1,58364241,59130357,59130358,c,cT,1
NC_037340.1,NC_032662.1,58364250,59130367,59130368,T,TC,1
NC_037340.1,NC_032662.1,58378331,59144454,59144461,G,GTTGTTAA,7
NC_037340.1,NC_032662.1,58383366,59149493,59149494,G,GR,1
NC_037340.1,NC_032662.1,58391645,59157775,59157776,T,TG,1
NC_037340.1,NC_032662.1,58446510,59210739,59210740,C,CY,1
NC_037340.1,NC_032662.1,58446519,59210749,59210750,G,GC,1
NC_037340.1,NC_032662.1,58480143,59244377,59244378,G,GT,1
NC_037340.1,NC_032662.1,58489368,59253603,59253604,C,CY,1
NC_037340.1,NC_032662.1,58517890,59282108,59282109,C,CT,1
NC_037340.1,NC_032662.1,58579885,59343942,59343943,A,AG,1
NC_037340.1,NC_032662.1,58612391,59376448,59376449,C,CN,1
NC_037340.1,NC_032662.1,58623003,59387056,59387057,A,AG,1
NC_037340.1,NC_032662.1,58840021,59606490,59606491,t,tc,1
NC_037340.1,NC_032662.1,58901782,59668254,59668255,t,ta,1
NC_037340.1,NC_032662.1,58901816,59668288,59668289,c,cg,1
NC_037340.1,NC_032662.1,58904355,59670828,59670836,A,AGTTGACTG,8
NC_037340.1,NC_032662.1,58908184,59674668,59674670,T,TTA,2
NC_037340.1,NC_032662.1,58920930,59687419,59687485,A,ACTGAGAGGAGGAACCCCAGATGCTGAGAGGTGGCACCCCAGGTACTGAGAGGAGGAACCCCAGATG,66
NC_037340.1,NC_032662.1,58927832,59694387,59694388,a,ag,1
NC_037340.1,NC_032662.1,58967923,59734481,59734482,G,GC,1
NC_037340.1,NC_032662.1,58985749,59752310,59752311,G,GT,1
NC_037340.1,NC_032662.1,58991915,59758495,59758498,a,acat,3
NC_037340.1,NC_032662.1,59002124,59768710,59768711,A,AG,1
NC_037340.1,NC_032662.1,59019021,59785631,59785633,c,caa,2
NC_037340.1,NC_032662.1,59042008,59808623,59808624,G,GA,1
NC_037340.1,NC_032662.1,59208375,59975633,59975634,G,GA,1
NC_037340.1,NC_032662.1,59244849,60012111,60012112,T,TK,1
NC_037340.1,NC_032662.1,59254510,60021384,60021385,T,TA,1
NC_037340.1,NC_032662.1,59275875,60042672,60042673,a,at,1
NC_037340.1,NC_032662.1,59296556,60062701,60062702,G,GK,1
NC_037340.1,NC_032662.1,59303609,60069790,60069791,C,CY,1
NC_037340.1,NC_032662.1,59304881,60088135,60088136,T,TN,1
NC_037340.1,NC_032662.1,59324741,60107993,60107995,g,gga,2
NC_037340.1,NC_032662.1,59327847,60111096,60111099,t,tagc,3
NC_037340.1,NC_032662.1,59336728,60119983,60119984,C,CT,1
NC_037340.1,NC_032662.1,59371679,60154935,60154938,c,ccaa,3
NC_037340.1,NC_032662.1,59382438,60165696,60165697,a,at,1
NC_037340.1,NC_032662.1,59421668,60204930,60204932,T,TGA,2
NC_037340.1,NC_032662.1,59508678,60291982,60291983,t,ta,1
NC_037340.1,NC_032662.1,59516695,60300000,60300002,A,AAT,2
NC_037340.1,NC_032662.1,59541061,60327274,60327275,A,AC,1
NC_037340.1,NC_032662.1,59543813,60330028,60330030,c,cga,2
NC_037340.1,NC_032662.1,59582244,60375823,60375825,C,CCG,2
NC_037340.1,NC_032662.1,59612978,60406210,60406211,T,TY,1
NC_037340.1,NC_032662.1,59627063,60420448,60420457,a,acactgtttc,9
NC_037340.1,NC_032662.1,59762685,60599783,60599784,T,TG,1
NC_037340.1,NC_032662.1,59774998,60620103,60620106,a,agag,3
NC_037340.1,NC_032662.1,59805121,60650239,60650240,G,GT,1
NC_037340.1,NC_032662.1,59822493,60667607,60667611,A,AGAGG,4
NC_037340.1,NC_032662.1,59846614,60691732,60691733,T,TY,1
NC_037340.1,NC_032662.1,59853030,60698145,60698146,G,GR,1
NC_037340.1,NC_032662.1,59917546,60762641,60762645,T,TACAG,4
NC_037340.1,NC_032662.1,59917921,60763017,60763019,G,GAC,2
NC_037340.1,NC_032662.1,59925059,60770160,60770162,T,TTG,2
NC_037340.1,NC_032662.1,59925479,60770582,60770583,A,AT,1
NC_037340.1,NC_032662.1,59983557,60828741,60828747,c,cacacag,6
NC_037340.1,NC_032662.1,59986265,60831458,60831460,g,gac,2
NC_037340.1,NC_032662.1,60178621,61025920,61025921,t,tc,1
NC_037340.1,NC_032662.1,60344264,61191608,61191609,c,ct,1
NC_037340.1,NC_032662.1,60543223,61383499,61383500,G,GA,1
NC_037340.1,NC_032662.1,60692457,61526549,61526550,T,TG,1
NC_037340.1,NC_032662.1,60745916,61580920,61580921,C,CT,1
NC_037340.1,NC_032662.1,60914666,61752542,61752543,g,ga,1
NC_037340.1,NC_032662.1,60962935,61800603,61800605,A,AAC,2
NC_037340.1,NC_032662.1,60963389,61801059,61801060,A,AM,1
NC_037340.1,NC_032662.1,60999019,61836676,61836677,a,ac,1
NC_037340.1,NC_032662.1,61002338,61840003,61840004,G,GA,1
NC_037340.1,NC_032662.1,61004865,61842527,61842528,A,AG,1
NC_037340.1,NC_032662.1,61008687,61846358,61846361,T,TAAC,3
NC_037340.1,NC_032662.1,61013543,61851219,61851221,A,AAT,2
NC_037340.1,NC_032662.1,61016287,61853965,61853966,c,ct,1
NC_037340.1,NC_032662.1,61025241,61862954,61862955,T,TA,1
NC_037340.1,NC_032662.1,61025345,61863059,61863061,T,TTG,2
NC_037340.1,NC_032662.1,61026008,61863726,61863727,c,ca,1
NC_037340.1,NC_032662.1,61028344,61866070,61866071,a,at,1
NC_037340.1,NC_032662.1,61033633,61871358,61871388,G,GGGAAAACTCTCATGagttataaaaaataga,30
NC_037340.1,NC_032662.1,61045702,61883448,61883449,g,ga,1
NC_037340.1,NC_032662.1,61048888,61886635,61886640,t,tccaac,5
NC_037340.1,NC_032662.1,61058951,61896698,61896700,c,caa,2
NC_037340.1,NC_032662.1,61059919,61897667,61897668,T,TC,1
NC_037340.1,NC_032662.1,61067084,61905563,61905578,T,TTCCTTCCATCAACCW,15
NC_037340.1,NC_032662.1,61290492,62152297,62152298,G,GA,1
NC_037340.1,NC_032662.1,61391252,62253364,62253365,G,GK,1
NC_037340.1,NC_032662.1,61450026,62315064,62315065,T,TC,1
NC_037340.1,NC_032662.1,61450398,62315436,62315437,a,ag,1
NC_037340.1,NC_032662.1,61460634,62325674,62325675,T,TY,1
NC_037340.1,NC_032662.1,61480595,62345636,62345637,G,GT,1
NC_037340.1,NC_032662.1,61552833,62417873,62417896,T,Tgttgtacatatattttatatcaa,23
NC_037340.1,NC_032662.1,61590369,62455462,62455464,C,CTG,2
NC_037340.1,NC_032662.1,61612743,62477846,62477848,C,CTT,2
NC_037340.1,NC_032662.1,61652171,62516440,62516441,G,GK,1
NC_037340.1,NC_032662.1,61791998,62657583,62657584,A,AW,1
NC_037340.1,NC_032662.1,61909743,62783828,62783829,G,GT,1
NC_037340.1,NC_032662.1,61989014,62863112,62863114,c,cca,2
NC_037340.1,NC_032662.1,62003723,62877944,62877945,T,TA,1
NC_037340.1,NC_032662.1,62061938,62935203,62935204,G,GS,1
NC_037340.1,NC_032662.1,62095418,62968700,62968701,g,gt,1
NC_037340.1,NC_032662.1,62095445,62968728,62968729,t,tg,1
NC_037340.1,NC_032662.1,62097027,62970311,62970312,t,ta,1
NC_037340.1,NC_032662.1,62112681,62985916,62985917,a,aW,1
NC_037340.1,NC_032662.1,62130332,63005656,63005657,C,CG,1
NC_037340.1,NC_032662.1,62130365,63005690,63005691,C,CA,1
NC_037340.1,NC_032662.1,62137057,63012384,63012386,a,agg,2
NC_037340.1,NC_032662.1,62142337,63017667,63017686,C,CNNNNNNNNNNNNNNNNNNN,19
NC_037340.1,NC_032662.1,62301179,63176987,63176988,t,ta,1
NC_037340.1,NC_032662.1,62322738,63198529,63198531,C,CKG,2
NC_037340.1,NC_032662.1,62329623,63205416,63205417,T,TK,1
NC_037340.1,NC_032662.1,62346673,63222851,63222858,t,ttttttta,7
NC_037340.1,NC_032662.1,62346922,63223107,63223108,C,CA,1
NC_037340.1,NC_032662.1,62347611,63223808,63223809,c,ct,1
NC_037340.1,NC_032662.1,62366243,63242444,63242445,C,CY,1
NC_037340.1,NC_032662.1,62366252,63242454,63242455,A,AG,1
NC_037340.1,NC_032662.1,62491366,63375430,63375431,T,TG,1
NC_037340.1,NC_032662.1,62525041,63387202,63387203,A,AC,1
NC_037340.1,NC_032662.1,62525124,63387286,63387289,t,ttaa,3
NC_037340.1,NC_032662.1,62525177,63387342,63387346,T,TAACA,4
NC_037340.1,NC_032662.1,62528389,63390559,63390560,c,ct,1
NC_037340.1,NC_032662.1,62534820,63396991,63396992,A,AT,1
NC_037340.1,NC_032662.1,62534828,63397000,63397001,A,AG,1
NC_037340.1,NC_032662.1,62536209,63398382,63398383,G,GR,1
NC_037340.1,NC_032662.1,62542840,63405016,63405017,G,GK,1
NC_037340.1,NC_032662.1,62546901,63409078,63409079,c,ca,1
NC_037340.1,NC_032662.1,62546945,63409123,63409124,t,tg,1
NC_037340.1,NC_032662.1,62566961,63429142,63429143,A,AC,1
NC_037340.1,NC_032662.1,62674638,63536686,63536687,A,AM,1
NC_037340.1,NC_032662.1,62678138,63540206,63540207,A,AT,1
NC_037340.1,NC_032662.1,62705452,63567517,63567518,a,ac,1
NC_037340.1,NC_032662.1,62739888,63601960,63601961,a,at,1
NC_037340.1,NC_032662.1,62761956,63624412,63624414,T,TAA,2
NC_037340.1,NC_032662.1,62773376,63635833,63635834,a,at,1
NC_037340.1,NC_032662.1,62903729,63766198,63766199,C,CY,1
NC_037340.1,NC_032662.1,62909092,63771563,63771566,T,TCTC,3
NC_037340.1,NC_032662.1,63120510,63984787,63984788,T,TG,1
NC_037340.1,NC_032662.1,63150980,64016033,64016035,t,ttg,2
NC_037340.1,NC_032662.1,63263586,64134244,64134247,G,GAGA,3
NC_037340.1,NC_032662.1,63275304,64145990,64145994,a,aaagg,4
NC_037340.1,NC_032662.1,63288300,64158991,64158992,C,CY,1
NC_037340.1,NC_032662.1,63308873,64179555,64179556,C,CY,1
NC_037340.1,NC_032662.1,63327241,64197923,64197924,G,GR,1
NC_037340.1,NC_032662.1,63334857,64205542,64205545,a,aatg,3
NC_037340.1,NC_032662.1,63470422,64341124,64341139,T,TTCTGATAGGAACACA,15
NC_037340.1,NC_032662.1,63493353,64364071,64364073,c,cct,2
NC_037340.1,NC_032662.1,63847016,64430813,64430814,t,tg,1
NC_037340.1,NC_032662.1,63896487,64484297,64484298,G,GA,1
NC_037340.1,NC_032662.1,64097672,64683723,64683724,t,tg,1
NC_037340.1,NC_032662.1,64181131,64766914,64766915,G,GA,1
NC_037340.1,NC_032662.1,64363013,64956906,64956908,A,ATC,2
NC_037340.1,NC_032662.1,64370013,64963909,64963911,a,aag,2
NC_037340.1,NC_032662.1,64378663,64972549,64972550,c,ct,1
NC_037340.1,NC_032662.1,64379033,64972920,64972921,c,ca,1
NC_037340.1,NC_032662.1,64382619,64976505,64976509,t,ttttg,4
NC_037340.1,NC_032662.1,64412469,65006364,65006367,T,TATA,3
NC_037340.1,NC_032662.1,64461339,65055292,65055295,a,agag,3
NC_037340.1,NC_032662.1,64485024,65078974,65078975,t,ta,1
NC_037340.1,NC_032662.1,64616103,65211168,65211171,G,GAGT,3
NC_037340.1,NC_032662.1,64620903,65215973,65215974,T,TW,1
NC_037340.1,NC_032662.1,64781743,65377231,65377232,g,ga,1
NC_037340.1,NC_032662.1,64901670,65498867,65498868,A,AR,1
NC_037340.1,NC_032662.1,65113404,65711222,65711223,G,GM,1
NC_037340.1,NC_032662.1,65128218,65726037,65726038,C,CY,1
NC_037340.1,NC_032662.1,65135145,65732967,65732968,T,TC,1
NC_037340.1,NC_032662.1,65213405,65814069,65814071,c,caa,2
NC_037340.1,NC_032662.1,65282598,65883275,65883276,G,GC,1
NC_037340.1,NC_032662.1,65323839,65923550,65923554,G,GACTC,4
NC_037340.1,NC_032662.1,65325878,65925593,65925594,a,ag,1
NC_037340.1,NC_032662.1,65326414,65926130,65926131,G,GS,1
NC_037340.1,NC_032662.1,65354932,65954675,65954676,A,AC,1
NC_037340.1,NC_032662.1,65527601,66127290,66127292,C,CAT,2
NC_037340.1,NC_032662.1,65662964,66262681,66262682,T,TY,1
NC_037340.1,NC_032662.1,65699846,66299436,66299437,a,ac,1
NC_037340.1,NC_032662.1,65711250,66310875,66310876,T,TY,1
NC_037340.1,NC_032662.1,65721126,66320760,66320761,G,GA,1
NC_037340.1,NC_032662.1,65721204,66320839,66320841,C,CAT,2
NC_037340.1,NC_032662.1,65721220,66320857,66320858,A,AG,1
NC_037340.1,NC_032662.1,65731210,66330847,66330848,T,TY,1
NC_037340.1,NC_032662.1,65734417,66334055,66334056,T,TY,1
NC_037340.1,NC_032662.1,65750551,66350193,66350194,A,AG,1
NC_037340.1,NC_032662.1,65752024,66351665,66351666,t,tg,1
NC_037340.1,NC_032662.1,65758631,66358271,66358272,A,AT,1
NC_037340.1,NC_032662.1,65760503,66360144,66360145,A,AR,1
NC_037340.1,NC_032662.1,65768911,66368334,66368353,A,ACCCTACTTTCTTAACCAGT,19
NC_037340.1,NC_032662.1,65772452,66371916,66371920,T,TGAGY,4
NC_037340.1,NC_032662.1,65781077,66380552,66380553,G,GR,1
NC_037340.1,NC_032662.1,65820339,66419594,66419600,t,tgtacac,6
NC_037340.1,NC_032662.1,65933930,66532671,66532672,G,GT,1
NC_037340.1,NC_032662.1,66068244,66667972,66667975,T,TAAG,3
NC_037340.1,NC_032662.1,66316526,66916917,66916919,A,ACT,2
NC_037340.1,NC_032662.1,66347236,66947644,66947659,T,TTTTACTCCTTATCAC,15
NC_037340.1,NC_032662.1,66348649,66949072,66949074,G,GGT,2
NC_037340.1,NC_032662.1,66363825,66962330,66962332,t,tta,2
NC_037340.1,NC_032662.1,66377643,66976162,66976170,c,caYACACAT,8
NC_037340.1,NC_032662.1,66390612,66989111,66989112,g,ga,1
NC_037340.1,NC_032662.1,66400742,66999248,66999249,C,CS,1
NC_037340.1,NC_032662.1,66404455,67002962,67002963,A,AC,1
NC_037340.1,NC_032662.1,66509925,67108532,67108533,C,CM,1
NC_037340.1,NC_032662.1,66513602,67112210,67112211,G,GT,1
NC_037340.1,NC_032662.1,66516998,67115608,67115609,T,TW,1
NC_037340.1,NC_032662.1,66529744,67128089,67128095,T,TAGNNNN,6
NC_037340.1,NC_032662.1,66536879,67136983,67136984,A,AR,1
NC_037340.1,NC_032662.1,66591451,67191569,67191570,a,at,1
NC_037340.1,NC_032662.1,66591564,67191683,67191684,G,GA,1
NC_037340.1,NC_032662.1,66606139,67206260,67206282,t,tctagtcaaggctatggtttttc,22
NC_037340.1,NC_032662.1,66611215,67211359,67211361,T,TNN,2
NC_037340.1,NC_032662.1,66628014,67228254,67228255,T,TA,1
NC_037340.1,NC_032662.1,66630887,67231127,67231136,g,ggtttttttt,9
NC_037340.1,NC_032662.1,66654620,67254876,67254883,g,gcaCACCN,7
NC_037340.1,NC_032662.1,66654699,67254962,67254963,A,AC,1
NC_037340.1,NC_032662.1,66736823,67339385,67339386,t,tc,1
NC_037340.1,NC_032662.1,66750537,67353108,67353118,G,GCTTCTTCTGR,10
NC_037340.1,NC_032662.1,66759371,67367933,67367934,G,GT,1
NC_037340.1,NC_032662.1,66807561,67416092,67416093,A,AG,1
NC_037340.1,NC_032662.1,66810605,67418754,67418756,C,CAA,2
NC_037340.1,NC_032662.1,66818342,67426496,67426497,A,AR,1
NC_037340.1,NC_032662.1,66841803,67449960,67449961,T,TY,1
NC_037340.1,NC_032662.1,66856632,67464789,67464791,t,tca,2
NC_037340.1,NC_032662.1,66861843,67470002,67470004,a,agt,2
NC_037340.1,NC_032662.1,66959865,67568044,67568045,t,tc,1
NC_037340.1,NC_032662.1,67017732,67625922,67625925,G,GCAA,3
NC_037340.1,NC_032662.1,67108997,67717188,67717189,G,GK,1
NC_037340.1,NC_032662.1,67114684,67722892,67722893,T,TC,1
NC_037340.1,NC_032662.1,67131467,67739678,67739679,G,GT,1
NC_037340.1,NC_032662.1,67162627,67770848,67770857,g,gccactgttt,9
NC_037340.1,NC_032662.1,67168663,67776892,67776893,C,CA,1
NC_037340.1,NC_032662.1,67192756,67795951,67795954,A,ACAC,3
NC_037340.1,NC_032662.1,67384887,67987951,67987955,a,atatt,4
NC_037340.1,NC_032662.1,67388829,67991896,67991897,G,GR,1
NC_037340.1,NC_032662.1,67468746,68071802,68071804,t,tNN,2
NC_037340.1,NC_032662.1,67504212,68949586,68949587,C,CA,1
NC_037340.1,NC_032662.1,67504220,68949595,68949596,t,ta,1
NC_037340.1,NC_032662.1,67504235,68949611,68949612,a,ag,1
NC_037340.1,NC_032662.1,67519311,68964688,68964689,G,GS,1
NC_037340.1,NC_032662.1,67601071,68219870,68219871,T,TY,1
NC_037340.1,NC_032662.1,67627224,68245978,68245980,C,CAT,2
NC_037340.1,NC_032662.1,67674366,68293152,68293190,A,ACCAAATGTGTAGGGTAGACTAAGAATGAGGACTGAGAT,38
NC_037340.1,NC_032662.1,67686208,68305166,68305167,T,TC,1
NC_037340.1,NC_032662.1,67815827,68460433,68460434,a,ac,1
NC_037340.1,NC_032662.1,67881151,68530426,68530427,T,TC,1
NC_037340.1,NC_032662.1,68234904,68900691,68900700,G,GCTGAAGGTS,9
NC_037340.1,NC_032662.1,68326122,68997596,68997597,A,AG,1
NC_037340.1,NC_032662.1,68419225,69089915,69089916,G,GA,1
NC_037340.1,NC_032662.1,68436744,69107279,69107281,G,GGT,2
NC_037340.1,NC_032662.1,68509889,69180430,69180431,C,CM,1
NC_037340.1,NC_032662.1,68552209,69223257,69223259,C,CAT,2
NC_037340.1,NC_032662.1,68552252,69223302,69223303,T,TC,1
NC_037340.1,NC_032662.1,68726524,69397534,69397535,C,CR,1
NC_037340.1,NC_032662.1,68729074,69400085,69400086,c,ca,1
NC_037340.1,NC_032662.1,68858105,69534289,69534292,t,tgga,3
NC_037340.1,NC_032662.1,68876637,69552825,69552826,T,TA,1
NC_037340.1,NC_032662.1,69009658,69685194,69685208,T,TGGGTGGCAGAAGAC,14
NC_037340.1,NC_032662.1,69100919,69776471,69776472,T,TC,1
NC_037340.1,NC_032662.1,69127795,69803352,69803353,T,TA,1
NC_037340.1,NC_032662.1,69177972,69853528,69853529,G,GC,1
NC_037340.1,NC_032662.1,69259149,69934211,69934212,a,at,1
NC_037340.1,NC_032662.1,69339645,70013255,70013256,a,at,1
NC_037340.1,NC_032662.1,69494320,70178777,70178778,C,CA,1
NC_037340.1,NC_032662.1,69511800,70196260,70196261,a,ag,1
NC_037340.1,NC_032662.1,69532654,70217117,70217119,t,taa,2
NC_037340.1,NC_032662.1,69557608,70242118,70242119,C,CA,1
NC_037340.1,NC_032662.1,69560127,70244638,70244639,A,AR,1
NC_037340.1,NC_032662.1,69650405,70377517,70377518,G,GC,1
NC_037340.1,NC_032662.1,69697445,70419862,70419863,C,CA,1
NC_037340.1,NC_032662.1,69697520,70419938,70419940,G,GAC,2
NC_037340.1,NC_032662.1,69697528,70419948,70419949,C,CA,1
NC_037340.1,NC_032662.1,69707688,70430314,70430315,T,TA,1
NC_037340.1,NC_032662.1,69791272,70514139,70514140,G,GT,1
NC_037340.1,NC_032662.1,69791275,70514143,70514147,C,CTTCT,4
NC_037340.1,NC_032662.1,69839335,70562209,70562210,G,GS,1
NC_037340.1,NC_032662.1,69937268,70670844,70670845,G,GR,1
NC_037340.1,NC_032662.1,69985853,70709856,70709857,G,GA,1
NC_037340.1,NC_032662.1,69995548,70719554,70719555,C,CG,1
NC_037340.1,NC_032662.1,69995654,70719661,70719662,T,TG,1
NC_037340.1,NC_032662.1,69996477,70720485,70720486,T,TG,1
NC_037340.1,NC_032662.1,69996491,70720500,70720501,A,AG,1
NC_037340.1,NC_032662.1,69996497,70720507,70720508,A,AG,1
NC_037340.1,NC_032662.1,70070895,70794593,70794594,t,ta,1
NC_037340.1,NC_032662.1,70087519,70811218,70811220,C,CAA,2
NC_037340.1,NC_032662.1,70105200,70828902,70828903,T,TC,1
NC_037340.1,NC_032662.1,70105423,70829121,70829122,A,AN,1
NC_037340.1,NC_032662.1,70130593,70854096,70854097,c,ct,1
NC_037340.1,NC_032662.1,70143238,70866743,70866744,c,ca,1
NC_037340.1,NC_032662.1,70201083,70924591,70924592,A,AW,1
NC_037340.1,NC_032662.1,70293727,71018109,71018114,a,aacttc,5
NC_037340.1,NC_032662.1,70401352,71120401,71120405,T,TAAAA,4
NC_037340.1,NC_032662.1,70401391,71120444,71120447,t,ttta,3
NC_037340.1,NC_032662.1,70460333,71178930,71178932,c,ctg,2
NC_037340.1,NC_032662.1,70560575,71300486,71300487,C,CM,1
NC_037340.1,NC_032662.1,70563005,71302910,71302918,C,CTGGTCTGG,8
NC_037340.1,NC_032662.1,70674437,71414172,71414173,g,gt,1
NC_037340.1,NC_032662.1,70680505,71420244,71420252,a,atattaagt,8
NC_037340.1,NC_032662.1,70703191,71442996,71442997,T,TG,1
NC_037340.1,NC_032662.1,70731871,71471723,71471727,t,tactc,4
NC_037340.1,NC_032662.1,70732126,71471982,71471985,t,taga,3
NC_037340.1,NC_032662.1,70732182,71472041,71472042,t,tg,1
NC_037340.1,NC_032662.1,70992433,71757318,71757323,t,tgagtg,5
NC_037340.1,NC_032662.1,70994287,71759181,71759185,T,TCTTY,4
NC_037340.1,NC_032662.1,70999655,71764544,71764545,T,TA,1
NC_037340.1,NC_032662.1,70999909,71764798,71764801,T,TTAA,3
NC_037340.1,NC_032662.1,71000765,71765660,71765661,A,AR,1
NC_037340.1,NC_032662.1,71004051,71768942,71768943,c,ca,1
NC_037340.1,NC_032662.1,71012220,71777117,71777118,G,GA,1
NC_037340.1,NC_032662.1,71023283,71788199,71788200,C,CY,1
NC_037340.1,NC_032662.1,71046406,71811329,71811331,A,AAT,2
NC_037340.1,NC_032662.1,71050623,71815547,71815548,g,ga,1
NC_037340.1,NC_032662.1,71055398,71820319,71820320,a,ag,1
NC_037340.1,NC_032662.1,71063708,71828656,71828657,T,TK,1
NC_037340.1,NC_032662.1,71077903,71842849,71842850,c,ct,1
NC_037340.1,NC_032662.1,71086760,71851708,71851709,g,gt,1
NC_037340.1,NC_032662.1,71091461,71856403,71856404,T,TY,1
NC_037340.1,NC_032662.1,71091516,71856459,71856460,C,CT,1
NC_037340.1,NC_032662.1,71154136,71919339,71919340,c,ca,1
NC_037340.1,NC_032662.1,71155555,71920759,71920760,t,tN,1
NC_037340.1,NC_032662.1,71165606,71930810,71930811,t,tc,1
NC_037340.1,NC_032662.1,71168590,71934521,71934526,g,ggaaaa,5
NC_037340.1,NC_032662.1,71170738,71936674,71936683,g,gttttggttt,9
NC_037340.1,NC_032662.1,71260668,72026331,72026332,a,ag,1
NC_037340.1,NC_032662.1,71343406,72110128,72110129,T,TA,1
NC_037340.1,NC_032662.1,71385600,72152320,72152321,g,gt,1
NC_037340.1,NC_032662.1,71392975,72159689,72159690,A,AC,1
NC_037340.1,NC_032662.1,71418302,72185027,72185028,t,tc,1
NC_037340.1,NC_032662.1,71444977,72212452,72212453,c,ct,1
NC_037340.1,NC_032662.1,71461793,72230361,72230362,C,CT,1
NC_037340.1,NC_032662.1,71507622,72276197,72276199,t,tac,2
NC_037340.1,NC_032662.1,71521519,72290105,72290106,g,ga,1
NC_037340.1,NC_032662.1,71582586,72350789,72350790,G,GA,1
NC_037340.1,NC_032662.1,71611109,72379314,72379315,a,ac,1
NC_037340.1,NC_032662.1,71657326,72425583,72425584,A,AR,1
NC_037340.1,NC_032662.1,71658348,72426620,72426621,G,GR,1
NC_037340.1,NC_032662.1,71659813,72428087,72428088,t,ta,1
NC_037340.1,NC_032662.1,71665919,72434196,72434198,A,AAC,2
NC_037340.1,NC_032662.1,71681000,72449052,72449053,c,ca,1
NC_037340.1,NC_032662.1,71760038,72527745,72527746,A,AG,1
NC_037340.1,NC_032662.1,71773692,72541423,72541424,A,AT,1
NC_037340.1,NC_032662.1,71781405,72549145,72549148,t,ttga,3
NC_037340.1,NC_032662.1,71801727,72568497,72568499,G,GSA,2
NC_037340.1,NC_032662.1,71822902,72589984,72589985,G,GR,1
NC_037340.1,NC_032662.1,71822909,72589992,72589993,G,GR,1
NC_037340.1,NC_032662.1,71909768,72677279,72677280,G,GA,1
NC_037340.1,NC_032662.1,71909891,72677403,72677404,C,CT,1
NC_037340.1,NC_032662.1,71931684,72699268,72699269,g,gt,1
NC_037340.1,NC_032662.1,71976277,72743436,72743437,A,AM,1
NC_037340.1,NC_032662.1,71996682,72763999,72764008,C,CNNNNNNNNN,9
NC_037340.1,NC_032662.1,72005545,72772871,72772887,t,tcgccaagagtctgaca,16
NC_037340.1,NC_032662.1,72006834,72774175,72774176,A,AG,1
NC_037340.1,NC_032662.1,72037463,72805581,72805582,T,TS,1
NC_037340.1,NC_032662.1,72038524,72806643,72806644,c,ct,1
NC_037340.1,NC_032662.1,72120419,72888540,72888541,t,ta,1
NC_037340.1,NC_032662.1,72124636,72892758,72892759,C,CM,1
NC_037340.1,NC_032662.1,72151202,72919373,72919375,C,CTG,2
NC_037340.1,NC_032662.1,72156154,72924327,72924328,C,CS,1
NC_037340.1,NC_032662.1,72184166,72952341,72952342,C,CM,1
NC_037340.1,NC_032662.1,72188309,72956493,72956496,a,atct,3
NC_037340.1,NC_032662.1,72244113,73012176,73012182,C,CTGTTAA,6
NC_037340.1,NC_032662.1,72244116,73012185,73012187,T,TTA,2
NC_037340.1,NC_032662.1,72244131,73012202,73012203,a,at,1
NC_037340.1,NC_032662.1,72273246,73037623,73037624,g,gt,1
NC_037340.1,NC_032662.1,72329353,73093644,73093645,g,gc,1
NC_037340.1,NC_032662.1,72389304,73153599,73153600,a,ag,1
NC_037340.1,NC_032662.1,72475525,73266737,73266738,T,TG,1
NC_037340.1,NC_032662.1,72518540,73309753,73309754,G,GT,1
NC_037340.1,NC_032662.1,72519942,73311158,73311159,T,TA,1
NC_037340.1,NC_032662.1,72519989,73311207,73311208,T,TA,1
NC_037340.1,NC_032662.1,72519995,73311214,73311215,A,AC,1
NC_037340.1,NC_032662.1,72520008,73311228,73311229,A,AG,1
NC_037340.1,NC_032662.1,72520606,73311827,73311828,C,CT,1
NC_037340.1,NC_032662.1,72529625,73320670,73320671,A,AM,1
NC_037340.1,NC_032662.1,72665471,73455726,73455729,a,agtt,3
NC_037340.1,NC_032662.1,72678964,73469226,73469227,A,AN,1
NC_037340.1,NC_032662.1,72700277,73477940,73477941,C,CT,1
NC_037340.1,NC_032662.1,72740897,73518802,73518803,C,CA,1
NC_037340.1,NC_032662.1,72893179,73670010,73670011,C,CA,1
NC_037340.1,NC_032662.1,72893516,73670348,73670363,T,TTTGCCTGCGACCCCC,15
NC_037340.1,NC_032662.1,72893732,73670579,73670587,G,GAATTGGTA,8
NC_037340.1,NC_032662.1,72897949,73674799,73674800,T,TY,1
NC_037340.1,NC_032662.1,72898689,73675541,73675545,T,TGGTC,4
NC_037340.1,NC_032662.1,72898979,73675838,73675839,T,TG,1
NC_037340.1,NC_032662.1,72903455,73680316,73680317,A,AR,1
NC_037340.1,NC_032662.1,72920304,73697245,73697249,c,cattt,4
NC_037340.1,NC_032662.1,72945860,73723243,73723244,G,GA,1
NC_037340.1,NC_032662.1,72986124,73763091,73763093,t,tta,2
NC_037340.1,NC_032662.1,72988695,73765664,73765665,a,aM,1
NC_037340.1,NC_032662.1,73060598,73837865,73837869,A,AAATT,4
NC_037340.1,NC_032662.1,73064594,73841867,73841870,G,GTCC,3
NC_037340.1,NC_032662.1,73109495,73886778,73886779,C,CY,1
NC_037340.1,NC_032662.1,73120024,73897311,73897312,A,AC,1
NC_037340.1,NC_032662.1,73127662,73904951,73904952,C,CA,1
NC_037340.1,NC_032662.1,73143634,73927520,73927521,t,tg,1
NC_037340.1,NC_032662.1,73222346,74009949,74009950,C,CG,1
NC_037340.1,NC_032662.1,73266857,74056137,74056139,t,taa,2
NC_037340.1,NC_032662.1,73267133,74056414,74056430,G,GCACCAAAAACAACATA,16
NC_037340.1,NC_032662.1,73269117,74059486,74059503,T,TATTTCAGCTTTTTGAGC,17
NC_037340.1,NC_032662.1,73329580,74107393,74107397,T,TGTTA,4
NC_037340.1,NC_032662.1,73343571,74124240,74124242,C,CCA,2
NC_037340.1,NC_032662.1,73355554,74136227,74136228,A,AG,1
NC_037340.1,NC_032662.1,73363224,74143894,74143896,C,CAT,2
NC_037340.1,NC_032662.1,73367662,74148538,74148539,a,at,1
NC_037340.1,NC_032662.1,73457454,74238492,74238493,g,gc,1
NC_037340.1,NC_032662.1,73461370,74242409,74242410,G,GS,1
NC_037340.1,NC_032662.1,73482755,74262596,74262598,A,AAT,2
NC_037340.1,NC_032662.1,73482757,74262600,74262601,A,AG,1
NC_037340.1,NC_032662.1,73488375,74268213,74268214,C,CG,1
NC_037340.1,NC_032662.1,73516237,74277633,74277635,t,tac,2
NC_037340.1,NC_032662.1,73533597,74294995,74294996,t,ta,1
NC_037340.1,NC_032662.1,73563341,74338312,74338313,c,ca,1
NC_037340.1,NC_032662.1,73568531,74343528,74343529,G,GC,1
NC_037340.1,NC_032662.1,73572053,74347048,74347049,a,ac,1
NC_037340.1,NC_032662.1,73572974,74347970,74347971,G,GR,1
NC_037340.1,NC_032662.1,73573031,74348028,74348030,C,CCT,2
NC_037340.1,NC_032662.1,73580571,74355570,74355571,T,TC,1
NC_037340.1,NC_032662.1,73597255,74372198,74372199,T,TG,1
NC_037340.1,NC_032662.1,73681852,74457212,74457213,T,TG,1
NC_037340.1,NC_032662.1,73691487,74466848,74466854,C,CCCCKAT,6
NC_037340.1,NC_032662.1,73713735,74489787,74489788,A,AG,1
NC_037340.1,NC_032662.1,73729426,74505481,74505482,C,CT,1
NC_037340.1,NC_032662.1,73734645,74509913,74509914,C,CA,1
NC_037340.1,NC_032662.1,73737778,74513046,74513049,c,ccca,3
NC_037340.1,NC_032662.1,73746927,74522289,74522290,T,TA,1
NC_037340.1,NC_032662.1,73751536,74526894,74526896,A,AAG,2
NC_037340.1,NC_032662.1,73798927,74576144,74576148,a,aaaat,4
NC_037340.1,NC_032662.1,73880231,74657540,74657542,g,gga,2
NC_037340.1,NC_032662.1,73912917,74691969,74692008,C,CNNNNNNNNNNNNNNNNNNNNNNNNNNNNNNNNNNNNNNN,39
NC_037340.1,NC_032662.1,74127629,74909812,74909813,A,AG,1
NC_037340.1,NC_032662.1,74131092,74913276,74913277,g,gt,1
NC_037340.1,NC_032662.1,74227330,75009517,75009518,C,CS,1
NC_037340.1,NC_032662.1,74238078,75020266,75020269,A,ATGG,3
NC_037340.1,NC_032662.1,74238078,75088090,75088093,A,ATGG,3
NC_037340.1,NC_032662.1,74301978,75084255,75084256,t,tc,1
NC_037340.1,NC_032662.1,74302545,75084824,75084825,a,ag,1
NC_037340.1,NC_032662.1,74303719,75085969,75085970,T,TC,1
NC_037340.1,NC_032662.1,74322286,75104532,75104533,t,tc,1
NC_037340.1,NC_032662.1,74326155,75108402,75108403,g,ga,1
NC_037340.1,NC_032662.1,74350826,75133559,75133560,G,GW,1
NC_037340.1,NC_032662.1,74378635,75161370,75161371,t,ta,1
NC_037340.1,NC_032662.1,74523144,75305444,75305445,C,CT,1
NC_037340.1,NC_032662.1,74525704,75308006,75308007,T,TY,1
NC_037340.1,NC_032662.1,74526279,75308581,75308582,a,ag,1
NC_037340.1,NC_032662.1,74528777,75311076,75311077,g,gt,1
NC_037340.1,NC_032662.1,74530969,75313287,75313288,g,gt,1
NC_037340.1,NC_032662.1,74537777,75320095,75320101,c,ccaaaaa,6
NC_037340.1,NC_032662.1,74542103,75324424,75324430,g,gtcgtgt,6
NC_037340.1,NC_032662.1,74542876,75325194,75325195,A,AT,1
NC_037340.1,NC_032662.1,74543913,75326232,75326249,t,tggggggcaagaggagaa,17
NC_037340.1,NC_032662.1,74544891,75327226,75327227,c,ca,1
NC_037340.1,NC_032662.1,74562797,75345136,75345137,T,TC,1
NC_037340.1,NC_032662.1,74578318,75365867,75365868,g,gt,1
NC_037340.1,NC_032662.1,74592255,75379804,75379805,G,GR,1
NC_037340.1,NC_032662.1,74593307,75380858,75380861,t,ttaa,3
NC_037340.1,NC_032662.1,74629625,75415898,75415912,C,CCTATCATGAAGTCT,14
NC_037340.1,NC_032662.1,74657553,75444065,75444067,C,CTG,2
NC_037340.1,NC_032662.1,74684812,75471329,75471333,C,CCATA,4
NC_037340.1,NC_032662.1,74689121,75475663,75475664,G,GT,1
NC_037340.1,NC_032662.1,74690598,75477142,75477144,T,TTC,2
NC_037340.1,NC_032662.1,74692554,75479103,75479104,T,TG,1
NC_037340.1,NC_032662.1,74699124,75485666,75485667,C,CS,1
NC_037340.1,NC_032662.1,74699277,75485820,75485821,C,CT,1
NC_037340.1,NC_032662.1,74711129,75497679,75497680,a,at,1
NC_037340.1,NC_032662.1,74724149,75510701,75510702,A,AG,1
NC_037340.1,NC_032662.1,74728394,75515306,75515308,c,cca,2
NC_037340.1,NC_032662.1,74822127,75608644,75608645,G,GT,1
NC_037340.1,NC_032662.1,74854583,75641072,75641073,T,TG,1
NC_037340.1,NC_032662.1,74857904,75644392,75644393,G,GR,1
NC_037340.1,NC_032662.1,74865271,75651762,75651763,G,GS,1
NC_037340.1,NC_032662.1,74884521,75671017,75671077,G,GCCCTGCTGGCGTCTGCAGGGTGTTGGTGATAAGCAATGCCACCAAGTCATCGCAGGCGAT,60
NC_037340.1,NC_032662.1,74890489,75677046,75677047,C,CT,1
NC_037340.1,NC_032662.1,74979822,75766119,75766120,T,TA,1
NC_037340.1,NC_032662.1,75003324,75788949,75788950,c,ca,1
NC_037340.1,NC_032662.1,75004091,75789720,75789721,T,TK,1
NC_037340.1,NC_032662.1,75009498,75794613,75794614,t,ta,1
NC_037340.1,NC_032662.1,75030187,75815320,75815321,G,GA,1
NC_037340.1,NC_032662.1,75088816,75873583,75873584,C,CT,1
NC_037340.1,NC_032662.1,75174855,75961608,75961612,c,ctgag,4
NC_037340.1,NC_032662.1,75177006,75963950,75963951,T,TC,1
NC_037340.1,NC_032662.1,75179478,75966419,75966420,G,GR,1
NC_037340.1,NC_032662.1,75180380,75967323,75967324,G,GC,1
NC_037340.1,NC_032662.1,75186496,75973463,75973464,a,at,1
NC_037340.1,NC_032662.1,75192306,75979270,75979274,c,cttct,4
NC_037340.1,NC_032662.1,75200032,75987007,75987024,G,GTNNNNNNNNNNNNNNNN,17
NC_037340.1,NC_032662.1,75201383,75988375,75988376,T,TG,1
NC_037340.1,NC_032662.1,75201484,75988477,75988487,A,ACACTCGAGTG,10
NC_037340.1,NC_032662.1,75209878,75996834,75996899,c,ccttctcctgcatcTTCAGTCTATGTGGAAGATGAGAANNNNNNNNTCTGCTGAATTTAAACACct,65
NC_037340.1,NC_032662.1,75254360,76041383,76041384,C,CY,1
NC_037340.1,NC_032662.1,75254366,76041390,76041391,C,CT,1
NC_037340.1,NC_032662.1,75259205,76046247,76046248,g,ga,1
NC_037340.1,NC_032662.1,75259811,76046856,76046857,C,CT,1
NC_037340.1,NC_032662.1,75259999,76047045,76047049,t,tgata,4
NC_037340.1,NC_032662.1,75268843,76055898,76055899,A,AC,1
NC_037340.1,NC_032662.1,75304656,76091784,76091788,a,atgct,4
NC_037340.1,NC_032662.1,75304686,76091818,76091821,c,ctag,3
NC_037340.1,NC_032662.1,75318136,76105268,76105275,A,ACTAAATR,7
NC_037340.1,NC_032662.1,75361874,76149019,76149025,A,ACAAATG,6
NC_037340.1,NC_032662.1,75373080,76160230,76160231,t,ta,1
NC_037340.1,NC_032662.1,75396794,76184399,76184400,g,gc,1
NC_037340.1,NC_032662.1,75450036,76237650,76237651,A,AG,1
NC_037340.1,NC_032662.1,75463334,76250949,76250951,A,AAG,2
NC_037340.1,NC_032662.1,75482365,76269977,76269978,c,ca,1
NC_037340.1,NC_032662.1,75482398,76270011,76270012,t,tc,1
NC_037340.1,NC_032662.1,75482685,76270299,76270301,a,act,2
NC_037340.1,NC_032662.1,75488784,76276432,76276433,C,CY,1
NC_037340.1,NC_032662.1,75499704,76287354,76287357,a,attt,3
NC_037340.1,NC_032662.1,75614452,76407240,76407241,G,GT,1
NC_037340.1,NC_032662.1,75689431,76415143,76415144,t,ta,1
NC_037340.1,NC_032662.1,75737608,76598608,76598609,C,CG,1
NC_037340.1,NC_032662.1,75753345,76614360,76614361,c,ct,1
NC_037340.1,NC_032662.1,75773296,76634299,76634301,T,TTC,2
NC_037340.1,NC_032662.1,75785817,76646818,76646819,T,TG,1
NC_037340.1,NC_032662.1,75788653,76649657,76649660,g,ggtt,3
NC_037340.1,NC_032662.1,75810395,76671407,76671408,T,TK,1
NC_037340.1,NC_032662.1,75842924,76703999,76704000,T,TC,1
NC_037340.1,NC_032662.1,75922522,76849678,76849679,t,tc,1
NC_037340.1,NC_032662.1,75956005,76883776,76883777,C,CG,1
NC_037340.1,NC_032662.1,75970004,76897782,76897783,T,TC,1
NC_037340.1,NC_032662.1,75998076,76925887,76925889,t,taa,2
NC_037340.1,NC_032662.1,75998108,76925921,76925922,t,ta,1
NC_037340.1,NC_032662.1,76000662,76928476,76928477,a,at,1
NC_037340.1,NC_032662.1,76049130,76976479,76976485,c,ctttttt,6
NC_037340.1,NC_032662.1,76109756,77039403,77039404,G,GA,1
NC_037340.1,NC_032662.1,76126711,77056371,77056372,C,CT,1
NC_037340.1,NC_032662.1,76126967,77056628,77056629,C,CT,1
NC_037340.1,NC_032662.1,76159343,77088996,77088998,G,GCY,2
NC_037340.1,NC_032662.1,76185548,77115206,77115213,C,CGAGGAAY,7
NC_037340.1,NC_032662.1,76192039,77121081,77121082,T,TK,1
NC_037340.1,NC_032662.1,76463119,77391404,77391405,a,ac,1
NC_037340.1,NC_032662.1,76490375,77418991,77418992,T,TG,1
NC_037340.1,NC_032662.1,76602846,77621524,77621536,t,tccccaacccctg,12
NC_037340.1,NC_032662.1,76653426,77672076,77672077,t,tg,1
NC_037340.1,NC_032662.1,76656707,77675357,77675358,C,CM,1
NC_037340.1,NC_032662.1,76692344,77710998,77710999,G,GT,1
NC_037340.1,NC_032662.1,76692817,77711473,77711474,T,TC,1
NC_037340.1,NC_032662.1,76743423,77762098,77762099,a,ac,1
NC_037340.1,NC_032662.1,76770084,77788697,77788698,T,TC,1
NC_037340.1,NC_032662.1,76773235,77791850,77791851,G,GS,1
NC_037340.1,NC_032662.1,76806038,77824653,77824654,c,ct,1
NC_037340.1,NC_032662.1,76806234,77824850,77824851,c,cg,1
NC_037340.1,NC_032662.1,76808519,77827136,77827150,t,tattgactatgccaa,14
NC_037340.1,NC_032662.1,76856696,77875656,77875657,G,GR,1
NC_037340.1,NC_032662.1,76860321,77879282,77879285,C,CTTG,3
NC_037340.1,NC_032662.1,76876028,77895019,77895020,T,TA,1
NC_037340.1,NC_032662.1,76895816,77914814,77914815,C,CY,1
NC_037340.1,NC_032662.1,76940967,77960485,77960486,G,GS,1
NC_037340.1,NC_032662.1,77003920,78024266,78024267,G,GA,1
NC_037340.1,NC_032662.1,77150362,78170484,78170485,A,AR,1
NC_037340.1,NC_032662.1,77202218,78222356,78222364,t,tgttttttg,8
NC_037340.1,NC_032662.1,77210984,78231123,78231124,t,tK,1
NC_037340.1,NC_032662.1,77227702,78247525,78247526,G,GA,1
NC_037340.1,NC_032662.1,77231403,78251220,78251224,T,TCTGA,4
NC_037340.1,NC_032662.1,77236591,78256410,78256421,C,CTTCATCAAGGT,11
NC_037340.1,NC_032662.1,77259226,78279057,78279058,c,ca,1
NC_037340.1,NC_032662.1,77279486,78299320,78299321,C,CT,1
NC_037340.1,NC_032662.1,77294625,78314622,78314623,A,AC,1
NC_037340.1,NC_032662.1,77295955,78315953,78315963,C,CNNNNNNNNNN,10
NC_037340.1,NC_032662.1,77299272,78319173,78319174,a,ag,1
NC_037340.1,NC_032662.1,77308941,78328842,78328843,a,at,1
NC_037340.1,NC_032662.1,77535437,78562966,78562968,G,GGA,2
NC_037340.1,NC_032662.1,77546355,78573888,78573889,G,GR,1
NC_037340.1,NC_032662.1,77598429,78625979,78625980,G,GS,1
NC_037340.1,NC_032662.1,77601288,78628839,78628841,T,TTC,2
NC_037340.1,NC_032662.1,77604140,78631692,78631700,a,atatatatW,8
NC_037340.1,NC_032662.1,77604466,78632026,78632028,A,AAG,2
NC_037340.1,NC_032662.1,77606016,78633578,78633580,C,CRT,2
NC_037340.1,NC_032662.1,77608708,78636280,78636288,A,AATGTATTC,8
NC_037340.1,NC_032662.1,77716368,78744207,78744208,T,TY,1
NC_037340.1,NC_032662.1,77724977,78752824,78752828,t,tNNNN,4
NC_037340.1,NC_032662.1,77729358,78757265,78757267,G,GTC,2
NC_037340.1,NC_032662.1,77735543,78763456,78763458,t,tta,2
NC_037340.1,NC_032662.1,77743524,78771449,78771450,T,TK,1
NC_037340.1,NC_032662.1,77749920,78777851,78777852,g,ga,1
NC_037340.1,NC_032662.1,77753222,78781157,78781158,G,GY,1
NC_037340.1,NC_032662.1,77816864,78843793,78843795,a,att,2
NC_037340.1,NC_032662.1,78012605,79037268,79037269,T,TA,1
NC_037340.1,NC_032662.1,78030753,79055417,79055418,C,CM,1
NC_037340.1,NC_032662.1,78035960,79060625,79060626,A,AC,1
NC_037340.1,NC_032662.1,78055506,79080172,79080173,a,aN,1
NC_037340.1,NC_032662.1,78064744,79089410,79089412,g,gNN,2
NC_037340.1,NC_032662.1,78077920,79102592,79102593,C,CA,1
NC_037340.1,NC_032662.1,78077936,79102609,79102610,g,ga,1
NC_037340.1,NC_032662.1,78220596,81335422,81335423,t,tg,1
NC_037340.1,NC_032662.1,78220606,81335433,81335435,t,ttg,2
NC_037340.1,NC_032662.1,78220606,79240737,79240739,t,ttg,2
NC_037340.1,NC_032662.1,78230510,79250485,79250486,a,ag,1
NC_037340.1,NC_032662.1,78267444,79286848,79286849,t,tg,1
NC_037340.1,NC_032662.1,78656570,79685151,79685152,T,TC,1
NC_037340.1,NC_032662.1,78770799,79771797,79771798,C,CM,1
NC_037340.1,NC_032662.1,78849440,79850475,79850480,G,GATTAA,5
NC_037340.1,NC_032662.1,78942237,79942446,79942447,C,CT,1
NC_037340.1,NC_032662.1,79015648,80035092,80035096,c,catct,4
NC_037340.1,NC_032662.1,79022939,80042387,80042388,C,CY,1
NC_037340.1,NC_032662.1,79030470,80049919,80049920,C,CY,1
NC_037340.1,NC_032662.1,79037266,80056708,80056743,c,ctcttgagagtcccttggactgcaaggagatccaat,35
NC_037340.1,NC_032662.1,79044194,80063671,80063672,t,tK,1
NC_037340.1,NC_032662.1,79052636,80072116,80072117,T,TC,1
NC_037340.1,NC_032662.1,79053658,80073141,80073145,t,tatac,4
NC_037340.1,NC_032662.1,79061047,80080541,80080546,g,gtgttt,5
NC_037340.1,NC_032662.1,79062438,80081939,80081940,G,GC,1
NC_037340.1,NC_032662.1,79062996,80082498,80082500,C,CAG,2
NC_037340.1,NC_032662.1,79067315,80086772,80086776,g,gctgt,4
NC_037340.1,NC_032662.1,79069939,80089398,80089404,g,gtccctc,6
NC_037340.1,NC_032662.1,79071543,80091008,80091009,A,AT,1
NC_037340.1,NC_032662.1,79078881,80098346,80098347,G,GT,1
NC_037340.1,NC_032662.1,79093686,80113172,80113173,C,CM,1
NC_037340.1,NC_032662.1,79095450,80114937,80114938,C,CT,1
NC_037340.1,NC_032662.1,79101480,80120970,80120988,G,GTGTTGGAAGCCTGCTCCA,18
NC_037340.1,NC_032662.1,79121864,80141381,80141383,t,ttc,2
NC_037340.1,NC_032662.1,79124347,80143868,80143869,C,CA,1
NC_037340.1,NC_032662.1,79140849,80160426,80160427,T,TG,1
NC_037340.1,NC_032662.1,79167829,80187418,80187420,a,atg,2
NC_037340.1,NC_032662.1,79176062,80195654,80195655,C,CG,1
NC_037340.1,NC_032662.1,79222328,80242316,80242317,C,CG,1
NC_037340.1,NC_032662.1,79230146,80250094,80250095,C,CA,1
NC_037340.1,NC_032662.1,79265279,80283865,80283871,t,tacacac,6
NC_037340.1,NC_032662.1,79274173,80292764,80292765,A,AT,1
NC_037340.1,NC_032662.1,79274188,80292780,80292781,T,TA,1
NC_037340.1,NC_032662.1,79305662,80324247,80324248,C,CK,1
NC_037340.1,NC_032662.1,79311931,80330517,80330521,T,TCTCA,4
NC_037340.1,NC_032662.1,79329890,80348479,80348481,c,cca,2
NC_037340.1,NC_032662.1,79394900,80413496,80413497,A,AG,1
NC_037340.1,NC_032662.1,79424679,80443273,80443274,a,at,1
NC_037340.1,NC_032662.1,79458078,80476556,80476557,T,TG,1
NC_037340.1,NC_032662.1,79567158,80586550,80586551,C,CA,1
NC_037340.1,NC_032662.1,79574588,80593986,80593989,a,aagt,3
NC_037340.1,NC_032662.1,79578625,80598031,80598033,A,ATC,2
NC_037340.1,NC_032662.1,79592995,80612390,80612391,G,GA,1
NC_037340.1,NC_032662.1,79617193,80637273,80637274,C,CY,1
NC_037340.1,NC_032662.1,79696989,80717035,80717036,t,ta,1
NC_037340.1,NC_032662.1,79746074,80766317,80766318,C,CA,1
NC_037340.1,NC_032662.1,79746082,80766326,80766327,C,CG,1
NC_037340.1,NC_032662.1,79746098,80766343,80766345,C,CCT,2
NC_037340.1,NC_032662.1,79755674,80775921,80775923,G,GGC,2
NC_037340.1,NC_032662.1,79756727,80776974,80776975,a,ag,1
NC_037340.1,NC_032662.1,79808334,80828483,80828487,T,TCAGA,4
NC_037340.1,NC_032662.1,79809325,80829479,80829481,a,atc,2
NC_037340.1,NC_032662.1,79811319,80831475,80831480,C,CAGGGG,5
NC_037340.1,NC_032662.1,79816938,80837098,80837100,C,CTT,2
NC_037340.1,NC_032662.1,79824470,80844634,80844635,A,AN,1
NC_037340.1,NC_032662.1,79826183,80846346,80846347,c,ca,1
NC_037340.1,NC_032662.1,79849839,80870001,80870002,g,ga,1
NC_037340.1,NC_032662.1,79872119,80895799,80895800,A,AS,1
NC_037340.1,NC_032662.1,79936832,80960511,80960512,c,ct,1
NC_037340.1,NC_032662.1,80104627,81127844,81127845,C,CG,1
NC_037340.1,NC_032662.1,80106760,81129977,81129978,G,GA,1
NC_037340.1,NC_032662.1,80106768,81129986,81129987,C,CA,1
NC_037340.1,NC_032662.1,80106785,81130004,81130005,T,TA,1
NC_037340.1,NC_032662.1,80106795,81130015,81130016,C,CA,1
NC_037340.1,NC_032662.1,80141299,81164215,81164216,C,CA,1
NC_037340.1,NC_032662.1,80329884,81441309,81441310,G,GA,1
NC_037340.1,NC_032662.1,80364912,81476336,81476337,g,gc,1
NC_037340.1,NC_032662.1,80376648,81488091,81488098,g,gctcagcc,7
NC_037340.1,NC_032662.1,80377967,81489417,81489422,g,gatctc,5
NC_037340.1,NC_032662.1,80418582,81530037,81530038,A,AC,1
NC_037340.1,NC_032662.1,80424014,81535415,81535422,G,GAAACAGA,7
NC_037340.1,NC_032662.1,80434332,81545739,81545741,a,atg,2
NC_037340.1,NC_032662.1,80557972,81667553,81667554,G,GW,1
NC_037340.1,NC_032662.1,80577693,81687277,81687278,C,CG,1
NC_037340.1,NC_032662.1,80729620,81839419,81839420,c,ca,1
NC_037340.1,NC_032662.1,80833122,81943586,81943589,t,tagc,3
NC_037340.1,NC_032662.1,80838737,81949205,81949206,C,CA,1
NC_037340.1,NC_032662.1,80949278,82057951,82057952,A,AT,1
NC_037340.1,NC_032662.1,80950658,82059331,82059333,G,GAN,2
NC_037340.1,NC_032662.1,80964990,82073582,82073583,A,AR,1
NC_037340.1,NC_032662.1,81001760,82110356,82110358,a,acg,2
NC_037340.1,NC_032662.1,81111338,82219956,82219959,g,gggc,3
NC_037340.1,NC_032662.1,81115284,82224088,82224092,A,AAGTC,4
NC_037340.1,NC_032662.1,81173262,82281603,82281604,c,ct,1
NC_037340.1,NC_032662.1,81173284,82281626,82281627,c,ct,1
NC_037340.1,NC_032662.1,81196653,82305354,82305356,g,gca,2
NC_037340.1,NC_032662.1,81200001,82308705,82308716,T,TATTCAGAGCCA,11
NC_037340.1,NC_032662.1,81204990,82313708,82313709,C,CA,1
NC_037340.1,NC_032662.1,81254329,82363029,82363030,A,AM,1
NC_037340.1,NC_032662.1,81274120,82382816,82382817,c,ca,1
NC_037340.1,NC_032662.1,81274142,82382839,82382840,g,ga,1
NC_037340.1,NC_032662.1,81274156,82382854,82382855,g,ga,1
NC_037340.1,NC_032662.1,81284200,82392752,82392760,g,gcacacaca,8
NC_037340.1,NC_032662.1,81411105,82519709,82519710,g,gt,1
NC_037340.1,NC_032662.1,81522791,82631340,82631341,g,gc,1
NC_037340.1,NC_032662.1,81550403,82658858,82658865,C,CACCCCCS,7
NC_037340.1,NC_032662.1,81557806,82666268,82666269,C,CT,1
NC_037340.1,NC_032662.1,81557844,82666307,82666308,T,TW,1
NC_037340.1,NC_032662.1,81561016,82669480,82669482,C,CAG,2
NC_037340.1,NC_032662.1,81563692,82672158,82672160,A,ACT,2
NC_037340.1,NC_032662.1,81635169,82743442,82743443,A,AT,1
NC_037340.1,NC_032662.1,81646540,82754812,82754813,C,CT,1
NC_037340.1,NC_032662.1,81656873,82764993,82764994,c,ca,1
NC_037340.1,NC_032662.1,81660535,82768656,82768658,C,CAT,2
NC_037340.1,NC_032662.1,81664105,82772228,82772229,A,AC,1
NC_037340.1,NC_032662.1,81702206,82809775,82809776,c,cg,1
NC_037340.1,NC_032662.1,81702285,82809855,82809856,A,AG,1
NC_037340.1,NC_032662.1,81734505,82842083,82842086,t,taca,3
NC_037340.1,NC_032662.1,81737265,82844846,82844847,c,ct,1
NC_037340.1,NC_032662.1,81749248,82856833,82856834,C,CT,1
NC_037340.1,NC_032662.1,81755903,82863488,82863490,a,aat,2
NC_037340.1,NC_032662.1,81769338,82876954,82876963,c,cgtctcctgt,9
NC_037340.1,NC_032662.1,81817302,82984517,82984519,a,atc,2
NC_037340.1,NC_032662.1,81817511,82984728,82984729,t,tK,1
NC_037340.1,NC_032662.1,81862306,83027387,83027389,a,act,2
NC_037340.1,NC_032662.1,82181693,83130813,83130814,c,ca,1
NC_037340.1,NC_032662.1,82184359,83133505,83133506,T,TY,1
NC_037340.1,NC_032662.1,82186019,83135163,83135165,A,AAC,2
NC_037340.1,NC_032662.1,82189855,83139002,83139003,T,TY,1
NC_037340.1,NC_032662.1,82215145,83164290,83164291,A,AT,1
NC_037340.1,NC_032662.1,82220986,83170132,83170137,a,agttgc,5
NC_037340.1,NC_032662.1,82255134,83205686,83205687,A,AR,1
NC_037340.1,NC_032662.1,82261029,83211580,83211581,g,gt,1
NC_037340.1,NC_032662.1,82273055,83223139,83223140,G,GC,1
NC_037340.1,NC_032662.1,82296325,83246415,83246416,G,GC,1
NC_037340.1,NC_032662.1,82296734,83246825,83246826,G,GC,1
NC_037340.1,NC_032662.1,82296931,83247023,83247088,C,CGTCAGGGCCCGGCGCNNNNNNNNNNNNNNNNNNNNNNNNNNNNNTTTTAGGATGAAAGCTTTGGA,65
NC_037340.1,NC_032662.1,82303287,83253418,83253423,c,cttctY,5
NC_037340.1,NC_032662.1,82309183,83259395,83259397,A,ACC,2
NC_037340.1,NC_032662.1,82324453,83274590,83274593,G,GTTK,3
NC_037340.1,NC_032662.1,82325644,83275791,83275793,C,CAG,2
NC_037340.1,NC_032662.1,82328697,83278736,83278737,G,GR,1
NC_037340.1,NC_032662.1,82359547,83309544,83309545,g,gt,1
NC_037340.1,NC_032662.1,82359646,83309644,83309681,g,ggttattgatgtatctgaggttattgatatttctccca,37
NC_037340.1,NC_032662.1,82425394,83422496,83422497,A,AM,1
NC_037340.1,NC_032662.1,82462708,83459424,83459443,T,TGATGGACATATANNNNNNN,19
NC_037340.1,NC_032662.1,82477300,83474184,83474185,C,CY,1
NC_037340.1,NC_032662.1,82485542,83482423,83482424,G,GC,1
NC_037340.1,NC_032662.1,82494469,83491478,83491479,g,ga,1
NC_037340.1,NC_032662.1,82495587,83492593,83492594,G,GC,1
NC_037340.1,NC_032662.1,82497250,83494232,83494233,t,tg,1
NC_037340.1,NC_032662.1,82504327,83501072,83501073,G,GT,1
NC_037340.1,NC_032662.1,82521141,83519100,83519101,t,ta,1
NC_037340.1,NC_032662.1,82528128,83526170,83526171,c,ca,1
NC_037340.1,NC_032662.1,82533788,83531832,83531834,t,tMA,2
NC_037340.1,NC_032662.1,82537936,83535987,83535997,c,catatatgtat,10
NC_037340.1,NC_032662.1,82539282,83537344,83537345,A,AT,1
NC_037340.1,NC_032662.1,82545568,83543284,83543287,C,CAGG,3
NC_037340.1,NC_032662.1,82549587,83547290,83547321,T,TCACATCCCAGGAAGGCTTCCAAGGCGGCCAG,31
NC_037340.1,NC_032662.1,82558862,83556593,83556594,A,AR,1
NC_037340.1,NC_032662.1,82577201,83575470,83575471,c,ct,1
NC_037340.1,NC_032662.1,82580223,83578903,83578904,A,AG,1
NC_037340.1,NC_032662.1,82586414,83585002,83585003,C,CS,1
NC_037340.1,NC_032662.1,82708456,83707255,83707256,T,TY,1
NC_037340.1,NC_032662.1,82764644,83763426,83763427,a,aT,1
NC_037340.1,NC_032662.1,82767386,83766169,83766173,t,taaaa,4
NC_037340.1,NC_032662.1,82775152,83773941,83773942,T,TA,1
NC_037340.1,NC_032662.1,82781323,83780113,83780114,A,AW,1
NC_037340.1,NC_032662.1,82782065,83780855,83780856,A,AR,1
NC_037340.1,NC_032662.1,82791183,83789975,83789976,C,CS,1
NC_037340.1,NC_032662.1,82820788,83819517,83819518,G,GC,1
NC_037340.1,NC_032662.1,82857363,83840644,83840646,G,GGA,2
NC_037340.1,NC_032662.1,82898838,83882301,83882302,T,TC,1
NC_037340.1,NC_032662.1,82914895,83898525,83898526,G,GR,1
NC_037340.1,NC_032662.1,82916913,83900543,83900544,G,GT,1
NC_037340.1,NC_032662.1,82933802,83917794,83917797,a,aaaR,3
NC_037340.1,NC_032662.1,82937597,83921510,83921511,C,CT,1
NC_037340.1,NC_032662.1,82943808,83927719,83927721,A,AAT,2
NC_037340.1,NC_032662.1,82945195,83929108,83929121,C,CCTCAAAAAACTTS,13
NC_037340.1,NC_032662.1,82945487,83929413,83929414,A,AG,1
NC_037340.1,NC_032662.1,82951743,83935670,83935671,G,GS,1
NC_037340.1,NC_032662.1,82962431,83946360,83946361,t,tg,1
NC_037340.1,NC_032662.1,82978157,83962092,83962093,A,AG,1
NC_037340.1,NC_032662.1,83066968,84050836,84050837,t,ta,1
NC_037340.1,NC_032662.1,83067009,84050878,84050880,t,taa,2
NC_037340.1,NC_032662.1,83093664,84077535,84077537,A,AWG,2
NC_037340.1,NC_032662.1,83094254,84078127,84078128,g,gt,1
NC_037340.1,NC_032662.1,83101368,84085242,84085243,C,CT,1
NC_037340.1,NC_032662.1,83117186,84101073,84101075,A,AAC,2
NC_037340.1,NC_032662.1,83166477,84150410,84150411,a,at,1
NC_037340.1,NC_032662.1,83223415,84207205,84207206,a,ag,1
NC_037340.1,NC_032662.1,83247276,84231068,84231069,g,ga,1
NC_037340.1,NC_032662.1,83328909,84311224,84311225,T,TK,1
NC_037340.1,NC_032662.1,83355494,84337843,84337844,C,CG,1
NC_037340.1,NC_032662.1,83383865,84366215,84366220,C,CAGCCA,5
