Reference ID,Query ID,Reference POS,Query POS,Query END,REF,ALT,SVLEN
NC_037351.1,NC_032673.1,322347,35268,35269,t,ta,1
NC_037351.1,NC_032673.1,415770,128608,128610,T,TCA,2
NC_037351.1,NC_032673.1,429757,142733,142742,a,acactgtttc,9
NC_037351.1,NC_032673.1,430034,143018,143019,c,ca,1
NC_037351.1,NC_032673.1,456941,169929,169930,a,at,1
NC_037351.1,NC_032673.1,557188,266395,266396,C,CA,1
NC_037351.1,NC_032673.1,573883,283086,283114,T,TCAGGGTCAATTGGAGGGCCATCCAGGAC,28
NC_037351.1,NC_032673.1,615384,299236,299239,c,ccca,3
NC_037351.1,NC_032673.1,616874,300738,300741,C,CAGG,3
NC_037351.1,NC_032673.1,801226,539176,539177,T,TC,1
NC_037351.1,NC_032673.1,810662,548615,548630,G,GGCATGGAGCTNNNNN,15
NC_037351.1,NC_032673.1,916494,649494,649495,A,AC,1
NC_037351.1,NC_032673.1,1088015,821108,821109,a,at,1
NC_037351.1,NC_032673.1,1264365,1004882,1004883,T,TG,1
NC_037351.1,NC_032673.1,1264486,1005003,1005005,T,TTG,2
NC_037351.1,NC_032673.1,1357846,1098318,1098341,a,agaggctttttagttcctcttcac,23
NC_037351.1,NC_032673.1,1453634,1194140,1194141,T,TC,1
NC_037351.1,NC_032673.1,1495804,1236771,1236772,A,AG,1
NC_037351.1,NC_032673.1,1495804,1328607,1328608,A,AG,1
NC_037351.1,NC_032673.1,1512757,1345577,1345578,t,tN,1
NC_037351.1,NC_032673.1,1516486,1349307,1349308,A,AC,1
NC_037351.1,NC_032673.1,1516486,1257268,1257269,A,AC,1
NC_037351.1,NC_032673.1,1598841,1431702,1431703,C,CY,1
NC_037351.1,NC_032673.1,1613478,1446689,1446690,C,CG,1
NC_037351.1,NC_032673.1,1621068,1454355,1454357,c,cag,2
NC_037351.1,NC_032673.1,1629449,1462732,1462736,C,CCAGT,4
NC_037351.1,NC_032673.1,1630044,1463330,1463331,c,ca,1
NC_037351.1,NC_032673.1,1669088,1502520,1502537,C,CACTAGGACACCCTGCCT,17
NC_037351.1,NC_032673.1,1671147,1504598,1504600,t,taa,2
NC_037351.1,NC_032673.1,1687635,1521129,1521130,G,GK,1
NC_037351.1,NC_032673.1,1709831,1543162,1543163,G,GA,1
NC_037351.1,NC_032673.1,1842264,1714904,1714906,a,aNN,2
NC_037351.1,NC_032673.1,1845521,1624984,1624985,c,cg,1
NC_037351.1,NC_032673.1,1856772,1729417,1729419,t,tta,2
NC_037351.1,NC_032673.1,1879788,1752434,1752435,G,GR,1
NC_037351.1,NC_032673.1,2023798,1816144,1816145,A,AT,1
NC_037351.1,NC_032673.1,2072500,1866796,1866799,T,TATC,3
NC_037351.1,NC_032673.1,2135207,1929186,1929209,T,TCCAGCCTGTCCCTCACGAAGGCG,23
NC_037351.1,NC_032673.1,2240195,2034650,2034651,G,GC,1
NC_037351.1,NC_032673.1,2243261,2037717,2037718,C,CA,1
NC_037351.1,NC_032673.1,2252417,2046876,2046879,A,ACCG,3
NC_037351.1,NC_032673.1,2256238,2050697,2050698,T,TY,1
NC_037351.1,NC_032673.1,2272183,2066648,2066657,g,gagtcggtca,9
NC_037351.1,NC_032673.1,2272521,2066995,2066997,t,tNN,2
NC_037351.1,NC_032673.1,2275490,2069964,2069965,a,ac,1
NC_037351.1,NC_032673.1,2295726,2090187,2090188,C,CY,1
NC_037351.1,NC_032673.1,2296731,2091193,2091194,T,TG,1
NC_037351.1,NC_032673.1,2316980,2111443,2111444,G,GC,1
NC_037351.1,NC_032673.1,2317721,2112185,2112186,G,GR,1
NC_037351.1,NC_032673.1,2420181,2212603,2212604,a,ac,1
NC_037351.1,NC_032673.1,2446614,2238928,2238930,T,TNN,2
NC_037351.1,NC_032673.1,2456615,2285213,2285217,t,tacaa,4
NC_037351.1,NC_032673.1,2503205,2334480,2334484,C,CTTTT,4
NC_037351.1,NC_032673.1,2551603,2382850,2382851,G,GC,1
NC_037351.1,NC_032673.1,2573772,2404432,2404435,T,TCTC,3
NC_037351.1,NC_032673.1,2700744,2530612,2530625,g,gtcatgtccaactc,13
NC_037351.1,NC_032673.1,2789260,2619013,2619015,g,gaa,2
NC_037351.1,NC_032673.1,2789679,2619434,2619435,C,CT,1
NC_037351.1,NC_032673.1,2803566,2633530,2633532,g,gaa,2
NC_037351.1,NC_032673.1,2820702,2650674,2650675,c,cY,1
NC_037351.1,NC_032673.1,2825378,2655351,2655352,A,AW,1
NC_037351.1,NC_032673.1,2879918,2709839,2709840,c,ct,1
NC_037351.1,NC_032673.1,2883960,2713926,2713927,A,AW,1
NC_037351.1,NC_032673.1,2886549,2716517,2716528,T,TTGTTAAATTAC,11
NC_037351.1,NC_032673.1,2910338,2740003,2740004,a,at,1
NC_037351.1,NC_032673.1,2981703,2811377,2811378,T,TA,1
NC_037351.1,NC_032673.1,2981709,2811384,2811385,G,GA,1
NC_037351.1,NC_032673.1,3016000,2845652,2845653,t,tc,1
NC_037351.1,NC_032673.1,3020874,2850527,2850529,T,TTG,2
NC_037351.1,NC_032673.1,3167296,2996674,2996675,C,CG,1
NC_037351.1,NC_032673.1,3410719,3265812,3265813,A,AR,1
NC_037351.1,NC_032673.1,3435498,3290597,3290598,A,AG,1
NC_037351.1,NC_032673.1,3460552,3315652,3315653,A,AT,1
NC_037351.1,NC_032673.1,3461343,3316444,3316445,C,CA,1
NC_037351.1,NC_032673.1,3504385,3359549,3359550,T,TC,1
NC_037351.1,NC_032673.1,3588548,3484847,3484848,A,AG,1
NC_037351.1,NC_032673.1,3625335,3521644,3521645,C,CA,1
NC_037351.1,NC_032673.1,3636653,3532969,3532970,G,GC,1
NC_037351.1,NC_032673.1,3639986,3536303,3536304,A,AG,1
NC_037351.1,NC_032673.1,3640069,3536387,3536388,C,CY,1
NC_037351.1,NC_032673.1,3658607,3554926,3554929,C,CAAT,3
NC_037351.1,NC_032673.1,3659112,3555434,3555435,C,CA,1
NC_037351.1,NC_032673.1,3664581,3560907,3560908,G,GA,1
NC_037351.1,NC_032673.1,3668447,3564785,3564788,t,taaa,3
NC_037351.1,NC_032673.1,3682062,3579265,3579266,g,ga,1
NC_037351.1,NC_032673.1,3722221,3631715,3631716,g,ga,1
NC_037351.1,NC_032673.1,3749730,3659223,3659224,C,CW,1
NC_037351.1,NC_032673.1,3770629,3680123,3680125,T,TTC,2
NC_037351.1,NC_032673.1,3883490,3792929,3792930,A,AT,1
NC_037351.1,NC_032673.1,3953581,3862868,3862869,t,ta,1
NC_037351.1,NC_032673.1,4004192,3912351,3912352,G,GA,1
NC_037351.1,NC_032673.1,4161763,4075991,4075992,T,TC,1
NC_037351.1,NC_032673.1,4162317,4076546,4076547,T,TG,1
NC_037351.1,NC_032673.1,4224895,4141922,4141923,T,TK,1
NC_037351.1,NC_032673.1,4253142,4170166,4170167,G,GC,1
NC_037351.1,NC_032673.1,4253148,4170173,4170174,G,GA,1
NC_037351.1,NC_032673.1,4282182,4199436,4199439,g,gtgt,3
NC_037351.1,NC_032673.1,4302885,4220144,4220145,t,ta,1
NC_037351.1,NC_032673.1,4302911,4220171,4220172,t,ta,1
NC_037351.1,NC_032673.1,4309930,4227223,4227236,A,AATTCCCTCCAGAC,13
NC_037351.1,NC_032673.1,4385233,4289592,4289593,A,AR,1
NC_037351.1,NC_032673.1,4392741,4297074,4297075,t,tc,1
NC_037351.1,NC_032673.1,4392858,4297191,4297192,t,tc,1
NC_037351.1,NC_032673.1,4398048,4302381,4302382,A,AG,1
NC_037351.1,NC_032673.1,4398336,4302673,4302674,A,AG,1
NC_037351.1,NC_032673.1,4398691,4303029,4303030,T,TA,1
NC_037351.1,NC_032673.1,4399151,4303490,4303491,T,TG,1
NC_037351.1,NC_032673.1,4419445,4323631,4323632,C,CA,1
NC_037351.1,NC_032673.1,4480822,4387419,4387423,a,aaaNN,4
NC_037351.1,NC_032673.1,4483510,4390111,4390126,c,cacttGGGGTGACCNN,15
NC_037351.1,NC_032673.1,4511279,4417845,4417846,T,TA,1
NC_037351.1,NC_032673.1,4522666,4429233,4429234,C,CT,1
NC_037351.1,NC_032673.1,4618532,4525095,4525099,C,CGACT,4
NC_037351.1,NC_032673.1,4618743,4525309,4525310,A,AG,1
NC_037351.1,NC_032673.1,4626641,4533204,4533208,t,tgtaa,4
NC_037351.1,NC_032673.1,4632097,4538663,4538664,a,ac,1
NC_037351.1,NC_032673.1,4634492,4541057,4541059,A,AAG,2
NC_037351.1,NC_032673.1,4636040,4542609,4542610,A,AT,1
NC_037351.1,NC_032673.1,4661461,4568035,4568036,a,aN,1
NC_037351.1,NC_032673.1,4662133,4568708,4568709,g,gt,1
NC_037351.1,NC_032673.1,4676030,4582610,4582611,a,ag,1
NC_037351.1,NC_032673.1,4707623,4617382,4617383,a,ac,1
NC_037351.1,NC_032673.1,4713689,4623450,4623451,A,AG,1
NC_037351.1,NC_032673.1,4713955,4623718,4623719,A,AG,1
NC_037351.1,NC_032673.1,4747058,4656825,4656828,t,taTA,3
NC_037351.1,NC_032673.1,4750605,4660375,4660376,t,ta,1
NC_037351.1,NC_032673.1,4768592,4678370,4678371,a,at,1
NC_037351.1,NC_032673.1,4776652,4686431,4686432,C,CM,1
NC_037351.1,NC_032673.1,4777504,4687284,4687291,t,ttttttta,7
NC_037351.1,NC_032673.1,4792728,4702520,4702521,T,TG,1
NC_037351.1,NC_032673.1,4795179,4704973,4704974,t,tc,1
NC_037351.1,NC_032673.1,4796069,4705865,4705866,t,ta,1
NC_037351.1,NC_032673.1,4796097,4705894,4705895,t,ta,1
NC_037351.1,NC_032673.1,4796869,4706655,4706657,g,gat,2
NC_037351.1,NC_032673.1,4800483,4710271,4710272,a,aN,1
NC_037351.1,NC_032673.1,4835962,4864589,4864593,t,tgtga,4
NC_037351.1,NC_032673.1,4846567,4875199,4875202,t,tctc,3
NC_037351.1,NC_032673.1,4857105,4767164,4767165,a,aN,1
NC_037351.1,NC_032673.1,4875414,4903943,4903944,c,ca,1
NC_037351.1,NC_032673.1,4875722,4904252,4904253,a,ag,1
NC_037351.1,NC_032673.1,4875991,4904522,4904524,a,aat,2
NC_037351.1,NC_032673.1,4882683,4784780,4784795,T,TTATTACTGCTGGTGA,15
NC_037351.1,NC_032673.1,4882683,4911857,4911872,T,TTATTACTGCTGGTGA,15
NC_037351.1,NC_032673.1,4891420,4793532,4793534,A,AAG,2
NC_037351.1,NC_032673.1,4891420,4920609,4920611,A,AAG,2
NC_037351.1,NC_032673.1,4902798,4931989,4931990,G,GA,1
NC_037351.1,NC_032673.1,4946158,4971818,4971820,c,caa,2
NC_037351.1,NC_032673.1,4959234,4985187,4985188,c,cg,1
NC_037351.1,NC_032673.1,4960022,4985976,4985977,C,CT,1
NC_037351.1,NC_032673.1,4960045,4986000,4986001,A,AG,1
NC_037351.1,NC_032673.1,4960082,4986040,4986041,a,ac,1
NC_037351.1,NC_032673.1,4960102,4986061,4986062,c,ca,1
NC_037351.1,NC_032673.1,4964729,4990684,4990686,T,TTS,2
NC_037351.1,NC_032673.1,5002037,5029419,5029420,G,GA,1
NC_037351.1,NC_032673.1,5060865,5088292,5088293,a,ac,1
NC_037351.1,NC_032673.1,5098564,5126002,5126004,c,cat,2
NC_037351.1,NC_032673.1,5107687,5135128,5135133,g,gtgtgt,5
NC_037351.1,NC_032673.1,5115123,5142569,5142596,A,AGCACCTACTANNNNNNNNNNNNNNNNN,27
NC_037351.1,NC_032673.1,5119172,5146642,5146643,a,aR,1
NC_037351.1,NC_032673.1,5157322,5184793,5184811,a,atgtgtgtgtgtgtgtgtg,18
NC_037351.1,NC_032673.1,5193722,5221238,5221239,c,ca,1
NC_037351.1,NC_032673.1,5204708,5232173,5232174,T,TK,1
NC_037351.1,NC_032673.1,5237164,5265298,5265299,T,TA,1
NC_037351.1,NC_032673.1,5237174,5265309,5265310,A,AG,1
NC_037351.1,NC_032673.1,5237187,5265323,5265324,C,CA,1
NC_037351.1,NC_032673.1,5254619,5282762,5282763,C,CG,1
NC_037351.1,NC_032673.1,5254619,5367071,5367072,C,CA,1
NC_037351.1,NC_032673.1,5259358,5287502,5287503,c,ct,1
NC_037351.1,NC_032673.1,5317748,5430210,5430211,C,CN,1
NC_037351.1,NC_032673.1,5334841,5447301,5447305,c,cttag,4
NC_037351.1,NC_032673.1,5335037,5447501,5447502,g,ga,1
NC_037351.1,NC_032673.1,5335329,5447794,5447797,T,TCTC,3
NC_037351.1,NC_032673.1,5350448,5462919,5462921,t,taa,2
NC_037351.1,NC_032673.1,5372137,5603604,5603610,c,cttcact,6
NC_037351.1,NC_032673.1,5377556,5609029,5609030,T,TC,1
NC_037351.1,NC_032673.1,5399566,5631043,5631045,T,TTG,2
NC_037351.1,NC_032673.1,5402956,5634434,5634435,t,tg,1
NC_037351.1,NC_032673.1,5540896,5767751,5767754,t,taaa,3
NC_037351.1,NC_032673.1,5546636,5773500,5773504,A,AACTG,4
NC_037351.1,NC_032673.1,5602709,5829599,5829605,a,aaNNNNN,6
NC_037351.1,NC_032673.1,5622120,5849019,5849020,C,CT,1
NC_037351.1,NC_032673.1,5622166,5849066,5849067,G,GC,1
NC_037351.1,NC_032673.1,5627363,5854223,5854224,T,TW,1
NC_037351.1,NC_032673.1,5632721,5859581,5859599,g,gtaaacaatctgcctgcaa,18
NC_037351.1,NC_032673.1,5660098,5886978,5886979,T,TK,1
NC_037351.1,NC_032673.1,5661130,5888011,5888012,C,CY,1
NC_037351.1,NC_032673.1,5701300,5928263,5928265,A,AAC,2
NC_037351.1,NC_032673.1,5740893,5968146,5968177,A,ATATTTTACtacatattttacatacataaaaT,31
NC_037351.1,NC_032673.1,5741533,5968818,5968820,a,att,2
NC_037351.1,NC_032673.1,5746257,5973606,5973612,a,aaaaaag,6
NC_037351.1,NC_032673.1,5824013,6051407,6051408,c,ct,1
NC_037351.1,NC_032673.1,5848654,6076053,6076054,g,gc,1
NC_037351.1,NC_032673.1,5950393,6177800,6177802,t,tta,2
NC_037351.1,NC_032673.1,6012253,6240568,6240569,A,AC,1
NC_037351.1,NC_032673.1,6039687,6267967,6267969,a,aNN,2
NC_037351.1,NC_032673.1,6094137,6321737,6321738,a,ac,1
NC_037351.1,NC_032673.1,6114763,6342341,6342342,a,ag,1
NC_037351.1,NC_032673.1,6166520,6390872,6390873,a,at,1
NC_037351.1,NC_032673.1,6276552,6500704,6500706,g,ggc,2
NC_037351.1,NC_032673.1,6276567,6500721,6500722,a,ag,1
NC_037351.1,NC_032673.1,6522710,6767227,6767236,c,caataGTNNN,9
NC_037351.1,NC_032673.1,6527025,6771560,6771573,A,AAAATATAACTTAT,13
NC_037351.1,NC_032673.1,6678052,6922608,6922609,t,tc,1
NC_037351.1,NC_032673.1,6921737,7030357,7030358,t,tc,1
NC_037351.1,NC_032673.1,7221375,7325629,7325630,C,CA,1
NC_037351.1,NC_032673.1,7221384,7325639,7325640,G,GA,1
NC_037351.1,NC_032673.1,7221394,7325650,7325651,G,GC,1
NC_037351.1,NC_032673.1,7221421,7325678,7325679,G,GS,1
NC_037351.1,NC_032673.1,7238713,7342974,7342975,a,at,1
NC_037351.1,NC_032673.1,7377455,7481581,7481583,t,ttg,2
NC_037351.1,NC_032673.1,7380186,7484315,7484321,c,cacataY,6
NC_037351.1,NC_032673.1,7380564,7484699,7484700,C,CT,1
NC_037351.1,NC_032673.1,7381300,7485436,7485437,C,CA,1
NC_037351.1,NC_032673.1,7396907,7501077,7501101,g,ggatcCCCATCCCAACGTGCCTNNN,24
NC_037351.1,NC_032673.1,7449873,7554076,7554078,G,GAC,2
NC_037351.1,NC_032673.1,7472611,7576919,7576920,a,ac,1
NC_037351.1,NC_032673.1,7475126,7579443,7579452,G,GGCCCTTCCC,9
NC_037351.1,NC_032673.1,7514153,7618383,7618384,T,TY,1
NC_037351.1,NC_032673.1,7534907,7639210,7639216,t,tNNNNNN,6
NC_037351.1,NC_032673.1,7616533,7720905,7720906,A,AG,1
NC_037351.1,NC_032673.1,7660932,7934278,7934280,A,ACR,2
NC_037351.1,NC_032673.1,7916605,8149931,8149933,c,ctt,2
NC_037351.1,NC_032673.1,7942008,8178549,8178550,c,ct,1
NC_037351.1,NC_032673.1,7942124,8178666,8178669,a,attc,3
NC_037351.1,NC_032673.1,7961438,8197989,8197990,t,tc,1
NC_037351.1,NC_032673.1,7961906,8198459,8198462,g,gcac,3
NC_037351.1,NC_032673.1,7965302,8201859,8201863,C,CCTCA,4
NC_037351.1,NC_032673.1,7981055,8217614,8217617,t,tagc,3
NC_037351.1,NC_032673.1,7990618,8227184,8227185,T,TG,1
NC_037351.1,NC_032673.1,7990977,8227544,8227545,t,tc,1
NC_037351.1,NC_032673.1,8000543,8240499,8240501,a,agT,2
NC_037351.1,NC_032673.1,8003955,8243915,8243916,T,TY,1
NC_037351.1,NC_032673.1,8014068,8254030,8254031,a,at,1
NC_037351.1,NC_032673.1,8025792,8268297,8268300,g,gtta,3
NC_037351.1,NC_032673.1,8057935,8300446,8300447,A,AC,1
NC_037351.1,NC_032673.1,8073112,8315644,8315649,A,AGAAAG,5
NC_037351.1,NC_032673.1,8091359,8333767,8333768,A,AG,1
NC_037351.1,NC_032673.1,8093451,8335856,8335859,a,acac,3
NC_037351.1,NC_032673.1,8166170,8408601,8408602,c,ct,1
NC_037351.1,NC_032673.1,8182559,8424893,8424894,t,ta,1
NC_037351.1,NC_032673.1,8187019,8429358,8429359,t,tg,1
NC_037351.1,NC_032673.1,8189033,8431375,8431376,C,CG,1
NC_037351.1,NC_032673.1,8189043,8431386,8431387,A,AR,1
NC_037351.1,NC_032673.1,8192315,8434659,8434660,A,AR,1
NC_037351.1,NC_032673.1,8202407,8444751,8444752,G,GK,1
NC_037351.1,NC_032673.1,8209883,8452228,8452229,t,ta,1
NC_037351.1,NC_032673.1,8219429,8462581,8462582,t,tg,1
NC_037351.1,NC_032673.1,8343798,8585596,8585597,a,aN,1
NC_037351.1,NC_032673.1,8393998,8687872,8687879,g,ggtttttt,7
NC_037351.1,NC_032673.1,8450679,8743286,8743287,g,gC,1
NC_037351.1,NC_032673.1,8521414,8813879,8813880,c,ct,1
NC_037351.1,NC_032673.1,8551819,8844298,8844301,C,CTCA,3
NC_037351.1,NC_032673.1,8554617,8847093,8847094,g,gt,1
NC_037351.1,NC_032673.1,8560065,8852542,8852543,T,TA,1
NC_037351.1,NC_032673.1,8560392,8852870,8852871,G,GT,1
NC_037351.1,NC_032673.1,8597494,8908352,8908355,c,caga,3
NC_037351.1,NC_032673.1,8597542,8908403,8908404,t,tg,1
NC_037351.1,NC_032673.1,8684200,9043092,9043094,c,cag,2
NC_037351.1,NC_032673.1,8684483,9043377,9043384,a,atttcttt,7
NC_037351.1,NC_032673.1,8685527,9044428,9044429,g,gc,1
NC_037351.1,NC_032673.1,8685746,9044648,9044650,g,gga,2
NC_037351.1,NC_032673.1,8720454,9081859,9081861,a,aNN,2
NC_037351.1,NC_032673.1,8745754,9107162,9107163,g,gc,1
NC_037351.1,NC_032673.1,8785829,9147243,9147244,t,tg,1
NC_037351.1,NC_032673.1,9045323,9425697,9425698,T,TA,1
NC_037351.1,NC_032673.1,9096893,9478506,9478508,t,tNN,2
NC_037351.1,NC_032673.1,9122429,9504046,9504047,c,cg,1
NC_037351.1,NC_032673.1,9122479,9504097,9504098,a,ag,1
NC_037351.1,NC_032673.1,9152760,9534635,9534637,a,aNN,2
NC_037351.1,NC_032673.1,9267155,9651264,9651265,a,at,1
NC_037351.1,NC_032673.1,9284786,9670004,9670014,a,actgatctgat,10
NC_037351.1,NC_032673.1,9284871,9670099,9670103,C,CGTGT,4
NC_037351.1,NC_032673.1,9288719,9673951,9673952,a,ag,1
NC_037351.1,NC_032673.1,9294272,9679505,9679506,a,at,1
NC_037351.1,NC_032673.1,9626686,10039323,10039329,G,GACGNNN,6
NC_037351.1,NC_032673.1,9680503,10090788,10090792,A,ATCTC,4
NC_037351.1,NC_032673.1,9709941,10120208,10120210,g,gca,2
NC_037351.1,NC_032673.1,9882774,10334547,10334549,a,aNN,2
NC_037351.1,NC_032673.1,9910732,10362508,10362509,t,tg,1
NC_037351.1,NC_032673.1,10028611,10481129,10481131,A,AAG,2
NC_037351.1,NC_032673.1,10034428,10491788,10491789,c,ct,1
NC_037351.1,NC_032673.1,10111662,10569359,10569360,c,ct,1
NC_037351.1,NC_032673.1,10156850,10614550,10614551,g,gc,1
NC_037351.1,NC_032673.1,10168739,10638324,10638345,A,ATTNNNNNNNNNNNNNNNNNNN,21
NC_037351.1,NC_032673.1,10172336,10642423,10642424,a,at,1
NC_037351.1,NC_032673.1,10574195,11176504,11176505,g,gt,1
NC_037351.1,NC_032673.1,10574195,11166489,11166490,g,gt,1
NC_037351.1,NC_032673.1,10587783,11190097,11190098,C,CA,1
NC_037351.1,NC_032673.1,10587783,11152897,11152898,C,CA,1
NC_037351.1,NC_032673.1,10629196,11213391,11213393,T,TKG,2
NC_037351.1,NC_032673.1,10635893,11220095,11220096,a,at,1
NC_037351.1,NC_032673.1,10636353,11220557,11220572,G,GTTTAAACTTATCATA,15
NC_037351.1,NC_032673.1,10636433,11220651,11220652,T,TA,1
NC_037351.1,NC_032673.1,10658331,11242550,11242559,g,gcaaatcaat,9
NC_037351.1,NC_032673.1,10660288,11244516,11244517,a,ag,1
NC_037351.1,NC_032673.1,10660726,11244955,11244956,t,ta,1
NC_037351.1,NC_032673.1,10741508,11325384,11325385,T,TA,1
NC_037351.1,NC_032673.1,10890191,11472230,11472234,a,atttt,4
NC_037351.1,NC_032673.1,10940439,11522326,11522327,g,gc,1
NC_037351.1,NC_032673.1,10952587,11534480,11534486,G,Gtattaa,6
NC_037351.1,NC_032673.1,10953212,11535112,11535113,A,AW,1
NC_037351.1,NC_032673.1,10959332,11541228,11541260,g,ggagagaagggaaaaaaagagagatgaacaAAA,32
NC_037351.1,NC_032673.1,10963271,11545199,11545200,a,ag,1
NC_037351.1,NC_032673.1,10971555,11553484,11553486,G,GGT,2
NC_037351.1,NC_032673.1,10971839,11553767,11553768,A,AC,1
NC_037351.1,NC_032673.1,10975148,11557061,11557062,c,ca,1
NC_037351.1,NC_032673.1,11009822,11592503,11592504,A,AW,1
NC_037351.1,NC_032673.1,11010751,11593433,11593434,T,TY,1
NC_037351.1,NC_032673.1,11015260,11597943,11597946,T,TGTC,3
NC_037351.1,NC_032673.1,11022006,11604710,11604715,G,GGCCCT,5
NC_037351.1,NC_032673.1,11024413,11607122,11607123,g,ga,1
NC_037351.1,NC_032673.1,11037347,11620064,11620067,T,TTAC,3
NC_037351.1,NC_032673.1,11038835,11621556,11621557,t,ta,1
NC_037351.1,NC_032673.1,11042092,11624823,11624830,A,ANNNNNNN,7
NC_037351.1,NC_032673.1,11147008,11734997,11734998,g,gt,1
NC_037351.1,NC_032673.1,11177367,11765371,11765372,a,at,1
NC_037351.1,NC_032673.1,11179374,11767378,11767383,C,CTAAAT,5
NC_037351.1,NC_032673.1,11244417,11832434,11832436,a,aac,2
NC_037351.1,NC_032673.1,11245776,11833804,11833805,G,GA,1
NC_037351.1,NC_032673.1,11278624,11866676,11866677,C,CA,1
NC_037351.1,NC_032673.1,11280167,11880061,11880068,g,ggcttcaa,7
NC_037351.1,NC_032673.1,11280912,11880813,11880814,t,ta,1
NC_037351.1,NC_032673.1,11281369,11881271,11881276,c,caaatg,5
NC_037351.1,NC_032673.1,11284854,11884831,11884832,t,tc,1
NC_037351.1,NC_032673.1,11331137,11931294,11931296,t,taa,2
NC_037351.1,NC_032673.1,11399048,11999211,11999212,a,ac,1
NC_037351.1,NC_032673.1,11420152,12020319,12020320,t,ta,1
NC_037351.1,NC_032673.1,11475544,12077818,12077819,a,ag,1
NC_037351.1,NC_032673.1,11500691,12102967,12102968,g,gt,1
NC_037351.1,NC_032673.1,11670627,12273319,12273320,t,tg,1
NC_037351.1,NC_032673.1,11671084,12273777,12273778,c,ca,1
NC_037351.1,NC_032673.1,11709521,12308787,12308788,a,ag,1
NC_037351.1,NC_032673.1,11822730,12421945,12421952,C,CTCAAAAA,7
NC_037351.1,NC_032673.1,11963674,12568889,12568890,c,ca,1
NC_037351.1,NC_032673.1,12137119,12742314,12742342,A,AGGTGNNNNNNNNNNNNNNNNNNNNNNNN,28
NC_037351.1,NC_032673.1,12137137,12742360,12742363,T,TAAA,3
NC_037351.1,NC_032673.1,12739032,13344558,13344559,C,CG,1
NC_037351.1,NC_032673.1,12785575,13414571,13414573,a,aNN,2
NC_037351.1,NC_032673.1,12878661,13547337,13547338,T,TG,1
NC_037351.1,NC_032673.1,13006528,13706395,13706396,T,TC,1
NC_037351.1,NC_032673.1,13047468,13747350,13747351,g,gt,1
NC_037351.1,NC_032673.1,13085604,13786887,13786888,c,ct,1
NC_037351.1,NC_032673.1,13087304,13788588,13788589,t,tg,1
NC_037351.1,NC_032673.1,13121294,13822580,13822581,a,ac,1
NC_037351.1,NC_032673.1,13252326,13952699,13952700,t,tg,1
NC_037351.1,NC_032673.1,13294509,13994887,13994888,t,tg,1
NC_037351.1,NC_032673.1,13549128,14251723,14251724,a,ag,1
NC_037351.1,NC_032673.1,13791950,14510435,14510437,T,TAG,2
NC_037351.1,NC_032673.1,13904350,14622727,14622728,a,ag,1
NC_037351.1,NC_032673.1,13904420,14622798,14622799,t,tc,1
NC_037351.1,NC_032673.1,14026372,14749285,14749286,A,AR,1
NC_037351.1,NC_032673.1,14088167,14810928,14810929,t,tg,1
NC_037351.1,NC_032673.1,14136599,14859184,14859185,t,tc,1
NC_037351.1,NC_032673.1,14136728,14859314,14859315,T,TK,1
NC_037351.1,NC_032673.1,14136804,14859391,14859392,A,AW,1
NC_037351.1,NC_032673.1,14186585,14909174,14909175,a,at,1
NC_037351.1,NC_032673.1,14273849,14994031,14994032,t,tg,1
NC_037351.1,NC_032673.1,14303971,15024147,15024148,C,CT,1
NC_037351.1,NC_032673.1,14419810,15140978,15140980,g,gta,2
NC_037351.1,NC_032673.1,14509168,15239153,15239178,a,aagNNNNNNNNNNNNNNNNNNNNNNN,25
NC_037351.1,NC_032673.1,14544417,15272928,15272929,G,GC,1
NC_037351.1,NC_032673.1,14604354,15333331,15333333,a,aNN,2
NC_037351.1,NC_032673.1,14621234,15350219,15350220,t,ta,1
NC_037351.1,NC_032673.1,14804773,15533759,15533761,t,tNN,2
NC_037351.1,NC_032673.1,15074301,15802451,15802452,C,CY,1
NC_037351.1,NC_032673.1,15079136,15807287,15807289,C,CTG,2
NC_037351.1,NC_032673.1,15106648,15834803,15834804,G,GT,1
NC_037351.1,NC_032673.1,15121217,15849381,15849383,a,aNN,2
NC_037351.1,NC_032673.1,15322317,16050554,16050556,g,gga,2
NC_037351.1,NC_032673.1,15564719,16292565,16292566,a,at,1
NC_037351.1,NC_032673.1,15564740,16292587,16292588,c,ca,1
NC_037351.1,NC_032673.1,15599117,16327074,16327075,t,tN,1
NC_037351.1,NC_032673.1,15695248,16422634,16422635,t,ta,1
NC_037351.1,NC_032673.1,15703836,16431223,16431224,t,tg,1
NC_037351.1,NC_032673.1,15758237,16490820,16490822,t,taa,2
NC_037351.1,NC_032673.1,15930087,16666742,16666743,G,GK,1
NC_037351.1,NC_032673.1,16023366,16762259,16762260,g,ga,1
NC_037351.1,NC_032673.1,16072671,7736003,7736004,t,tc,1
NC_037351.1,NC_032673.1,16242926,16980371,16980385,t,tcTCNNNNNNNNNNN,14
NC_037351.1,NC_032673.1,16247231,16984685,16984686,g,ga,1
NC_037351.1,NC_032673.1,16261906,16999361,16999362,T,TK,1
NC_037351.1,NC_032673.1,16355201,17077447,17077448,t,tc,1
NC_037351.1,NC_032673.1,16441810,17164030,17164031,g,gK,1
NC_037351.1,NC_032673.1,16549627,17276944,17276946,C,CTA,2
NC_037351.1,NC_032673.1,16738358,17465786,17465787,a,ag,1
NC_037351.1,NC_032673.1,16739111,17466540,17466541,a,ac,1
NC_037351.1,NC_032673.1,16762605,17490035,17490036,c,ct,1
NC_037351.1,NC_032673.1,16763551,17490982,17491008,c,ctttgtcaaagataaggtgtccatatg,26
NC_037351.1,NC_032673.1,16766792,17494242,17494245,g,gtct,3
NC_037351.1,NC_032673.1,16942700,17670325,17670344,t,tgtatatacacacacacaca,19
NC_037351.1,NC_032673.1,17010493,17738165,17738181,A,AAGCAATGGAGCCTCCT,16
NC_037351.1,NC_032673.1,17383547,18091597,18091600,g,gagc,3
NC_037351.1,NC_032673.1,17542034,18315205,18315213,t,tNNNNNNNN,8
NC_037351.1,NC_032673.1,17565139,18338319,18338324,t,ttcCNN,5
NC_037351.1,NC_032673.1,17569109,18342296,18342301,C,CTCACT,5
NC_037351.1,NC_032673.1,17600448,18410147,18410148,G,GS,1
NC_037351.1,NC_032673.1,17622499,18432533,18432534,G,GC,1
NC_037351.1,NC_032673.1,17738773,18549141,18549143,C,CAT,2
NC_037351.1,NC_032673.1,17864364,18674740,18674742,t,tNN,2
NC_037351.1,NC_032673.1,17954117,18764694,18764699,t,ttaaaa,5
NC_037351.1,NC_032673.1,18146988,18958235,18958257,g,gtgtgtgtgtgtgtgtgtgtgta,22
NC_037351.1,NC_032673.1,18316925,19137977,19137978,a,at,1
NC_037351.1,NC_032673.1,18364166,19193033,19193034,t,ta,1
NC_037351.1,NC_032673.1,18434731,19264623,19264627,t,ttttc,4
NC_037351.1,NC_032673.1,18488304,19317759,19317760,C,CY,1
NC_037351.1,NC_032673.1,18637862,19467317,19467318,t,tN,1
NC_037351.1,NC_032673.1,18640568,19470024,19470025,A,AC,1
NC_037351.1,NC_032673.1,18833928,19663397,19663398,c,ct,1
NC_037351.1,NC_032673.1,18884845,19714316,19714334,C,CCGGCTTCAAGGAGNNNNN,18
NC_037351.1,NC_032673.1,18887347,19716837,19716838,c,ca,1
NC_037351.1,NC_032673.1,18949314,19779219,19779268,g,gtctcgaaCTAGTCGACGTNNNNNNNNNNNNNNNNNNNNNNNNNNNNNNN,49
NC_037351.1,NC_032673.1,18949362,19779316,19779318,t,tcA,2
NC_037351.1,NC_032673.1,19372105,20201965,20201966,A,AW,1
NC_037351.1,NC_032673.1,19373596,20203808,20203810,t,tNN,2
NC_037351.1,NC_032673.1,19644932,20695743,20695744,c,cg,1
NC_037351.1,NC_032673.1,19837108,20943297,20943298,t,tc,1
NC_037351.1,NC_032673.1,19945299,21051490,21051491,c,ca,1
NC_037351.1,NC_032673.1,20382016,21488009,21488010,a,aN,1
NC_037351.1,NC_032673.1,20458949,21564947,21564958,c,ctgggtgttcat,11
NC_037351.1,NC_032673.1,20510056,21616488,21616489,a,at,1
NC_037351.1,NC_032673.1,20683810,21790148,21790149,c,ct,1
NC_037351.1,NC_032673.1,20792724,21899076,21899077,A,AG,1
NC_037351.1,NC_032673.1,20929004,22030368,22030369,g,ga,1
NC_037351.1,NC_032673.1,20929029,22030394,22030395,g,ga,1
NC_037351.1,NC_032673.1,20929076,22030443,22030444,c,ca,1
NC_037351.1,NC_032673.1,21006529,22107897,22107898,g,gc,1
NC_037351.1,NC_032673.1,21488476,22589256,22589257,a,aN,1
NC_037351.1,NC_032673.1,21508435,22609412,22609414,T,TTC,2
NC_037351.1,NC_032673.1,21636328,22737227,22737233,a,agaaagt,6
NC_037351.1,NC_032673.1,21636637,22737542,22737543,g,ga,1
NC_037351.1,NC_032673.1,21750265,22851141,22851142,a,aM,1
NC_037351.1,NC_032673.1,21758503,22859381,22859382,g,ga,1
NC_037351.1,NC_032673.1,22158389,23263832,23263833,g,ga,1
NC_037351.1,NC_032673.1,22594550,23699169,23699170,t,ta,1
NC_037351.1,NC_032673.1,22674978,23779479,23779481,t,tNN,2
NC_037351.1,NC_032673.1,22680206,23784709,23784710,c,ct,1
NC_037351.1,NC_032673.1,22883045,23962600,23962601,T,TG,1
NC_037351.1,NC_032673.1,22883243,23962798,23962799,T,TC,1
NC_037351.1,NC_032673.1,22883275,23962831,23962832,T,TG,1
NC_037351.1,NC_032673.1,22883821,23963373,23963375,T,TGA,2
NC_037351.1,NC_032673.1,22883973,23963527,23963529,t,ttg,2
NC_037351.1,NC_032673.1,22884093,23963648,23963649,A,AT,1
NC_037351.1,NC_032673.1,22884335,23963891,23963892,t,tc,1
NC_037351.1,NC_032673.1,22884519,23964076,23964077,a,ag,1
NC_037351.1,NC_032673.1,22884584,23964141,23964142,g,gt,1
NC_037351.1,NC_032673.1,22884731,23964287,23964288,g,gc,1
NC_037351.1,NC_032673.1,22884802,23964359,23964360,t,ta,1
NC_037351.1,NC_032673.1,22884823,23964382,23964383,G,GT,1
NC_037351.1,NC_032673.1,22884864,23964424,23964425,t,ta,1
NC_037351.1,NC_032673.1,22884890,23964451,23964453,a,att,2
NC_037351.1,NC_032673.1,22884935,23964498,23964500,t,tgg,2
NC_037351.1,NC_032673.1,22885177,23964740,23964741,c,ct,1
NC_037351.1,NC_032673.1,22885448,23965009,23965010,c,ca,1
NC_037351.1,NC_032673.1,22885559,23965119,23965121,T,TTG,2
NC_037351.1,NC_032673.1,22885567,23965129,23965130,A,AC,1
NC_037351.1,NC_032673.1,22885593,23965156,23965157,t,tg,1
NC_037351.1,NC_032673.1,22885871,23965432,23965433,T,TA,1
NC_037351.1,NC_032673.1,22886392,23965954,23965955,g,gt,1
NC_037351.1,NC_032673.1,22886448,23966011,23966012,g,gc,1
NC_037351.1,NC_032673.1,22887755,23967319,23967320,g,ga,1
NC_037351.1,NC_032673.1,23747588,24826878,24826879,G,GR,1
NC_037351.1,NC_032673.1,24163074,25232837,25232838,a,at,1
NC_037351.1,NC_032673.1,24274129,25344368,25344369,c,ct,1
NC_037351.1,NC_032673.1,24323778,25393436,25393437,c,ct,1
NC_037351.1,NC_032673.1,24671760,25741141,25741143,t,tNN,2
NC_037351.1,NC_032673.1,24808098,25887658,25887660,t,tNN,2
NC_037351.1,NC_032673.1,25001295,26081781,26081782,t,ta,1
NC_037351.1,NC_032673.1,25102210,26183050,26183051,t,ta,1
NC_037351.1,NC_032673.1,25102578,26183419,26183421,c,cag,2
NC_037351.1,NC_032673.1,25102653,26183496,26183498,a,att,2
NC_037351.1,NC_032673.1,25125261,26206106,26206107,G,GS,1
NC_037351.1,NC_032673.1,25263949,26344797,26344798,C,CY,1
NC_037351.1,NC_032673.1,25278284,26359021,26359022,a,at,1
NC_037351.1,NC_032673.1,25397408,26478703,26478704,A,AC,1
NC_037351.1,NC_032673.1,25459500,26540861,26540862,C,CA,1
NC_037351.1,NC_032673.1,25459574,26540944,26540946,a,att,2
NC_037351.1,NC_032673.1,25536480,26617666,26617667,a,ag,1
NC_037351.1,NC_032673.1,25721087,26785950,26785953,t,tgaa,3
NC_037351.1,NC_032673.1,25902445,26967717,26967725,t,tctaGACAC,8
NC_037351.1,NC_032673.1,25911180,26976475,26976477,g,gat,2
NC_037351.1,NC_032673.1,26099376,27166297,27166298,t,tY,1
NC_037351.1,NC_032673.1,26181304,27248226,27248227,T,TK,1
NC_037351.1,NC_032673.1,26345657,27410054,27410055,a,ag,1
NC_037351.1,NC_032673.1,26345674,27410072,27410077,t,tcatgg,5
NC_037351.1,NC_032673.1,26943722,27966187,27966189,g,gca,2
NC_037351.1,NC_032673.1,27015308,28037859,28037860,a,ac,1
NC_037351.1,NC_032673.1,27015369,28037922,28037923,g,ga,1
NC_037351.1,NC_032673.1,27031677,28054217,28054218,t,ta,1
NC_037351.1,NC_032673.1,27130640,28153519,28153520,a,ag,1
NC_037351.1,NC_032673.1,27132753,28155637,28155640,c,cttt,3
NC_037351.1,NC_032673.1,27167748,28190633,28190634,c,ct,1
NC_037351.1,NC_032673.1,27175583,28198468,28198478,G,GGTGCCTACAC,10
NC_037351.1,NC_032673.1,27177046,28199946,28199947,T,TY,1
NC_037351.1,NC_032673.1,27277263,28301276,28301277,A,AM,1
NC_037351.1,NC_032673.1,27285924,28309936,28309938,C,CCT,2
NC_037351.1,NC_032673.1,27291944,28315963,28315964,t,tg,1
NC_037351.1,NC_032673.1,27292307,28316325,28316327,C,CTG,2
NC_037351.1,NC_032673.1,27292319,28316339,28316351,G,GTTTATTGCATAT,12
NC_037351.1,NC_032673.1,27293466,28317499,28317500,T,TA,1
NC_037351.1,NC_032673.1,27293762,28317796,28317797,c,ct,1
NC_037351.1,NC_032673.1,27299997,28324017,28324018,g,gt,1
NC_037351.1,NC_032673.1,27317046,28340894,28340895,C,CA,1
NC_037351.1,NC_032673.1,27317152,28341001,28341002,t,ta,1
NC_037351.1,NC_032673.1,27340975,28364828,28364829,A,AR,1
NC_037351.1,NC_032673.1,27355006,28379491,28379492,a,ag,1
NC_037351.1,NC_032673.1,27355045,28379531,28379533,c,cta,2
NC_037351.1,NC_032673.1,27359406,28384912,28384915,a,aagg,3
NC_037351.1,NC_032673.1,27359673,28385183,28385184,C,CG,1
NC_037351.1,NC_032673.1,27538301,28569240,28569241,t,tc,1
NC_037351.1,NC_032673.1,27565174,28596118,28596121,t,tgtg,3
NC_037351.1,NC_032673.1,27569685,28600628,28600629,T,TC,1
NC_037351.1,NC_032673.1,27570040,28600983,28600984,C,CT,1
NC_037351.1,NC_032673.1,27606393,28637363,28637364,A,AG,1
NC_037351.1,NC_032673.1,27694949,28725900,28725902,A,AAC,2
NC_037351.1,NC_032673.1,27775513,28806499,28806500,T,TC,1
NC_037351.1,NC_032673.1,27784943,28815931,28815932,t,ta,1
NC_037351.1,NC_032673.1,27875710,28906684,28906700,G,GCTTTAACAGTCAATAA,16
NC_037351.1,NC_032673.1,27904466,28935459,28935460,a,ag,1
NC_037351.1,NC_032673.1,27904471,28935465,28935468,g,gaaa,3
NC_037351.1,NC_032673.1,27916060,28947002,28947003,T,TA,1
NC_037351.1,NC_032673.1,27929410,28960354,28960355,t,ta,1
NC_037351.1,NC_032673.1,27933419,28964369,28964375,a,aaagaag,6
NC_037351.1,NC_032673.1,27969876,29000781,29000782,A,AG,1
NC_037351.1,NC_032673.1,27973896,29004801,29004802,G,GT,1
NC_037351.1,NC_032673.1,27976254,29007161,29007162,C,CA,1
NC_037351.1,NC_032673.1,27995674,29026797,29026798,c,ca,1
NC_037351.1,NC_032673.1,28149269,29207903,29207904,t,tc,1
NC_037351.1,NC_032673.1,28197681,29256313,29256314,c,ct,1
NC_037351.1,NC_032673.1,28254613,29313250,29313255,A,ATAGTC,5
NC_037351.1,NC_032673.1,28405428,29462322,29462323,T,TG,1
NC_037351.1,NC_032673.1,28406446,29463341,29463344,T,TCTY,3
NC_037351.1,NC_032673.1,28409372,29466268,29466269,a,at,1
NC_037351.1,NC_032673.1,28409799,29466696,29466699,T,TTTA,3
NC_037351.1,NC_032673.1,28414140,29471042,29471052,a,aaaaaacaaat,10
NC_037351.1,NC_032673.1,28437744,29492061,29492062,C,CT,1
NC_037351.1,NC_032673.1,28439996,29494323,29494324,T,TG,1
NC_037351.1,NC_032673.1,28450816,29505141,29505142,T,TA,1
NC_037351.1,NC_032673.1,28483232,29537562,29537563,C,CA,1
NC_037351.1,NC_032673.1,28511038,29565368,29565369,a,at,1
NC_037351.1,NC_032673.1,28514434,29568761,29568767,C,CTAAAAT,6
NC_037351.1,NC_032673.1,28521452,29575788,29575789,T,TA,1
NC_037351.1,NC_032673.1,28531219,29585562,29585564,T,TTG,2
NC_037351.1,NC_032673.1,28532252,29586598,29586599,A,AT,1
NC_037351.1,NC_032673.1,28533298,29587636,29587637,c,ct,1
NC_037351.1,NC_032673.1,28533577,29587916,29587917,c,ct,1
NC_037351.1,NC_032673.1,28534006,29588346,29588347,C,CT,1
NC_037351.1,NC_032673.1,28534128,29588469,29588470,A,AG,1
NC_037351.1,NC_032673.1,28534336,29588678,29588679,a,at,1
NC_037351.1,NC_032673.1,28543490,29597831,29597832,t,ta,1
NC_037351.1,NC_032673.1,28593106,29647453,29647454,t,ta,1
NC_037351.1,NC_032673.1,28593117,29647465,29647466,g,gt,1
NC_037351.1,NC_032673.1,28646034,29700386,29700390,C,CTAAA,4
NC_037351.1,NC_032673.1,28693964,29748372,29748380,G,GGAGCCTTT,8
NC_037351.1,NC_032673.1,28695380,29749796,29749797,G,GA,1
NC_037351.1,NC_032673.1,28710701,29765109,29765110,t,tW,1
NC_037351.1,NC_032673.1,28712424,29766835,29766836,C,CT,1
NC_037351.1,NC_032673.1,28731658,29786080,29786089,t,ttcagtcgta,9
NC_037351.1,NC_032673.1,28802892,29857317,29857321,A,ANNNN,4
NC_037351.1,NC_032673.1,28825859,29880288,29880289,A,AC,1
NC_037351.1,NC_032673.1,28856973,29911406,29911407,T,TY,1
NC_037351.1,NC_032673.1,28863007,29917446,29917447,G,GC,1
NC_037351.1,NC_032673.1,28874748,29929186,29929187,T,TA,1
NC_037351.1,NC_032673.1,28893309,29947780,29947783,A,AAGG,3
NC_037351.1,NC_032673.1,28901771,29956247,29956253,t,tagatag,6
NC_037351.1,NC_032673.1,28908883,29963371,29963373,T,TAG,2
NC_037351.1,NC_032673.1,28911142,29965653,29965655,c,cat,2
NC_037351.1,NC_032673.1,28911151,29965664,29965666,a,act,2
NC_037351.1,NC_032673.1,29085695,30132547,30132548,c,ct,1
NC_037351.1,NC_032673.1,29108200,30155053,30155054,C,CT,1
NC_037351.1,NC_032673.1,29117322,30164177,30164179,c,cag,2
NC_037351.1,NC_032673.1,29145512,30192385,30192388,t,ttta,3
NC_037351.1,NC_032673.1,29183223,30230530,30230531,g,ga,1
NC_037351.1,NC_032673.1,29183233,30230541,30230548,a,acccacct,7
NC_037351.1,NC_032673.1,29224566,30271889,30271890,a,ag,1
NC_037351.1,NC_032673.1,29267255,30314575,30314576,G,GR,1
NC_037351.1,NC_032673.1,29307770,30355097,30355098,g,gc,1
NC_037351.1,NC_032673.1,29383353,30431652,30431654,C,CTG,2
NC_037351.1,NC_032673.1,29398331,30446593,30446594,c,ct,1
NC_037351.1,NC_032673.1,29399589,30447852,30447854,c,caa,2
NC_037351.1,NC_032673.1,29663229,30470014,30470015,T,TG,1
NC_037351.1,NC_032673.1,29683026,30491026,30491036,A,AAACTTATAGT,10
NC_037351.1,NC_032673.1,29767624,30575342,30575343,T,TG,1
NC_037351.1,NC_032673.1,29777918,30585692,30585693,A,AT,1
NC_037351.1,NC_032673.1,29812074,30619119,30619120,g,ga,1
NC_037351.1,NC_032673.1,29821635,30628725,30628726,t,ta,1
NC_037351.1,NC_032673.1,29823609,30630701,30630702,g,gc,1
NC_037351.1,NC_032673.1,29823624,30630717,30630718,A,AG,1
NC_037351.1,NC_032673.1,29857376,30663502,30663503,A,AT,1
NC_037351.1,NC_032673.1,29857388,30663515,30663516,A,AT,1
NC_037351.1,NC_032673.1,29858347,30664473,30664474,t,tY,1
NC_037351.1,NC_032673.1,29869787,30676229,30676230,T,TY,1
NC_037351.1,NC_032673.1,29875555,30681996,30681997,C,CT,1
NC_037351.1,NC_032673.1,29876521,30682966,30682967,t,tg,1
NC_037351.1,NC_032673.1,29879798,30686245,30686247,a,aag,2
NC_037351.1,NC_032673.1,29941726,30766797,30766801,T,TTCAA,4
NC_037351.1,NC_032673.1,29959286,30784361,30784362,c,ca,1
NC_037351.1,NC_032673.1,29971571,30796647,30796648,T,TA,1
NC_037351.1,NC_032673.1,29987421,30816068,30816069,A,AC,1
NC_037351.1,NC_032673.1,29994340,30822987,30822996,a,acactgtttc,9
NC_037351.1,NC_032673.1,30015474,30844141,30844142,C,CT,1
NC_037351.1,NC_032673.1,30115492,30944165,30944166,g,ga,1
NC_037351.1,NC_032673.1,30115581,30944255,30944256,g,ga,1
NC_037351.1,NC_032673.1,30266542,31340474,31340475,G,GT,1
NC_037351.1,NC_032673.1,30270905,31344838,31344839,t,ta,1
NC_037351.1,NC_032673.1,30277474,31351408,31351409,t,ta,1
NC_037351.1,NC_032673.1,30290178,31364752,31364753,T,TC,1
NC_037351.1,NC_032673.1,30334375,31246911,31246912,g,gt,1
NC_037351.1,NC_032673.1,30336366,31249102,31249103,G,GC,1
NC_037351.1,NC_032673.1,30591088,31682158,31682159,t,tc,1
NC_037351.1,NC_032673.1,30591495,31682566,31682568,a,aat,2
NC_037351.1,NC_032673.1,30697248,31789267,31789269,t,ttY,2
NC_037351.1,NC_032673.1,30701398,31793419,31793433,a,aNNNNNNNNNNNNNN,14
NC_037351.1,NC_032673.1,30709730,31801765,31801771,C,CTTTCTT,6
NC_037351.1,NC_032673.1,30725152,31817237,31817238,A,AC,1
NC_037351.1,NC_032673.1,30754858,31848167,31848168,A,AT,1
NC_037351.1,NC_032673.1,30758147,31851471,31851473,a,aac,2
NC_037351.1,NC_032673.1,30782214,31874911,31874913,t,ttc,2
NC_037351.1,NC_032673.1,30865609,31959094,31959111,A,AAANNNNNNNNNNNNNNN,17
NC_037351.1,NC_032673.1,30870400,31963902,31963905,A,ATAT,3
NC_037351.1,NC_032673.1,30870419,31963924,31963925,G,GT,1
NC_037351.1,NC_032673.1,30870548,31964056,31964057,g,ga,1
NC_037351.1,NC_032673.1,30997505,32091539,32091542,T,TTTA,3
NC_037351.1,NC_032673.1,31228545,32339085,32339086,g,gt,1
NC_037351.1,NC_032673.1,31267453,32376438,32376439,c,ct,1
NC_037351.1,NC_032673.1,31267636,32376621,32376622,C,CT,1
NC_037351.1,NC_032673.1,31267640,32376626,32376627,G,GA,1
NC_037351.1,NC_032673.1,31279310,32388295,32388296,A,AM,1
NC_037351.1,NC_032673.1,31338985,32447982,32447993,T,TGGTCACTTTCW,11
NC_037351.1,NC_032673.1,31346347,32455356,32455359,g,ggtt,3
NC_037351.1,NC_032673.1,31376792,32486864,32486865,T,TA,1
NC_037351.1,NC_032673.1,31432848,32542348,32542349,c,ct,1
NC_037351.1,NC_032673.1,31470980,32580356,32580357,t,tN,1
NC_037351.1,NC_032673.1,31545635,32655063,32655064,g,ga,1
NC_037351.1,NC_032673.1,31583986,32693432,32693433,C,CY,1
NC_037351.1,NC_032673.1,31646145,32755624,32755630,t,tcgCACN,6
NC_037351.1,NC_032673.1,31676483,32785969,32785970,G,GR,1
NC_037351.1,NC_032673.1,31969030,33077546,33077548,a,aat,2
NC_037351.1,NC_032673.1,31975372,33083890,33083891,t,tg,1
NC_037351.1,NC_032673.1,32050280,33159963,33159965,t,ttg,2
NC_037351.1,NC_032673.1,32115430,33225117,33225119,C,CTG,2
NC_037351.1,NC_032673.1,32115448,33225137,33225138,g,ga,1
NC_037351.1,NC_032673.1,32187205,33296924,33296925,t,tc,1
NC_037351.1,NC_032673.1,32231939,33346791,33346792,C,CT,1
NC_037351.1,NC_032673.1,32262315,33600964,33600965,A,AW,1
NC_037351.1,NC_032673.1,32271111,33609743,33609744,g,ga,1
NC_037351.1,NC_032673.1,32271419,33610052,33610053,A,AT,1
NC_037351.1,NC_032673.1,32282822,33480783,33480785,T,TTC,2
NC_037351.1,NC_032673.1,32294593,33492574,33492578,t,tgggc,4
NC_037351.1,NC_032673.1,32295004,33493865,33493867,A,ACT,2
NC_037351.1,NC_032673.1,32301144,33500006,33500007,G,GT,1
NC_037351.1,NC_032673.1,32310341,33509203,33509207,t,tttga,4
NC_037351.1,NC_032673.1,32310387,33509253,33509254,C,CG,1
NC_037351.1,NC_032673.1,32310759,33509623,33509624,t,ta,1
NC_037351.1,NC_032673.1,32358019,33556771,33556777,G,GATGTGA,6
NC_037351.1,NC_032673.1,32359429,33558146,33558147,G,GT,1
NC_037351.1,NC_032673.1,32376382,33574914,33574928,c,cttttcacttttcat,14
NC_037351.1,NC_032673.1,32619277,33737338,33737340,c,ctt,2
NC_037351.1,NC_032673.1,32621115,33739178,33739183,C,CATGAT,5
NC_037351.1,NC_032673.1,32647874,33765955,33765956,A,AC,1
NC_037351.1,NC_032673.1,32704685,33883231,33883232,T,TK,1
NC_037351.1,NC_032673.1,32708514,33887063,33887064,a,at,1
NC_037351.1,NC_032673.1,32813442,33921556,33921559,a,acag,3
NC_037351.1,NC_032673.1,32816389,33924512,33924515,t,ttag,3
NC_037351.1,NC_032673.1,32817984,33926115,33926124,T,TGTTCGAAGG,9
NC_037351.1,NC_032673.1,32836224,33944452,33944453,a,ag,1
NC_037351.1,NC_032673.1,32836795,33945024,33945026,t,taa,2
NC_037351.1,NC_032673.1,32842727,33950957,33950961,a,aacac,4
NC_037351.1,NC_032673.1,32883629,33991871,33991872,C,CA,1
NC_037351.1,NC_032673.1,32892154,34000171,34000179,t,tttcaaaaa,8
NC_037351.1,NC_032673.1,32933565,34041600,34041601,A,AC,1
NC_037351.1,NC_032673.1,32962553,34070590,34070591,g,gt,1
NC_037351.1,NC_032673.1,32962557,34070595,34070596,a,ag,1
NC_037351.1,NC_032673.1,33059915,34150000,34150002,A,AAC,2
NC_037351.1,NC_032673.1,33125015,34214966,34214967,C,CA,1
NC_037351.1,NC_032673.1,33302827,34403425,34403426,t,ta,1
NC_037351.1,NC_032673.1,33311252,34411851,34411852,t,tc,1
NC_037351.1,NC_032673.1,33323906,34424506,34424507,T,TC,1
NC_037351.1,NC_032673.1,33325120,34425721,34425724,T,TTTA,3
NC_037351.1,NC_032673.1,33347050,34447647,34447654,T,TTGGGGAG,7
NC_037351.1,NC_032673.1,33350912,34451495,34451497,c,cca,2
NC_037351.1,NC_032673.1,33354798,34455383,34455384,G,GT,1
NC_037351.1,NC_032673.1,33367051,34467637,34467638,A,AR,1
NC_037351.1,NC_032673.1,33373845,34474429,34474430,C,CT,1
NC_037351.1,NC_032673.1,33373916,34474501,34474502,C,CT,1
NC_037351.1,NC_032673.1,33373999,34474585,34474600,A,ATNNNNNNNNNNNNNN,15
NC_037351.1,NC_032673.1,33398431,34499410,34499412,T,TAC,2
NC_037351.1,NC_032673.1,33419577,34520201,34520202,T,TC,1
NC_037351.1,NC_032673.1,33460093,34575850,34575851,A,AT,1
NC_037351.1,NC_032673.1,33460222,34575980,34575982,g,gaa,2
NC_037351.1,NC_032673.1,33471730,34587491,34587508,a,aaaaaaaaactaaaaaat,17
NC_037351.1,NC_032673.1,33508557,34624339,34624340,t,tg,1
NC_037351.1,NC_032673.1,33515237,34631025,34631026,t,tg,1
NC_037351.1,NC_032673.1,33561223,34677097,34677098,T,TC,1
NC_037351.1,NC_032673.1,33776090,34893535,34893536,g,gt,1
NC_037351.1,NC_032673.1,33805061,34922522,34922523,a,ac,1
NC_037351.1,NC_032673.1,33887101,35004572,35004574,t,ttg,2
NC_037351.1,NC_032673.1,33901461,35018940,35018941,t,ta,1
NC_037351.1,NC_032673.1,33962061,35079550,35079551,t,tg,1
NC_037351.1,NC_032673.1,34041510,35159007,35159008,g,gt,1
NC_037351.1,NC_032673.1,34060245,35177744,35177745,C,CM,1
NC_037351.1,NC_032673.1,34060604,35178103,35178104,C,CG,1
NC_037351.1,NC_032673.1,34091324,35215723,35215724,C,CA,1
NC_037351.1,NC_032673.1,34192149,35316211,35316212,T,TC,1
NC_037351.1,NC_032673.1,34260419,35384384,35384385,a,at,1
NC_037351.1,NC_032673.1,34300111,35424078,35424094,G,GNNNNNNNNNNNNNNNN,16
NC_037351.1,NC_032673.1,34412978,35536474,35536475,G,GC,1
NC_037351.1,NC_032673.1,34705132,35815975,35815978,a,aaat,3
NC_037351.1,NC_032673.1,34735525,35846466,35846468,T,TAA,2
NC_037351.1,NC_032673.1,34752564,35863391,35863393,a,acg,2
NC_037351.1,NC_032673.1,34760619,35871448,35871457,t,tgtgtgtgca,9
NC_037351.1,NC_032673.1,34766445,35877312,35877313,T,TC,1
NC_037351.1,NC_032673.1,34768935,35879804,35879805,T,TC,1
NC_037351.1,NC_032673.1,34780102,35890986,35890988,A,AGG,2
NC_037351.1,NC_032673.1,34782239,35893123,35893124,t,ta,1
NC_037351.1,NC_032673.1,34797302,35908189,35908190,G,GC,1
NC_037351.1,NC_032673.1,34827425,35935607,35935608,A,AT,1
NC_037351.1,NC_032673.1,34908645,36016776,36016778,C,CTT,2
NC_037351.1,NC_032673.1,34917336,36025469,36025470,C,CY,1
NC_037351.1,NC_032673.1,34918343,36026477,36026479,C,CCG,2
NC_037351.1,NC_032673.1,35115363,36235089,36235090,c,ct,1
NC_037351.1,NC_032673.1,35179018,36298747,36298748,c,ct,1
NC_037351.1,NC_032673.1,35182679,36302414,36302415,A,AG,1
NC_037351.1,NC_032673.1,35288785,36408526,36408528,G,GAT,2
NC_037351.1,NC_032673.1,35320983,36440784,36440785,C,CA,1
NC_037351.1,NC_032673.1,35365800,36485606,36485607,c,ct,1
NC_037351.1,NC_032673.1,35411840,36533067,36533068,t,ta,1
NC_037351.1,NC_032673.1,35433606,36554832,36554833,A,AT,1
NC_037351.1,NC_032673.1,35512659,36715019,36715027,t,tgttgttca,8
NC_037351.1,NC_032673.1,35513518,36715886,36715890,c,ctttt,4
NC_037351.1,NC_032673.1,35513532,36715904,36715910,c,cactttt,6
NC_037351.1,NC_032673.1,35656219,36858547,36858548,C,CA,1
NC_037351.1,NC_032673.1,35658146,36860475,36860476,C,CT,1
NC_037351.1,NC_032673.1,35797536,37007036,37007037,t,tc,1
NC_037351.1,NC_032673.1,35811219,37020734,37020735,G,GA,1
NC_037351.1,NC_032673.1,35813573,37023089,37023092,T,TAAC,3
NC_037351.1,NC_032673.1,35837729,37044651,37044654,G,GGTT,3
NC_037351.1,NC_032673.1,35839243,37046168,37046169,G,GC,1
NC_037351.1,NC_032673.1,35842459,37049374,37049375,t,tc,1
NC_037351.1,NC_032673.1,35890374,37097304,37097305,A,AT,1
NC_037351.1,NC_032673.1,35979597,37186567,37186568,t,ta,1
NC_037351.1,NC_032673.1,36166621,37367986,37367988,c,cat,2
NC_037351.1,NC_032673.1,36220062,37422514,37422515,G,GA,1
NC_037351.1,NC_032673.1,36272019,37474498,37474499,t,tg,1
NC_037351.1,NC_032673.1,36275489,37477976,37477977,a,ag,1
NC_037351.1,NC_032673.1,36372037,37707583,37707584,a,ag,1
NC_037351.1,NC_032673.1,36397752,37733278,37733335,c,cagccATGGTCNNNNNNNNNNNNNNNNNNNNNNNNNNNNNNNNNNNNNNNNNNTtaaa,57
NC_037351.1,NC_032673.1,36409551,37745135,37745139,a,aNNNN,4
NC_037351.1,NC_032673.1,36469026,37805005,37805008,G,GACT,3
NC_037351.1,NC_032673.1,36472365,37808346,37808347,T,TC,1
NC_037351.1,NC_032673.1,36484542,37820532,37820533,g,ga,1
NC_037351.1,NC_032673.1,36488189,37824180,37824194,t,tatatatatatacac,14
NC_037351.1,NC_032673.1,36556641,37892418,37892419,g,ga,1
NC_037351.1,NC_032673.1,36563614,37899398,37899399,c,ct,1
NC_037351.1,NC_032673.1,36681086,38017135,38017136,g,gt,1
NC_037351.1,NC_032673.1,36713347,38163912,38163913,t,tg,1
NC_037351.1,NC_032673.1,36783475,38177424,38177425,t,tg,1
NC_037351.1,NC_032673.1,36788288,38182239,38182240,g,ga,1
NC_037351.1,NC_032673.1,36794192,38188718,38188726,c,cacacacat,8
NC_037351.1,NC_032673.1,36795684,38190218,38190219,c,ca,1
NC_037351.1,NC_032673.1,36797294,38191829,38191830,g,gt,1
NC_037351.1,NC_032673.1,36797694,38192230,38192231,A,AM,1
NC_037351.1,NC_032673.1,36800527,38195070,38195073,C,CTCT,3
NC_037351.1,NC_032673.1,36812751,37542568,37542570,t,tta,2
NC_037351.1,NC_032673.1,36838122,37567538,37567557,A,AAAGAGNNNNNNNNNNNNNN,19
NC_037351.1,NC_032673.1,36846943,37576362,37576363,c,ct,1
NC_037351.1,NC_032673.1,36915105,37644121,37644122,a,ac,1
NC_037351.1,NC_032673.1,36915835,38308406,38308407,g,gt,1
NC_037351.1,NC_032673.1,36943399,38335973,38335974,c,ct,1
NC_037351.1,NC_032673.1,37000890,38393480,38393481,C,CG,1
NC_037351.1,NC_032673.1,37000990,38393645,38393646,T,TG,1
NC_037351.1,NC_032673.1,37004557,38397214,38397215,T,TG,1
NC_037351.1,NC_032673.1,37130986,38524411,38524412,G,GC,1
NC_037351.1,NC_032673.1,37134521,38527945,38527946,C,CT,1
NC_037351.1,NC_032673.1,37166388,38559821,38559824,c,ccca,3
NC_037351.1,NC_032673.1,37172289,38565725,38565728,A,ATAM,3
NC_037351.1,NC_032673.1,37172361,38565800,38565838,T,TATAAGATAAAGGCACTTTTCTAAATACACCTGTTCTGY,38
NC_037351.1,NC_032673.1,37174947,38568425,38568435,T,TCCAGAAAGGA,10
NC_037351.1,NC_032673.1,37203247,38596817,38596819,C,CGG,2
NC_037351.1,NC_032673.1,37230369,38623251,38623252,T,TC,1
NC_037351.1,NC_032673.1,37280943,38674386,38674396,t,tNNNNNNNNNN,10
NC_037351.1,NC_032673.1,37364427,38758430,38758431,a,at,1
NC_037351.1,NC_032673.1,37392021,38786023,38786024,T,TC,1
NC_037351.1,NC_032673.1,37404868,38798869,38798879,C,CGCGTATGCGT,10
NC_037351.1,NC_032673.1,37437638,38832182,38832183,A,AT,1
NC_037351.1,NC_032673.1,37443495,38838038,38838039,A,AG,1
NC_037351.1,NC_032673.1,37487435,38876547,38876549,c,caa,2
NC_037351.1,NC_032673.1,37509276,38898392,38898393,t,tc,1
NC_037351.1,NC_032673.1,37531357,38920516,38920523,A,ACTTTTGT,7
NC_037351.1,NC_032673.1,37617751,39006754,39006757,T,TATG,3
NC_037351.1,NC_032673.1,37786526,39175548,39175549,a,ac,1
NC_037351.1,NC_032673.1,37828591,39216985,39216986,G,GS,1
NC_037351.1,NC_032673.1,37860481,39248643,39248644,T,TY,1
NC_037351.1,NC_032673.1,37890976,39278880,39278882,C,CAA,2
NC_037351.1,NC_032673.1,37893550,39281457,39281459,g,gtt,2
NC_037351.1,NC_032673.1,37904255,39292160,39292161,t,ta,1
NC_037351.1,NC_032673.1,37956489,39344498,39344499,a,at,1
NC_037351.1,NC_032673.1,37956496,39344506,39344507,t,ta,1
NC_037351.1,NC_032673.1,37969326,39357352,39357354,g,gta,2
NC_037351.1,NC_032673.1,38059260,39447312,39447314,c,ctt,2
NC_037351.1,NC_032673.1,38060456,39448510,39448512,t,taa,2
NC_037351.1,NC_032673.1,38064522,39452578,39452579,G,GT,1
NC_037351.1,NC_032673.1,38076647,39464705,39464706,a,at,1
NC_037351.1,NC_032673.1,38097042,39485105,39485110,g,gagtca,5
NC_037351.1,NC_032673.1,38306390,39694457,39694458,a,aR,1
NC_037351.1,NC_032673.1,38317749,39705972,39705973,A,AG,1
NC_037351.1,NC_032673.1,38330830,39719026,39719027,T,TA,1
NC_037351.1,NC_032673.1,38345903,39733542,39733543,T,TA,1
NC_037351.1,NC_032673.1,38375049,39762011,39762013,t,tta,2
NC_037351.1,NC_032673.1,38378793,39766172,39766174,t,taa,2
NC_037351.1,NC_032673.1,38394267,39783125,39783128,a,attc,3
NC_037351.1,NC_032673.1,38399358,39788299,39788300,a,ac,1
NC_037351.1,NC_032673.1,38430624,39823282,39823283,a,at,1
NC_037351.1,NC_032673.1,38431022,39823680,39823682,a,act,2
NC_037351.1,NC_032673.1,38467965,39864639,39864640,A,AM,1
NC_037351.1,NC_032673.1,38496201,39893005,39893006,T,TK,1
NC_037351.1,NC_032673.1,38501321,39898126,39898133,g,gcattgca,7
NC_037351.1,NC_032673.1,38505352,39902164,39902176,a,actgctgctgctg,12
NC_037351.1,NC_032673.1,38513941,39910769,39910770,t,tc,1
NC_037351.1,NC_032673.1,38549398,39946610,39946611,a,ac,1
NC_037351.1,NC_032673.1,38550934,39948148,39948149,g,ga,1
NC_037351.1,NC_032673.1,38610317,40007750,40007751,c,ct,1
NC_037351.1,NC_032673.1,38815701,40299799,40299807,a,aaattctcc,8
NC_037351.1,NC_032673.1,38815991,40300097,40300112,t,tggaacaacagactga,15
NC_037351.1,NC_032673.1,39109867,40599179,40599181,T,TCY,2
NC_037351.1,NC_032673.1,39224096,40722299,40722300,C,CM,1
NC_037351.1,NC_032673.1,39282416,40779992,40779993,c,ct,1
NC_037351.1,NC_032673.1,39352667,40850566,40850567,t,tN,1
NC_037351.1,NC_032673.1,39441385,40939429,40939430,G,GC,1
NC_037351.1,NC_032673.1,39635911,41133157,41133158,g,ga,1
NC_037351.1,NC_032673.1,40091532,41588900,41588901,C,CA,1
NC_037351.1,NC_032673.1,40361088,41918380,41918381,T,TG,1
NC_037351.1,NC_032673.1,40394376,41951654,41951655,T,TA,1
NC_037351.1,NC_032673.1,40394463,41951741,41951742,G,GC,1
NC_037351.1,NC_032673.1,40924289,42482002,42482005,G,GATS,3
NC_037351.1,NC_032673.1,41045904,42603390,42603391,A,AC,1
NC_037351.1,NC_032673.1,41130595,42688324,42688325,a,ac,1
NC_037351.1,NC_032673.1,41130619,42688348,42688349,c,ct,1
NC_037351.1,NC_032673.1,41745183,43336718,43336719,t,tc,1
NC_037351.1,NC_032673.1,41745738,43337270,43337271,t,tg,1
NC_037351.1,NC_032673.1,42033627,43624767,43624768,g,ga,1
NC_037351.1,NC_032673.1,42033713,43624854,43624856,t,taa,2
NC_037351.1,NC_032673.1,42033734,43624877,43624878,g,gS,1
NC_037351.1,NC_032673.1,42063497,43654642,43654643,a,ac,1
NC_037351.1,NC_032673.1,42195042,43785579,43785580,G,GK,1
NC_037351.1,NC_032673.1,42423232,44016204,44016205,C,CK,1
NC_037351.1,NC_032673.1,42449587,44042735,44042736,G,GA,1
NC_037351.1,NC_032673.1,42455614,44048764,44048765,A,AG,1
NC_037351.1,NC_032673.1,42472176,44065327,44065328,C,CA,1
NC_037351.1,NC_032673.1,42640466,44233620,44233621,g,ga,1
NC_037351.1,NC_032673.1,42690725,44283678,44283679,C,CG,1
NC_037351.1,NC_032673.1,42737044,44329993,44329994,c,ca,1
NC_037351.1,NC_032673.1,42787591,44379933,44379935,G,GGR,2
NC_037351.1,NC_032673.1,43406576,44998687,44998688,t,ta,1
NC_037351.1,NC_032673.1,43457237,45049350,45049411,a,atccagccatctccctCAGCTCCGAGCCGCCTCCCTNNNNNNNNNNNNNNNNNNNGGGTggg,61
NC_037351.1,NC_032673.1,43647654,45236516,45236522,g,gaaatga,6
NC_037351.1,NC_032673.1,43652070,45240920,45240921,G,GT,1
NC_037351.1,NC_032673.1,43695348,45287625,45287626,G,GK,1
NC_037351.1,NC_032673.1,43714536,45306434,45306435,C,CT,1
NC_037351.1,NC_032673.1,43719452,45311351,45311357,c,cgaAGGT,6
NC_037351.1,NC_032673.1,43768819,45363629,45363638,g,gaggaaatga,9
NC_037351.1,NC_032673.1,43931810,45458116,45458117,a,at,1
NC_037351.1,NC_032673.1,44086696,45614773,45614774,T,TC,1
NC_037351.1,NC_032673.1,44169363,45697442,45697443,T,TA,1
NC_037351.1,NC_032673.1,44316193,45869710,45869711,t,tg,1
NC_037351.1,NC_032673.1,44372432,45925951,45925952,c,ct,1
NC_037351.1,NC_032673.1,44578060,46135338,46135339,c,ct,1
NC_037351.1,NC_032673.1,44584983,46142263,46142264,T,TK,1
NC_037351.1,NC_032673.1,44593914,46151195,46151196,A,AG,1
NC_037351.1,NC_032673.1,44626977,46184062,46184063,g,gt,1
NC_037351.1,NC_032673.1,44627018,46184104,46184105,c,ct,1
NC_037351.1,NC_032673.1,44690650,46247867,46247868,g,ga,1
NC_037351.1,NC_032673.1,45491850,47042292,47042294,A,ANN,2
NC_037351.1,NC_032673.1,45719366,47270710,47270714,t,ttgac,4
NC_037351.1,NC_032673.1,45719366,47276939,47276943,t,ttgac,4
NC_037351.1,NC_032673.1,45837452,47448673,47448694,C,CNNNNNNNNNNNNNNNNNNNNN,21
NC_037351.1,NC_032673.1,45862322,47473565,47473567,T,TCC,2
NC_037351.1,NC_032673.1,45954644,47567040,47567041,G,GC,1
NC_037351.1,NC_032673.1,46025991,47638354,47638365,g,gcatcattccct,11
NC_037351.1,NC_032673.1,46284383,47903046,47903047,g,ga,1
NC_037351.1,NC_032673.1,46327160,48009218,48009219,C,CA,1
NC_037351.1,NC_032673.1,46406703,48088762,48088763,g,ga,1
NC_037351.1,NC_032673.1,46599265,48282725,48282726,A,AN,1
NC_037351.1,NC_032673.1,46618811,48288481,48288482,c,ca,1
NC_037351.1,NC_032673.1,46618879,48288550,48288552,c,caa,2
NC_037351.1,NC_032673.1,46836269,48508372,48508373,t,tg,1
NC_037351.1,NC_032673.1,46858036,48530140,48530141,A,AW,1
NC_037351.1,NC_032673.1,47005652,48717858,48717859,T,TK,1
NC_037351.1,NC_032673.1,47045279,48760634,48760635,c,ct,1
NC_037351.1,NC_032673.1,47304101,49003179,49003180,G,GT,1
NC_037351.1,NC_032673.1,47304162,49003241,49003242,A,AT,1
NC_037351.1,NC_032673.1,47411187,49114032,49114034,c,ccg,2
NC_037351.1,NC_032673.1,47427628,49130469,49130470,C,CT,1
NC_037351.1,NC_032673.1,47427778,49130620,49130621,G,GA,1
NC_037351.1,NC_032673.1,47439398,49142242,49142243,t,tc,1
NC_037351.1,NC_032673.1,47584041,49438896,49438897,T,TC,1
NC_037351.1,NC_032673.1,47590875,49445733,49445734,A,AM,1
NC_037351.1,NC_032673.1,47622775,49182103,49182104,A,AM,1
NC_037351.1,NC_032673.1,47769892,49329612,49329613,A,AG,1
NC_037351.1,NC_032673.1,47790526,49350247,49350248,G,GA,1
NC_037351.1,NC_032673.1,47807215,49366936,49366937,T,TA,1
NC_037351.1,NC_032673.1,48041895,49706294,49706295,A,AM,1
NC_037351.1,NC_032673.1,48263805,49927594,49927595,C,CT,1
NC_037351.1,NC_032673.1,48360075,50024380,50024381,c,cg,1
NC_037351.1,NC_032673.1,48392552,50056859,50056860,G,GC,1
NC_037351.1,NC_032673.1,48398664,50063115,50063116,c,cg,1
NC_037351.1,NC_032673.1,48587808,50252108,50252109,C,CM,1
NC_037351.1,NC_032673.1,48620865,50285060,50285061,T,TY,1
NC_037351.1,NC_032673.1,48900332,50564378,50564381,g,ggtt,3
NC_037351.1,NC_032673.1,48900485,50564533,50564534,c,ct,1
NC_037351.1,NC_032673.1,48903422,50567472,50567474,a,aat,2
NC_037351.1,NC_032673.1,49157173,50822104,50822122,T,TCNNNNNNNNNNNNNNNNN,18
NC_037351.1,NC_032673.1,49214322,50883990,50883991,C,CS,1
NC_037351.1,NC_032673.1,49298092,51023601,51023602,c,ca,1
NC_037351.1,NC_032673.1,49305281,51030790,51030791,g,ga,1
NC_037351.1,NC_032673.1,49362839,51088349,51088350,t,tc,1
NC_037351.1,NC_032673.1,49611182,51363609,51363610,g,ga,1
NC_037351.1,NC_032673.1,49696207,51448638,51448639,C,CT,1
NC_037351.1,NC_032673.1,49731443,51483982,51483983,G,GT,1
NC_037351.1,NC_032673.1,50177813,51868136,51868137,T,TW,1
NC_037351.1,NC_032673.1,50186046,51875174,51875175,a,ag,1
NC_037351.1,NC_032673.1,50850921,52587632,52587633,c,ca,1
NC_037351.1,NC_032673.1,50944760,52682236,52682238,g,gga,2
NC_037351.1,NC_032673.1,51032121,52769601,52769602,G,GC,1
NC_037351.1,NC_032673.1,51111935,52849827,52849828,t,tc,1
NC_037351.1,NC_032673.1,51304765,53042672,53042673,T,TW,1
NC_037351.1,NC_032673.1,51335800,53073709,53073711,a,aNN,2
NC_037351.1,NC_032673.1,51543496,53623127,53623128,T,TA,1
NC_037351.1,NC_032673.1,51581566,53662565,53662567,a,aag,2
NC_037351.1,NC_032673.1,51581566,53383960,53383962,a,aag,2
NC_037351.1,NC_032673.1,51747229,53853751,53853752,a,at,1
NC_037351.1,NC_032673.1,51770020,53876544,53876546,t,tNN,2
NC_037351.1,NC_032673.1,51895085,54002087,54002088,T,TY,1
NC_037351.1,NC_032673.1,51910874,54017837,54017838,t,ta,1
NC_037351.1,NC_032673.1,52271267,54314488,54314489,a,at,1
NC_037351.1,NC_032673.1,52329024,54372244,54372245,G,GK,1
NC_037351.1,NC_032673.1,52443092,54486352,54486353,A,At,1
NC_037351.1,NC_032673.1,52449376,54492639,54492640,c,ct,1
NC_037351.1,NC_032673.1,52449399,54492663,54492664,c,ct,1
NC_037351.1,NC_032673.1,52523203,54566591,54566592,a,ag,1
NC_037351.1,NC_032673.1,52680272,54723731,54723732,G,GR,1
NC_037351.1,NC_032673.1,52680282,54723742,54723743,C,CA,1
NC_037351.1,NC_032673.1,52680444,54723907,54723909,C,CCG,2
NC_037351.1,NC_032673.1,52699456,54749009,54749010,t,tW,1
NC_037351.1,NC_032673.1,52890478,54939929,54939930,G,GR,1
NC_037351.1,NC_032673.1,52921101,54970597,54970598,a,aM,1
NC_037351.1,NC_032673.1,52945572,54995070,54995071,g,ga,1
NC_037351.1,NC_032673.1,52946017,54995516,54995518,C,CTG,2
NC_037351.1,NC_032673.1,53111371,55157985,55157986,t,tg,1
NC_037351.1,NC_032673.1,53179593,55230747,55230754,g,gggaggga,7
NC_037351.1,NC_032673.1,53367831,55417040,55417041,A,AT,1
NC_037351.1,NC_032673.1,53458404,55507613,55507614,T,TK,1
NC_037351.1,NC_032673.1,53646543,55743602,55743603,A,AC,1
NC_037351.1,NC_032673.1,53867158,55962915,55962916,a,ac,1
NC_037351.1,NC_032673.1,53903101,55998859,55998860,C,CG,1
NC_037351.1,NC_032673.1,54425014,56497102,56497103,c,ct,1
NC_037351.1,NC_032673.1,54558504,56630580,56630581,g,ga,1
NC_037351.1,NC_032673.1,54576079,56648460,56648461,G,GS,1
NC_037351.1,NC_032673.1,54631961,56721399,56721400,G,GY,1
NC_037351.1,NC_032673.1,54669931,56759374,56759376,C,CSW,2
NC_037351.1,NC_032673.1,54852322,56940837,56940838,C,CA,1
NC_037351.1,NC_032673.1,54997635,57128211,57128212,C,CA,1
NC_037351.1,NC_032673.1,55131664,57261647,57261660,T,TTAGATACTCTTAA,13
NC_037351.1,NC_032673.1,55146365,57277086,57277087,T,TA,1
NC_037351.1,NC_032673.1,55146394,57277116,57277117,G,GA,1
NC_037351.1,NC_032673.1,55154934,57285601,57285602,T,TY,1
NC_037351.1,NC_032673.1,55198545,57329201,57329203,a,aNN,2
NC_037351.1,NC_032673.1,55735824,57965364,57965365,C,CA,1
NC_037351.1,NC_032673.1,55765091,57994510,57994511,A,AG,1
NC_037351.1,NC_032673.1,55765197,57994617,57994629,a,aaaNNNNNNNNNN,12
NC_037351.1,NC_032673.1,55770034,57999467,57999468,a,at,1
NC_037351.1,NC_032673.1,55781029,58010465,58010466,a,at,1
NC_037351.1,NC_032673.1,55799520,58029740,58029741,g,ga,1
NC_037351.1,NC_032673.1,55800671,58030892,58030893,t,tg,1
NC_037351.1,NC_032673.1,55842895,58072470,58072476,t,tSacaca,6
NC_037351.1,NC_032673.1,55843729,58073310,58073311,T,TA,1
NC_037351.1,NC_032673.1,55893700,58123282,58123283,a,ac,1
NC_037351.1,NC_032673.1,55898666,58128249,58128250,a,ac,1
NC_037351.1,NC_032673.1,55919149,58148732,58148733,A,AC,1
NC_037351.1,NC_032673.1,55960017,58189417,58189418,G,GA,1
NC_037351.1,NC_032673.1,55973599,58203003,58203004,a,ag,1
NC_037351.1,NC_032673.1,55977843,58207229,58207230,A,AG,1
NC_037351.1,NC_032673.1,55986328,58215714,58215715,A,AC,1
NC_037351.1,NC_032673.1,55988855,58218242,58218243,C,CT,1
NC_037351.1,NC_032673.1,56059154,58288720,58288723,T,TAGC,3
NC_037351.1,NC_032673.1,56075655,58305225,58305226,C,CG,1
NC_037351.1,NC_032673.1,56100287,58329876,58329878,a,atg,2
NC_037351.1,NC_032673.1,56100749,58330340,58330342,C,CTG,2
NC_037351.1,NC_032673.1,56100820,58330413,58330419,A,ATTGTCC,6
NC_037351.1,NC_032673.1,56102104,58331703,58331704,C,CM,1
NC_037351.1,NC_032673.1,56141864,58371209,58371210,T,TY,1
NC_037351.1,NC_032673.1,56166406,58395302,58395307,T,TTTCTG,5
NC_037351.1,NC_032673.1,56233792,58708849,58708850,G,GA,1
NC_037351.1,NC_032673.1,56246493,58475906,58475944,g,gNNNNNNNNNNNNNNNNNNNNNNNNNNNNNNNNNNNNNN,38
NC_037351.1,NC_032673.1,56337709,58576831,58576832,T,TG,1
NC_037351.1,NC_032673.1,56340656,58579784,58579785,G,GA,1
NC_037351.1,NC_032673.1,56342702,58581831,58581832,T,TG,1
NC_037351.1,NC_032673.1,56345662,58584787,58584789,T,TTG,2
NC_037351.1,NC_032673.1,56347441,58586569,58586570,t,tc,1
NC_037351.1,NC_032673.1,56348356,58587484,58587485,c,ct,1
NC_037351.1,NC_032673.1,56348864,58587993,58587994,g,gt,1
NC_037351.1,NC_032673.1,56382055,58621195,58621197,T,TTC,2
NC_037351.1,NC_032673.1,56382132,58621275,58621276,A,AC,1
NC_037351.1,NC_032673.1,56424784,58663948,58663949,C,CT,1
NC_037351.1,NC_032673.1,56424848,58664013,58664014,A,AG,1
NC_037351.1,NC_032673.1,56512999,58796228,58796229,G,GA,1
NC_037351.1,NC_032673.1,56931764,59244222,59244223,c,ct,1
NC_037351.1,NC_032673.1,57044402,59362900,59362901,c,ca,1
NC_037351.1,NC_032673.1,57044575,59363074,59363076,c,cag,2
NC_037351.1,NC_032673.1,57044772,59363273,59363275,a,agg,2
NC_037351.1,NC_032673.1,57379550,59653763,59653765,T,TTK,2
NC_037351.1,NC_032673.1,57395924,59670139,59670140,t,ta,1
NC_037351.1,NC_032673.1,58117384,60454343,60454344,C,CS,1
NC_037351.1,NC_032673.1,58537827,60903785,60903786,c,ct,1
NC_037351.1,NC_032673.1,58657588,61023383,61023384,C,CG,1
NC_037351.1,NC_032673.1,58659644,61025440,61025441,T,TC,1
NC_037351.1,NC_032673.1,58689701,61055498,61055499,t,ta,1
NC_037351.1,NC_032673.1,59039318,61566822,61566823,C,CT,1
NC_037351.1,NC_032673.1,59041968,61569118,61569120,g,gca,2
NC_037351.1,NC_032673.1,59183595,61742850,61742853,t,tNNN,3
NC_037351.1,NC_032673.1,59345359,61904042,61904058,a,aggatagatcacatcct,16
NC_037351.1,NC_032673.1,59345526,61904225,61904237,g,gaagaaatcaaaa,12
NC_037351.1,NC_032673.1,59348067,61906778,61906779,a,ac,1
NC_037351.1,NC_032673.1,59369232,61927944,61927945,c,ct,1
NC_037351.1,NC_032673.1,59477146,62037671,62037673,a,aNN,2
NC_037351.1,NC_032673.1,59542361,62102888,62102889,a,ag,1
NC_037351.1,NC_032673.1,59542370,62102898,62102899,g,ga,1
NC_037351.1,NC_032673.1,59600287,62160534,62160535,T,TA,1
NC_037351.1,NC_032673.1,59734111,62294281,62294282,T,TG,1
NC_037351.1,NC_032673.1,59887859,62449249,62449250,G,GT,1
NC_037351.1,NC_032673.1,60259784,62823993,62823994,G,GT,1
NC_037351.1,NC_032673.1,60557471,63204173,63204174,t,tg,1
NC_037351.1,NC_032673.1,60558142,63204845,63204846,g,gc,1
NC_037351.1,NC_032673.1,60617709,63264404,63264405,G,GR,1
NC_037351.1,NC_032673.1,60736777,63383427,63383428,C,CS,1
NC_037351.1,NC_032673.1,60871041,63518336,63518337,a,ac,1
NC_037351.1,NC_032673.1,60920881,63568513,63568515,t,tNN,2
NC_037351.1,NC_032673.1,61127004,63774568,63774569,C,CG,1
NC_037351.1,NC_032673.1,61207836,63855264,63855265,C,CS,1
NC_037351.1,NC_032673.1,61210453,63857855,63857856,T,TA,1
NC_037351.1,NC_032673.1,61383442,63992388,63992389,a,ac,1
NC_037351.1,NC_032673.1,61441171,64062880,64062881,C,CG,1
NC_037351.1,NC_032673.1,61442789,64064501,64064503,T,TTC,2
NC_037351.1,NC_032673.1,61545190,64168183,64168185,A,AAS,2
NC_037351.1,NC_032673.1,61572996,64195988,64195992,t,tNNNN,4
NC_037351.1,NC_032673.1,61577123,64200118,64200119,a,ag,1
NC_037351.1,NC_032673.1,61786183,64429807,64429808,A,AG,1
NC_037351.1,NC_032673.1,61808687,64452312,64452313,a,ac,1
NC_037351.1,NC_032673.1,61820998,64464637,64464640,t,ttgg,3
NC_037351.1,NC_032673.1,61822064,64465633,64465638,t,tctgtg,5
NC_037351.1,NC_032673.1,61822255,64465829,64465832,t,ttaa,3
NC_037351.1,NC_032673.1,61824819,64468395,64468396,g,ga,1
NC_037351.1,NC_032673.1,61831204,64474778,64474794,C,CACCAAGCTCATGGACG,16
NC_037351.1,NC_032673.1,61847780,64491377,64491378,C,CT,1
NC_037351.1,NC_032673.1,61864554,64525185,64525186,G,GC,1
NC_037351.1,NC_032673.1,61866179,64526793,64526794,C,CA,1
NC_037351.1,NC_032673.1,61868457,64529065,64529066,C,CT,1
NC_037351.1,NC_032673.1,61869489,64530098,64530099,T,TA,1
NC_037351.1,NC_032673.1,61873006,64533616,64533619,t,ttta,3
NC_037351.1,NC_032673.1,61873014,64533627,64533633,a,aaatttt,6
NC_037351.1,NC_032673.1,61874815,64535416,64535440,c,cctacacctctgactttacgggggg,24
NC_037351.1,NC_032673.1,61877830,64538442,64538443,A,AG,1
NC_037351.1,NC_032673.1,61884607,64561941,64561951,T,TCCAGAGTTTA,10
NC_037351.1,NC_032673.1,61921530,64659958,64659959,a,at,1
NC_037351.1,NC_032673.1,61921571,64660000,64660001,a,ac,1
NC_037351.1,NC_032673.1,61922305,64660734,64660736,T,TGA,2
NC_037351.1,NC_032673.1,61922914,64734070,64734071,A,AC,1
NC_037351.1,NC_032673.1,61922915,64661346,64661347,C,CA,1
NC_037351.1,NC_032673.1,61924263,64662694,64662709,A,ANNNNNNNNNNNNNNN,15
NC_037351.1,NC_032673.1,61926208,64664654,64664658,g,gacaa,4
NC_037351.1,NC_032673.1,61926208,64737380,64737384,g,gacaa,4
NC_037351.1,NC_032673.1,61964178,64775339,64775341,g,gct,2
NC_037351.1,NC_032673.1,61971637,64782784,64782785,C,CG,1
NC_037351.1,NC_032673.1,61992232,64803309,64803310,c,ca,1
NC_037351.1,NC_032673.1,62029272,64844403,64844404,a,at,1
NC_037351.1,NC_032673.1,62068852,64883987,64883988,A,AT,1
NC_037351.1,NC_032673.1,62091705,64906872,64906874,a,att,2
NC_037351.1,NC_032673.1,62096659,64911831,64911832,G,GS,1
NC_037351.1,NC_032673.1,62107893,64923065,64923066,c,ct,1
