Reference ID,Query ID,Reference POS,Query POS,Query END,REF,ALT,SVLEN
NC_037332.1,NC_032654.1,124004,10689,10690,G,GR,1
NC_037332.1,NC_032654.1,138058,24696,24697,T,TC,1
NC_037332.1,NC_032654.1,163357,50004,50008,a,aaaac,4
NC_037332.1,NC_032654.1,169870,56522,56523,t,tW,1
NC_037332.1,NC_032654.1,214144,100146,100148,A,AAT,2
NC_037332.1,NC_032654.1,221885,107887,107888,A,AG,1
NC_037332.1,NC_032654.1,223224,109228,109229,T,TG,1
NC_037332.1,NC_032654.1,243539,129558,129559,t,ta,1
NC_037332.1,NC_032654.1,270109,155994,155995,g,gc,1
NC_037332.1,NC_032654.1,287749,173636,173637,t,tW,1
NC_037332.1,NC_032654.1,301468,187342,187343,c,ct,1
NC_037332.1,NC_032654.1,304955,190831,190832,A,AN,1
NC_037332.1,NC_032654.1,310465,196345,196346,G,GA,1
NC_037332.1,NC_032654.1,323349,209231,209234,t,ttta,3
NC_037332.1,NC_032654.1,350743,237734,237735,A,AT,1
NC_037332.1,NC_032654.1,354922,241916,241917,a,at,1
NC_037332.1,NC_032654.1,399242,286268,286270,G,GGT,2
NC_037332.1,NC_032654.1,415159,450843,450844,a,at,1
NC_037332.1,NC_032654.1,451789,487383,487385,t,tta,2
NC_037332.1,NC_032654.1,464470,500072,500073,a,aN,1
NC_037332.1,NC_032654.1,508529,544139,544140,C,CG,1
NC_037332.1,NC_032654.1,521060,433174,433175,G,GT,1
NC_037332.1,NC_032654.1,562728,635320,635321,G,GT,1
NC_037332.1,NC_032654.1,837594,836087,836088,G,GA,1
NC_037332.1,NC_032654.1,844363,842855,842864,C,CCAAAGCTTY,9
NC_037332.1,NC_032654.1,847920,846426,846427,T,TK,1
NC_037332.1,NC_032654.1,868894,867270,867272,A,ATG,2
NC_037332.1,NC_032654.1,885748,884046,884047,T,TG,1
NC_037332.1,NC_032654.1,888168,886467,886554,t,ttcctcatcactctctgccataaaggGTGGTGTCATNNNNNNNNNNNNNNNNNNNNNNNNNNNNNNNNNNNNNNNNACCAGTCACGgg,87
NC_037332.1,NC_032654.1,923267,922079,922080,a,at,1
NC_037332.1,NC_032654.1,944909,943734,943735,c,ct,1
NC_037332.1,NC_032654.1,955886,954722,954724,c,cct,2
NC_037332.1,NC_032654.1,1053939,1053128,1053129,c,ca,1
NC_037332.1,NC_032654.1,1145999,1143881,1143882,G,GA,1
NC_037332.1,NC_032654.1,1163461,1161358,1161359,A,AG,1
NC_037332.1,NC_032654.1,1183610,1181506,1181507,A,AR,1
NC_037332.1,NC_032654.1,1184377,1182274,1182275,a,aW,1
NC_037332.1,NC_032654.1,1185818,1183719,1183723,T,TGGTG,4
NC_037332.1,NC_032654.1,1186200,1184105,1184106,T,TC,1
NC_037332.1,NC_032654.1,1206332,1204262,1204263,a,at,1
NC_037332.1,NC_032654.1,1356590,1354342,1354344,a,aNN,2
NC_037332.1,NC_032654.1,1356618,1354372,1354373,a,at,1
NC_037332.1,NC_032654.1,1363077,1360863,1360865,g,ggt,2
NC_037332.1,NC_032654.1,1439475,1488004,1488005,G,GR,1
NC_037332.1,NC_032654.1,1455034,1503595,1503596,A,AR,1
NC_037332.1,NC_032654.1,1465930,1514489,1514490,c,ca,1
NC_037332.1,NC_032654.1,1503207,1562978,1562982,c,caact,4
NC_037332.1,NC_032654.1,1642537,1741683,1741699,t,tctatacacacacacac,16
NC_037332.1,NC_032654.1,1645205,1744367,1744368,C,CA,1
NC_037332.1,NC_032654.1,1658497,1757661,1757662,c,ct,1
NC_037332.1,NC_032654.1,1666325,1765489,1765490,a,ac,1
NC_037332.1,NC_032654.1,1670494,1769672,1769673,G,GA,1
NC_037332.1,NC_032654.1,1681499,1780683,1780684,c,ca,1
NC_037332.1,NC_032654.1,1687866,1787097,1787100,t,tagc,3
NC_037332.1,NC_032654.1,1703696,1802935,1802937,c,cag,2
NC_037332.1,NC_032654.1,1704671,1803913,1803914,g,ga,1
NC_037332.1,NC_032654.1,1712863,1812095,1812100,a,atacag,5
NC_037332.1,NC_032654.1,1712863,1678645,1678650,a,atacag,5
NC_037332.1,NC_032654.1,1713081,1812318,1812319,t,tg,1
NC_037332.1,NC_032654.1,1713081,1678868,1678869,t,tg,1
NC_037332.1,NC_032654.1,1720607,1687043,1687048,g,gtgaac,5
NC_037332.1,NC_032654.1,1720607,1820491,1820496,g,gtgaac,5
NC_037332.1,NC_032654.1,1723990,1690431,1690433,c,ctt,2
NC_037332.1,NC_032654.1,1723990,1823865,1823867,c,ctt,2
NC_037332.1,NC_032654.1,1729814,1829694,1829695,G,GC,1
NC_037332.1,NC_032654.1,1763944,1863369,1863370,t,tc,1
NC_037332.1,NC_032654.1,1810576,1910009,1910010,t,ta,1
NC_037332.1,NC_032654.1,1813407,1912841,1912842,A,AC,1
NC_037332.1,NC_032654.1,1834660,1934279,1934280,A,AG,1
NC_037332.1,NC_032654.1,1849508,1950174,1950175,g,gR,1
NC_037332.1,NC_032654.1,1858217,1958875,1958876,t,tc,1
NC_037332.1,NC_032654.1,1858395,1959054,1959055,t,tg,1
NC_037332.1,NC_032654.1,1862285,1962944,1962945,A,AG,1
NC_037332.1,NC_032654.1,1864662,1965322,1965324,a,agt,2
NC_037332.1,NC_032654.1,1894809,1995306,1995307,A,AC,1
NC_037332.1,NC_032654.1,1899218,1999715,1999727,t,taaaatttaaaaa,12
NC_037332.1,NC_032654.1,1899239,1999748,1999749,a,ac,1
NC_037332.1,NC_032654.1,1910392,2010905,2010906,g,ga,1
NC_037332.1,NC_032654.1,1911262,2011776,2011778,C,CAG,2
NC_037332.1,NC_032654.1,1911553,2012069,2012073,C,CACTY,4
NC_037332.1,NC_032654.1,1915928,2016447,2016448,G,GA,1
NC_037332.1,NC_032654.1,1916409,2016929,2016930,a,at,1
NC_037332.1,NC_032654.1,1940102,2040620,2040622,a,att,2
NC_037332.1,NC_032654.1,1953913,2054431,2054432,A,AG,1
NC_037332.1,NC_032654.1,2028107,2128625,2128627,t,tNN,2
NC_037332.1,NC_032654.1,2034405,2134926,2134928,C,CTG,2
NC_037332.1,NC_032654.1,2036165,2136689,2136690,c,ct,1
NC_037332.1,NC_032654.1,2036955,2137480,2137481,a,ac,1
NC_037332.1,NC_032654.1,2043965,2740091,2740093,t,taa,2
NC_037332.1,NC_032654.1,2053452,2749583,2749585,T,TTG,2
NC_037332.1,NC_032654.1,2061804,2757942,2757950,t,tNNNNNNNN,8
NC_037332.1,NC_032654.1,2064814,2760952,2760953,t,tc,1
NC_037332.1,NC_032654.1,2075480,2771606,2771620,C,CTTGTAAAGCTGTTY,14
NC_037332.1,NC_032654.1,2104767,2800916,2800940,t,tcctgcattgtaggcagacgcttta,24
NC_037332.1,NC_032654.1,2113148,2809304,2809310,T,TGTTTAA,6
NC_037332.1,NC_032654.1,2123283,2819442,2819444,c,cca,2
NC_037332.1,NC_032654.1,2163193,2181962,2181963,T,TC,1
NC_037332.1,NC_032654.1,2173240,2190705,2190706,C,CA,1
NC_037332.1,NC_032654.1,2210603,2259529,2259531,c,ctg,2
NC_037332.1,NC_032654.1,2255108,2304180,2304181,G,GT,1
NC_037332.1,NC_032654.1,2275620,2325396,2325403,a,accctcct,7
NC_037332.1,NC_032654.1,2319929,2369711,2369712,t,ta,1
NC_037332.1,NC_032654.1,2320944,2370727,2370728,t,tc,1
NC_037332.1,NC_032654.1,2330541,2380328,2380330,t,taa,2
NC_037332.1,NC_032654.1,2343143,2392951,2392952,t,ta,1
NC_037332.1,NC_032654.1,2352402,2402207,2402208,G,GC,1
NC_037332.1,NC_032654.1,2412798,2462719,2462721,c,ctg,2
NC_037332.1,NC_032654.1,2435078,2492062,2492063,a,ag,1
NC_037332.1,NC_032654.1,2457215,2514205,2514207,C,CAT,2
NC_037332.1,NC_032654.1,2471645,2528641,2528642,G,GT,1
NC_037332.1,NC_032654.1,2472136,2529133,2529135,c,caa,2
NC_037332.1,NC_032654.1,2494901,2551902,2551903,G,GC,1
NC_037332.1,NC_032654.1,2494965,2551966,2551967,C,CT,1
NC_037332.1,NC_032654.1,2519791,2577345,2577346,T,TC,1
NC_037332.1,NC_032654.1,2639074,2682517,2682518,c,ct,1
NC_037332.1,NC_032654.1,2694448,2866688,2866690,C,CTA,2
NC_037332.1,NC_032654.1,2696432,2868672,2868673,t,tc,1
NC_037332.1,NC_032654.1,2697324,2869565,2869566,a,at,1
NC_037332.1,NC_032654.1,2721986,2894283,2894291,a,atgtgtgtg,8
NC_037332.1,NC_032654.1,2725236,2897541,2897553,A,AAATACAAACAAT,12
NC_037332.1,NC_032654.1,2783745,2956047,2956049,t,taa,2
NC_037332.1,NC_032654.1,2786189,2958493,2958515,C,CAGATTAAATGTCAGATTAAATT,22
NC_037332.1,NC_032654.1,2796923,2969250,2969251,A,AC,1
NC_037332.1,NC_032654.1,2808613,2980944,2980959,t,ttctgaaagagatggg,15
NC_037332.1,NC_032654.1,2814878,2987224,2987225,t,tN,1
NC_037332.1,NC_032654.1,2817123,2989470,2989475,t,tcactg,5
NC_037332.1,NC_032654.1,2817475,2989827,2989838,a,ataaatatatat,11
NC_037332.1,NC_032654.1,2817581,2989944,2989945,a,at,1
NC_037332.1,NC_032654.1,2817848,2990214,2990215,c,ca,1
NC_037332.1,NC_032654.1,2850867,3023290,3023291,g,gt,1
NC_037332.1,NC_032654.1,2930949,3161818,3161821,t,tctc,3
NC_037332.1,NC_032654.1,2945301,3177033,3177034,T,TC,1
NC_037332.1,NC_032654.1,2954483,3186217,3186218,T,TA,1
NC_037332.1,NC_032654.1,2954850,3186585,3186588,A,ACYC,3
NC_037332.1,NC_032654.1,2959343,3191740,3191741,a,ag,1
NC_037332.1,NC_032654.1,2959423,3191821,3191822,g,gt,1
NC_037332.1,NC_032654.1,2981535,3213852,3213854,a,aat,2
NC_037332.1,NC_032654.1,3033119,3265717,3265719,t,tca,2
NC_037332.1,NC_032654.1,3044632,3277239,3277240,c,ct,1
NC_037332.1,NC_032654.1,3053657,3286266,3286268,t,tNN,2
NC_037332.1,NC_032654.1,3058041,3290656,3290657,t,tc,1
NC_037332.1,NC_032654.1,3058227,3290846,3290847,t,ta,1
NC_037332.1,NC_032654.1,3069296,3301921,3301922,C,CY,1
NC_037332.1,NC_032654.1,3075431,3308061,3308062,t,ta,1
NC_037332.1,NC_032654.1,3075458,3308089,3308091,t,ttc,2
NC_037332.1,NC_032654.1,3166347,3405007,3405008,a,at,1
NC_037332.1,NC_032654.1,3208579,3499560,3499561,A,AC,1
NC_037332.1,NC_032654.1,3264176,3554118,3554119,a,at,1
NC_037332.1,NC_032654.1,3265886,3555826,3555827,c,ct,1
NC_037332.1,NC_032654.1,3268608,3558558,3558559,A,AC,1
NC_037332.1,NC_032654.1,3269074,3559027,3559028,a,at,1
NC_037332.1,NC_032654.1,3272285,3562217,3562225,t,tNNNNNNNN,8
NC_037332.1,NC_032654.1,3272812,3562753,3562754,g,gt,1
NC_037332.1,NC_032654.1,3289394,3579334,3579336,a,aag,2
NC_037332.1,NC_032654.1,3328421,3618370,3618371,g,ga,1
NC_037332.1,NC_032654.1,3353179,3643130,3643131,A,AC,1
NC_037332.1,NC_032654.1,3358796,3648747,3648748,C,CA,1
NC_037332.1,NC_032654.1,3361281,3651233,3651234,t,ta,1
NC_037332.1,NC_032654.1,3363637,3653594,3653596,t,tta,2
NC_037332.1,NC_032654.1,3364684,3654643,3654644,A,AC,1
NC_037332.1,NC_032654.1,3364774,3654736,3654738,T,TTC,2
NC_037332.1,NC_032654.1,3367648,3657611,3657612,T,TG,1
NC_037332.1,NC_032654.1,3387190,3668800,3668813,c,cttttcacttgcat,13
NC_037332.1,NC_032654.1,3387311,3668934,3668937,t,tagc,3
NC_037332.1,NC_032654.1,3390502,3672137,3672138,T,TC,1
NC_037332.1,NC_032654.1,3391216,3672852,3672854,c,ctg,2
NC_037332.1,NC_032654.1,3394388,3676025,3676029,g,gagta,4
NC_037332.1,NC_032654.1,3410439,3692101,3692102,G,GN,1
NC_037332.1,NC_032654.1,3419334,3700997,3700999,t,tNN,2
NC_037332.1,NC_032654.1,3433194,3714861,3714862,a,at,1
NC_037332.1,NC_032654.1,3500277,3789008,3789009,A,AW,1
NC_037332.1,NC_032654.1,3501247,3789979,3789980,G,GA,1
NC_037332.1,NC_032654.1,3527216,3815957,3815958,t,ta,1
NC_037332.1,NC_032654.1,3533082,3819786,3819787,c,ct,1
NC_037332.1,NC_032654.1,3533949,3820654,3820655,a,ag,1
NC_037332.1,NC_032654.1,3628566,3916188,3916189,A,AC,1
NC_037332.1,NC_032654.1,3635945,3923556,3923557,t,ta,1
NC_037332.1,NC_032654.1,3635948,3923560,3923561,c,ca,1
NC_037332.1,NC_032654.1,3642733,3930349,3930353,T,TTGAC,4
NC_037332.1,NC_032654.1,3729628,4017255,4017256,t,ta,1
NC_037332.1,NC_032654.1,3767442,4055057,4055058,T,TC,1
NC_037332.1,NC_032654.1,3768790,4056265,4056266,t,tc,1
NC_037332.1,NC_032654.1,3771946,4059261,4059263,a,agt,2
NC_037332.1,NC_032654.1,3771977,4059294,4059296,C,CTG,2
NC_037332.1,NC_032654.1,3779706,4067053,4067054,t,tc,1
NC_037332.1,NC_032654.1,3780008,4067356,4067357,C,CA,1
NC_037332.1,NC_032654.1,3782082,4069432,4069433,A,AC,1
NC_037332.1,NC_032654.1,3910304,4197680,4197685,G,GTTTGT,5
NC_037332.1,NC_032654.1,3930109,4219727,4219728,a,ag,1
NC_037332.1,NC_032654.1,3978067,4267694,4267695,A,AT,1
NC_037332.1,NC_032654.1,4005376,4292730,4292731,G,GA,1
NC_037332.1,NC_032654.1,4005624,4292979,4292984,a,aaaaat,5
NC_037332.1,NC_032654.1,4005660,4293020,4293021,a,at,1
NC_037332.1,NC_032654.1,4018487,4305272,4305273,a,at,1
NC_037332.1,NC_032654.1,4032578,4319366,4319369,t,ttcc,3
NC_037332.1,NC_032654.1,4037432,4324230,4324231,t,tc,1
NC_037332.1,NC_032654.1,4040077,4326898,4326899,T,TA,1
NC_037332.1,NC_032654.1,4041020,4327844,4327845,c,ct,1
NC_037332.1,NC_032654.1,4041248,4328073,4328075,a,aat,2
NC_037332.1,NC_032654.1,4041922,4328749,4328750,T,TY,1
NC_037332.1,NC_032654.1,4042151,4328978,4328979,C,CT,1
NC_037332.1,NC_032654.1,4056133,4342967,4342969,a,aNN,2
NC_037332.1,NC_032654.1,4076840,4363686,4363687,C,CM,1
NC_037332.1,NC_032654.1,4202457,4502189,4502190,g,gt,1
NC_037332.1,NC_032654.1,4246908,4546658,4546659,A,AG,1
NC_037332.1,NC_032654.1,4288224,4587998,4587999,a,at,1
NC_037332.1,NC_032654.1,4289783,4589557,4589560,t,tcta,3
NC_037332.1,NC_032654.1,4290792,4590569,4590570,a,ag,1
NC_037332.1,NC_032654.1,4294254,4594020,4594023,c,ccaa,3
NC_037332.1,NC_032654.1,4322134,4621895,4621918,C,CCCAACTTCCTTTGGTTGAATGTA,23
NC_037332.1,NC_032654.1,4322234,4622018,4622019,T,TY,1
NC_037332.1,NC_032654.1,4333599,4633385,4633386,a,ag,1
NC_037332.1,NC_032654.1,4333632,4633419,4633420,t,tc,1
NC_037332.1,NC_032654.1,4333998,4633786,4633796,g,gtagAACCCCA,10
NC_037332.1,NC_032654.1,4334001,4633799,4633800,t,ta,1
NC_037332.1,NC_032654.1,4366599,4666419,4666430,a,aatcccagggct,11
NC_037332.1,NC_032654.1,4369743,4669600,4669614,a,agggttttttccaat,14
NC_037332.1,NC_032654.1,4374445,4674317,4674318,a,at,1
NC_037332.1,NC_032654.1,4374709,4674582,4674584,A,AAG,2
NC_037332.1,NC_032654.1,4391739,4693946,4693948,T,TAA,2
NC_037332.1,NC_032654.1,4435954,4734811,4734812,G,GT,1
NC_037332.1,NC_032654.1,4437551,4736412,4736413,T,TC,1
NC_037332.1,NC_032654.1,4441997,4740866,4740867,g,gc,1
NC_037332.1,NC_032654.1,4444120,4742990,4742991,g,gt,1
NC_037332.1,NC_032654.1,4447379,4746250,4746251,a,ag,1
NC_037332.1,NC_032654.1,4480546,4778670,4778671,t,tg,1
NC_037332.1,NC_032654.1,4480653,4778778,4778779,T,TC,1
NC_037332.1,NC_032654.1,4483136,4781260,4781261,A,AG,1
NC_037332.1,NC_032654.1,4485141,4783265,4783266,G,GR,1
NC_037332.1,NC_032654.1,4491410,4789537,4789538,c,ct,1
NC_037332.1,NC_032654.1,4565153,4861718,4861719,g,gc,1
NC_037332.1,NC_032654.1,4599853,4896398,4896399,T,TK,1
NC_037332.1,NC_032654.1,4623111,4919653,4919654,c,ct,1
NC_037332.1,NC_032654.1,4625741,4922282,4922299,g,gggACTCCCATAGAGTCt,17
NC_037332.1,NC_032654.1,4674232,4969887,4969888,t,tg,1
NC_037332.1,NC_032654.1,4674416,4970072,4970073,G,GA,1
NC_037332.1,NC_032654.1,4691473,4986796,4986802,c,caaaaaa,6
NC_037332.1,NC_032654.1,4749331,5014684,5014685,T,TG,1
NC_037332.1,NC_032654.1,4749339,5014693,5014694,A,AT,1
NC_037332.1,NC_032654.1,4789177,5054530,5054531,A,AT,1
NC_037332.1,NC_032654.1,4824758,5090115,5090118,c,cttt,3
NC_037332.1,NC_032654.1,4869344,5134718,5134724,t,tgttagc,6
NC_037332.1,NC_032654.1,4883499,5148879,5148881,G,GTA,2
NC_037332.1,NC_032654.1,4892958,5158340,5158342,a,acg,2
NC_037332.1,NC_032654.1,4893086,5158470,5158471,c,ct,1
NC_037332.1,NC_032654.1,4896059,5161450,5161451,A,AT,1
NC_037332.1,NC_032654.1,4910958,5179554,5179567,t,ttctttgtgtttga,13
NC_037332.1,NC_032654.1,4911513,5180119,5180123,c,cctat,4
NC_037332.1,NC_032654.1,4928453,5197035,5197036,a,ag,1
NC_037332.1,NC_032654.1,4942404,5210981,5210989,T,TNNNNNNNN,8
NC_037332.1,NC_032654.1,4980870,5249472,5249475,C,CTAT,3
NC_037332.1,NC_032654.1,4998762,5267370,5267372,c,cat,2
NC_037332.1,NC_032654.1,5074278,5342854,5342855,A,AT,1
NC_037332.1,NC_032654.1,5106775,5375347,5375348,a,ac,1
NC_037332.1,NC_032654.1,5158432,5427064,5427065,C,CA,1
NC_037332.1,NC_032654.1,5177500,5439332,5439333,a,ac,1
NC_037332.1,NC_032654.1,5178223,5440055,5440059,G,GTATT,4
NC_037332.1,NC_032654.1,5181665,5443502,5443503,G,GT,1
NC_037332.1,NC_032654.1,5194159,5456028,5456029,t,ta,1
NC_037332.1,NC_032654.1,5196937,5458806,5458807,T,TY,1
NC_037332.1,NC_032654.1,5199802,5461720,5461736,G,GCCATTCAGTATTTAGR,16
NC_037332.1,NC_032654.1,5208902,5470831,5470837,C,CTAAATA,6
NC_037332.1,NC_032654.1,5216771,5478706,5478707,T,TG,1
NC_037332.1,NC_032654.1,5218534,5480466,5480467,t,tg,1
NC_037332.1,NC_032654.1,5230168,5492100,5492124,a,agctggGTCTATCTTCCCAACCTTC,24
NC_037332.1,NC_032654.1,5231529,5493485,5493487,C,CAT,2
NC_037332.1,NC_032654.1,5233452,5495405,5495407,T,TTK,2
NC_037332.1,NC_032654.1,5305624,5522736,5522740,t,taaaa,4
NC_037332.1,NC_032654.1,5324966,5628678,5628679,G,GA,1
NC_037332.1,NC_032654.1,5357655,5661370,5661371,G,GC,1
NC_037332.1,NC_032654.1,5432579,5736807,5736809,t,tta,2
NC_037332.1,NC_032654.1,5432587,5736817,5736818,t,ta,1
NC_037332.1,NC_032654.1,5448944,5813055,5813056,t,ta,1
NC_037332.1,NC_032654.1,5450388,5814500,5814513,A,ACCAGNNNNNNNNN,13
NC_037332.1,NC_032654.1,5451319,5815444,5815446,C,CTT,2
NC_037332.1,NC_032654.1,5459901,5764144,5764148,c,ctttt,4
NC_037332.1,NC_032654.1,5459901,5824028,5824032,c,ctttt,4
NC_037332.1,NC_032654.1,5490913,5855048,5855049,t,tg,1
NC_037332.1,NC_032654.1,5503403,5869774,5869775,C,CA,1
NC_037332.1,NC_032654.1,5503616,5869988,5869989,a,ag,1
NC_037332.1,NC_032654.1,5505309,5871683,5871687,a,actgt,4
NC_037332.1,NC_032654.1,5532669,5899474,5899486,T,TGCTATTTGAARG,12
NC_037332.1,NC_032654.1,5540303,5907120,5907121,c,cM,1
NC_037332.1,NC_032654.1,5561382,5928198,5928199,c,ca,1
NC_037332.1,NC_032654.1,5568156,5934953,5934966,A,AAGGACCGAGAGAR,13
NC_037332.1,NC_032654.1,5576286,5943099,5943100,C,CA,1
NC_037332.1,NC_032654.1,5578193,5945001,5945008,T,TGATTAAC,7
NC_037332.1,NC_032654.1,5581567,5948382,5948384,A,AAC,2
NC_037332.1,NC_032654.1,5611333,5978159,5978160,T,TC,1
NC_037332.1,NC_032654.1,5618211,5985040,5985042,A,AAC,2
NC_037332.1,NC_032654.1,5700099,6054223,6054225,G,GMC,2
NC_037332.1,NC_032654.1,5708504,6062631,6062633,T,TCA,2
NC_037332.1,NC_032654.1,5755213,6096782,6096799,a,agccctgggatttctttg,17
NC_037332.1,NC_032654.1,5756842,6098427,6098428,A,AC,1
NC_037332.1,NC_032654.1,5850638,6247723,6247724,a,at,1
NC_037332.1,NC_032654.1,5965823,6367855,6367873,a,aattcYGCTCCTGGGTact,18
NC_037332.1,NC_032654.1,5989661,6391568,6391569,A,AG,1
NC_037332.1,NC_032654.1,5998122,6400028,6400029,T,TA,1
NC_037332.1,NC_032654.1,6004247,6406168,6406169,G,GT,1
NC_037332.1,NC_032654.1,6011785,6413709,6413712,A,ATGT,3
NC_037332.1,NC_032654.1,6023480,6425286,6425289,A,ACTT,3
NC_037332.1,NC_032654.1,6039566,6441384,6441387,a,aNNN,3
NC_037332.1,NC_032654.1,6040390,6442213,6442215,a,aNN,2
NC_037332.1,NC_032654.1,6155853,6587683,6587685,A,AAG,2
NC_037332.1,NC_032654.1,6464961,6895162,6895164,T,TTC,2
NC_037332.1,NC_032654.1,6465489,6895692,6895694,A,AAG,2
NC_037332.1,NC_032654.1,6497004,6927586,6927587,c,ca,1
NC_037332.1,NC_032654.1,6509469,6940051,6940053,T,TAA,2
NC_037332.1,NC_032654.1,6549795,6980254,6980255,a,ac,1
NC_037332.1,NC_032654.1,6601219,7032093,7032094,T,TC,1
NC_037332.1,NC_032654.1,6635317,7066193,7066194,a,ag,1
NC_037332.1,NC_032654.1,6671005,7102934,7102935,C,CT,1
NC_037332.1,NC_032654.1,6679442,7111372,7111375,a,acaS,3
NC_037332.1,NC_032654.1,6684312,7116245,7116246,g,gc,1
NC_037332.1,NC_032654.1,6686304,7118237,7118238,A,AG,1
NC_037332.1,NC_032654.1,6686355,7118289,7118291,T,TTC,2
NC_037332.1,NC_032654.1,6693110,7125042,7125043,A,AT,1
NC_037332.1,NC_032654.1,6701266,7133199,7133200,a,at,1
NC_037332.1,NC_032654.1,6707307,7139502,7139503,T,TA,1
NC_037332.1,NC_032654.1,6752625,7184147,7184151,A,ACTWW,4
NC_037332.1,NC_032654.1,6788785,7220753,7220755,G,GGC,2
NC_037332.1,NC_032654.1,6790251,7222217,7222221,C,CCCCY,4
NC_037332.1,NC_032654.1,6805348,7237615,7237616,T,TN,1
NC_037332.1,NC_032654.1,6849088,7281360,7281361,T,TY,1
NC_037332.1,NC_032654.1,6849240,7281513,7281514,t,ta,1
NC_037332.1,NC_032654.1,6855071,7287353,7287354,G,GC,1
NC_037332.1,NC_032654.1,6878336,7310614,7310615,a,aW,1
NC_037332.1,NC_032654.1,6915091,7347422,7347425,T,TTTC,3
NC_037332.1,NC_032654.1,7029813,7470876,7470891,t,tggggaagggaaggga,15
NC_037332.1,NC_032654.1,7053548,7494996,7495000,t,tNNNN,4
NC_037332.1,NC_032654.1,7062274,7503730,7503731,a,ac,1
NC_037332.1,NC_032654.1,7071684,7513134,7513135,c,ca,1
NC_037332.1,NC_032654.1,7186242,7627432,7627434,T,TAA,2
NC_037332.1,NC_032654.1,7196433,7637654,7637655,A,AR,1
NC_037332.1,NC_032654.1,7216816,7660467,7660468,C,CA,1
NC_037332.1,NC_032654.1,7217380,7661032,7661033,a,ag,1
NC_037332.1,NC_032654.1,7235379,7751984,7752006,t,ttatatatatatatatatatata,22
NC_037332.1,NC_032654.1,7240952,7757517,7757518,t,ta,1
NC_037332.1,NC_032654.1,7267424,7783753,7783754,T,TC,1
NC_037332.1,NC_032654.1,7296560,7812586,7812587,c,ca,1
NC_037332.1,NC_032654.1,7306658,7822392,7822393,g,gt,1
NC_037332.1,NC_032654.1,7315312,7831049,7831056,G,GGGAAGAC,7
NC_037332.1,NC_032654.1,7510370,8030208,8030210,t,tNN,2
NC_037332.1,NC_032654.1,7648540,8168276,8168277,a,ac,1
NC_037332.1,NC_032654.1,7663440,8183187,8183188,G,GA,1
NC_037332.1,NC_032654.1,7740100,8266138,8266139,c,ct,1
NC_037332.1,NC_032654.1,7751078,8277126,8277127,t,tg,1
NC_037332.1,NC_032654.1,7754588,8280635,8280645,c,ccctcccacct,10
NC_037332.1,NC_032654.1,7758434,8284343,8284344,a,at,1
NC_037332.1,NC_032654.1,7761125,8287034,8287035,a,ag,1
NC_037332.1,NC_032654.1,7761216,8287126,8287127,t,tc,1
NC_037332.1,NC_032654.1,7762444,8288356,8288357,A,AT,1
NC_037332.1,NC_032654.1,7770867,8296776,8296778,t,tta,2
NC_037332.1,NC_032654.1,7776644,8302563,8302564,t,ta,1
NC_037332.1,NC_032654.1,7777587,8303507,8303508,t,ta,1
NC_037332.1,NC_032654.1,7788105,8314026,8314030,t,tNNNN,4
NC_037332.1,NC_032654.1,7813358,8339283,8339284,c,cg,1
NC_037332.1,NC_032654.1,7818134,8344059,8344067,A,ACTATTGGT,8
NC_037332.1,NC_032654.1,7832180,8357341,8357342,c,ct,1
NC_037332.1,NC_032654.1,7904528,8429581,8429582,T,TY,1
NC_037332.1,NC_032654.1,7986338,8512902,8512904,t,ttg,2
NC_037332.1,NC_032654.1,8007894,8534466,8534467,A,AG,1
NC_037332.1,NC_032654.1,8008807,8535379,8535380,t,tc,1
NC_037332.1,NC_032654.1,8012499,8539072,8539075,A,AAAG,3
NC_037332.1,NC_032654.1,8012780,8539356,8539357,t,tc,1
NC_037332.1,NC_032654.1,8017617,8544178,8544179,T,TG,1
NC_037332.1,NC_032654.1,8044711,8571199,8571200,A,AC,1
NC_037332.1,NC_032654.1,8051481,8578395,8578396,c,ca,1
NC_037332.1,NC_032654.1,8053023,8579425,8579428,g,gaaa,3
NC_037332.1,NC_032654.1,8063025,8589428,8589429,A,AG,1
NC_037332.1,NC_032654.1,8068196,8594608,8594609,A,AC,1
NC_037332.1,NC_032654.1,8068753,8595166,8595168,a,att,2
NC_037332.1,NC_032654.1,8069188,8595603,8595611,a,acacacacg,8
NC_037332.1,NC_032654.1,8077760,8604184,8604186,A,AGC,2
NC_037332.1,NC_032654.1,8082190,8608615,8608616,T,TC,1
NC_037332.1,NC_032654.1,8085605,8612031,8612035,T,TTTAC,4
NC_037332.1,NC_032654.1,8125118,8651557,8651558,g,ga,1
NC_037332.1,NC_032654.1,8139510,8665955,8665959,t,tNNNN,4
NC_037332.1,NC_032654.1,8152405,8678855,8678857,a,aag,2
NC_037332.1,NC_032654.1,8153856,8680308,8680316,t,tNNNNNNNN,8
NC_037332.1,NC_032654.1,8159802,8686268,8686269,g,ga,1
NC_037332.1,NC_032654.1,8244117,8770590,8770591,a,ag,1
NC_037332.1,NC_032654.1,8256674,8783139,8783141,T,TAG,2
NC_037332.1,NC_032654.1,8268095,8794565,8794567,A,AAG,2
NC_037332.1,NC_032654.1,8270843,8797311,8797312,C,CM,1
NC_037332.1,NC_032654.1,8275837,8802300,8802301,A,AG,1
NC_037332.1,NC_032654.1,8276102,8802566,8802568,C,CTT,2
NC_037332.1,NC_032654.1,8389616,8916052,8916053,c,ca,1
NC_037332.1,NC_032654.1,8428592,8968697,8968698,c,ct,1
NC_037332.1,NC_032654.1,8442446,8982587,8982588,g,ga,1
NC_037332.1,NC_032654.1,8453185,8993327,8993328,A,AT,1
NC_037332.1,NC_032654.1,8464696,9004841,9004842,T,TA,1
NC_037332.1,NC_032654.1,8481135,9021284,9021289,A,ATGAAT,5
NC_037332.1,NC_032654.1,8524757,9065284,9065285,t,ta,1
NC_037332.1,NC_032654.1,8563271,9103829,9103830,A,AM,1
NC_037332.1,NC_032654.1,8569000,9109562,9109564,c,cNN,2
NC_037332.1,NC_032654.1,8571966,9112534,9112535,g,ga,1
NC_037332.1,NC_032654.1,8614919,9155515,9155521,a,aggggtg,6
NC_037332.1,NC_032654.1,8615942,9156544,9156545,G,GA,1
NC_037332.1,NC_032654.1,8619636,9160231,9160240,t,tttcactttc,9
NC_037332.1,NC_032654.1,8621674,9162279,9162282,t,taaa,3
NC_037332.1,NC_032654.1,8639920,9180632,9180633,G,GA,1
NC_037332.1,NC_032654.1,8752901,9297607,9297609,A,AAC,2
NC_037332.1,NC_032654.1,8800561,9345421,9345423,g,ggc,2
NC_037332.1,NC_032654.1,8811975,9356714,9356715,g,gc,1
NC_037332.1,NC_032654.1,8832867,9377413,9377418,T,TACATG,5
NC_037332.1,NC_032654.1,8842439,9387088,9387089,g,ga,1
NC_037332.1,NC_032654.1,8843198,9387847,9387848,c,ca,1
NC_037332.1,NC_032654.1,8844058,9388704,9388706,g,gat,2
NC_037332.1,NC_032654.1,8846664,9391314,9391315,A,AR,1
NC_037332.1,NC_032654.1,8905628,9450271,9450272,a,at,1
NC_037332.1,NC_032654.1,8906240,9450884,9450896,C,CATGAGTTGTGAT,12
NC_037332.1,NC_032654.1,8928635,9473308,9473315,C,CAAAAAAA,7
NC_037332.1,NC_032654.1,8954212,10907253,10907254,t,ta,1
NC_037332.1,NC_032654.1,8965105,10918145,10918149,T,TTAAC,4
NC_037332.1,NC_032654.1,8982353,10935522,10935524,a,aac,2
NC_037332.1,NC_032654.1,8991612,10944777,10944780,T,TACC,3
NC_037332.1,NC_032654.1,9012287,10965458,10965485,g,gtcgNNNNNNNNNNNNNNNNNNNNNNNN,27
NC_037332.1,NC_032654.1,9024882,10978081,10978082,g,ga,1
NC_037332.1,NC_032654.1,9080183,11061135,11061136,g,gc,1
NC_037332.1,NC_032654.1,9080755,11061708,11061709,G,GT,1
NC_037332.1,NC_032654.1,9083816,11064769,11064770,g,gt,1
NC_037332.1,NC_032654.1,9112448,11093189,11093192,A,AAAC,3
NC_037332.1,NC_032654.1,9117121,11097866,11097867,T,TC,1
NC_037332.1,NC_032654.1,9129301,11110074,11110077,G,GCAA,3
NC_037332.1,NC_032654.1,9154427,11135126,11135127,t,ta,1
NC_037332.1,NC_032654.1,9174423,11155125,11155128,a,actg,3
NC_037332.1,NC_032654.1,9179658,11160367,11160370,t,ttgc,3
NC_037332.1,NC_032654.1,9254765,11235459,11235463,a,aNNNN,4
NC_037332.1,NC_032654.1,9307685,11287002,11287003,A,AT,1
NC_037332.1,NC_032654.1,9310938,11290257,11290258,C,CA,1
NC_037332.1,NC_032654.1,9324764,11303865,11303867,C,CAA,2
NC_037332.1,NC_032654.1,9351798,11331652,11331653,G,GC,1
NC_037332.1,NC_032654.1,9395690,11375631,11375640,A,AAGTGGGCTG,9
NC_037332.1,NC_032654.1,9427503,11408350,11408361,T,TATATACGTGTA,11
NC_037332.1,NC_032654.1,9429386,11410246,11410247,t,tg,1
NC_037332.1,NC_032654.1,9457647,11438332,11438333,A,AR,1
NC_037332.1,NC_032654.1,9597544,11578629,11578633,a,aaaaM,4
NC_037332.1,NC_032654.1,9599078,11580167,11580171,C,CGAAA,4
NC_037332.1,NC_032654.1,9606218,11587311,11587312,t,ta,1
NC_037332.1,NC_032654.1,9610444,11591537,11591538,a,ag,1
NC_037332.1,NC_032654.1,9630438,11611540,11611541,a,ag,1
NC_037332.1,NC_032654.1,9633175,11614278,11614282,a,aaaag,4
NC_037332.1,NC_032654.1,9705589,11687338,11687339,c,ct,1
NC_037332.1,NC_032654.1,9708238,11689988,11689989,t,ta,1
NC_037332.1,NC_032654.1,9708251,11690002,11690005,t,ttac,3
NC_037332.1,NC_032654.1,9725718,11706302,11706303,t,tg,1
NC_037332.1,NC_032654.1,9726870,11707466,11707470,a,aagac,4
NC_037332.1,NC_032654.1,9757278,11737489,11737490,G,GR,1
NC_037332.1,NC_032654.1,9764108,11744413,11744414,A,AC,1
NC_037332.1,NC_032654.1,9774946,11755252,11755253,a,at,1
NC_037332.1,NC_032654.1,9877571,11857512,11857515,a,aact,3
NC_037332.1,NC_032654.1,9883204,11866362,11866363,A,AC,1
NC_037332.1,NC_032654.1,9884434,11867595,11867596,t,tc,1
NC_037332.1,NC_032654.1,9887357,11870521,11870522,a,ag,1
NC_037332.1,NC_032654.1,9988931,11999733,11999734,C,CY,1
NC_037332.1,NC_032654.1,9995763,12006543,12006544,a,ac,1
NC_037332.1,NC_032654.1,9997400,12008181,12008182,G,GC,1
NC_037332.1,NC_032654.1,10000319,12011103,12011104,t,ta,1
NC_037332.1,NC_032654.1,10008896,12019712,12019713,T,TG,1
NC_037332.1,NC_032654.1,10009062,12019879,12019882,C,CTCT,3
NC_037332.1,NC_032654.1,10026297,12037126,12037130,C,CAGTT,4
NC_037332.1,NC_032654.1,10052668,12063506,12063507,t,ta,1
NC_037332.1,NC_032654.1,10103216,12113349,12113350,g,gt,1
NC_037332.1,NC_032654.1,10140877,12151001,12151019,c,cctggagttggttgccata,18
NC_037332.1,NC_032654.1,10142819,12152960,12152961,A,AT,1
NC_037332.1,NC_032654.1,10181705,12191861,12191864,T,TGAA,3
NC_037332.1,NC_032654.1,10193093,12203812,12203813,T,TG,1
NC_037332.1,NC_032654.1,10197028,12207747,12207749,t,ttc,2
NC_037332.1,NC_032654.1,10201702,12212423,12212424,T,TG,1
NC_037332.1,NC_032654.1,10231491,12242164,12242165,A,AR,1
NC_037332.1,NC_032654.1,10311265,12321954,12321955,A,AT,1
NC_037332.1,NC_032654.1,10335109,12346153,12346154,G,GA,1
NC_037332.1,NC_032654.1,10411428,12422956,12422957,A,AW,1
NC_037332.1,NC_032654.1,10429949,12441476,12441478,A,AAC,2
NC_037332.1,NC_032654.1,10466178,12477738,12477740,c,cca,2
NC_037332.1,NC_032654.1,10469514,12481076,12481077,A,AC,1
NC_037332.1,NC_032654.1,10478023,12489182,12489192,a,actgatctgat,10
NC_037332.1,NC_032654.1,10495566,12506751,12506769,C,CATGMSATGTTAGTACAMA,18
NC_037332.1,NC_032654.1,10502703,12513917,12513919,G,GCA,2
NC_037332.1,NC_032654.1,10609011,12779111,12779113,g,gtt,2
NC_037332.1,NC_032654.1,10611098,12781200,12781201,A,AW,1
NC_037332.1,NC_032654.1,10726932,12823250,12823251,a,at,1
NC_037332.1,NC_032654.1,10752011,12848314,12848315,A,AC,1
NC_037332.1,NC_032654.1,10753291,12849593,12849595,A,AAM,2
NC_037332.1,NC_032654.1,10779763,12876487,12876488,t,ta,1
NC_037332.1,NC_032654.1,10781821,12878547,12878552,c,ctactg,5
NC_037332.1,NC_032654.1,10798076,12894807,12894808,t,ta,1
NC_037332.1,NC_032654.1,10824906,12925194,12925196,t,tNN,2
NC_037332.1,NC_032654.1,10845952,12986933,12986934,t,ta,1
NC_037332.1,NC_032654.1,10902936,13019930,13019932,t,tta,2
NC_037332.1,NC_032654.1,10932480,13049473,13049476,A,AAAT,3
NC_037332.1,NC_032654.1,10943006,13060001,13060002,c,ca,1
NC_037332.1,NC_032654.1,11016952,13133945,13133948,A,AAAC,3
NC_037332.1,NC_032654.1,11018680,13135678,13135679,T,TK,1
NC_037332.1,NC_032654.1,11019713,13136712,13136715,A,AYTM,3
NC_037332.1,NC_032654.1,11019813,13136815,13136816,C,CM,1
NC_037332.1,NC_032654.1,11030590,13147596,13147597,A,AR,1
NC_037332.1,NC_032654.1,11038889,13155934,13155935,t,ta,1
NC_037332.1,NC_032654.1,11038891,13155937,13155939,a,att,2
NC_037332.1,NC_032654.1,11039464,13156512,13156513,T,TC,1
NC_037332.1,NC_032654.1,11039726,13156774,13156775,A,AT,1
NC_037332.1,NC_032654.1,11041786,13158835,13158836,T,TW,1
NC_037332.1,NC_032654.1,11076803,13193861,13193862,c,ct,1
NC_037332.1,NC_032654.1,11087588,13204667,13204668,C,CA,1
NC_037332.1,NC_032654.1,11102625,13219698,13219699,a,ag,1
NC_037332.1,NC_032654.1,11165070,13287212,13287213,T,TK,1
NC_037332.1,NC_032654.1,11170658,13292800,13292801,c,ca,1
NC_037332.1,NC_032654.1,11178648,13300857,13300858,T,TG,1
NC_037332.1,NC_032654.1,11186190,13308440,13308444,g,gtttt,4
NC_037332.1,NC_032654.1,11186957,13309212,13309213,T,TA,1
NC_037332.1,NC_032654.1,11187093,13309349,13309350,G,GT,1
NC_037332.1,NC_032654.1,11191823,13314079,13314090,g,ggtttttttttt,11
NC_037332.1,NC_032654.1,11199928,13322194,13322196,A,AAG,2
NC_037332.1,NC_032654.1,11201549,13323825,13323826,A,AR,1
NC_037332.1,NC_032654.1,11203878,13326154,13326155,t,ta,1
NC_037332.1,NC_032654.1,11223535,13345815,13345817,t,taa,2
NC_037332.1,NC_032654.1,11227387,13349440,13349441,a,at,1
NC_037332.1,NC_032654.1,11231641,13353694,13353695,a,ac,1
NC_037332.1,NC_032654.1,11231751,13353805,13353806,t,tc,1
NC_037332.1,NC_032654.1,11233848,13355903,13355910,a,acccccgc,7
NC_037332.1,NC_032654.1,11237591,13359656,13359668,t,tagcagtagcagc,12
NC_037332.1,NC_032654.1,11237931,13360008,13360015,t,tttattta,7
NC_037332.1,NC_032654.1,11250297,13372780,13372781,C,CA,1
NC_037332.1,NC_032654.1,11255193,13377668,13377671,C,CCCA,3
NC_037332.1,NC_032654.1,11259272,13381740,13381742,t,taa,2
NC_037332.1,NC_032654.1,11262304,13384766,13384767,A,AM,1
NC_037332.1,NC_032654.1,11270943,13393236,13393237,a,ac,1
NC_037332.1,NC_032654.1,11313774,13435970,13435971,t,ta,1
NC_037332.1,NC_032654.1,11324276,13446176,13446177,a,at,1
NC_037332.1,NC_032654.1,11328820,13450717,13450719,c,cat,2
NC_037332.1,NC_032654.1,11328882,13450781,13450783,t,tac,2
NC_037332.1,NC_032654.1,11331169,13453062,13453065,C,CAGT,3
NC_037332.1,NC_032654.1,11336576,13458484,13458485,T,TW,1
NC_037332.1,NC_032654.1,11337588,13459498,13459500,c,cca,2
NC_037332.1,NC_032654.1,11339125,13461060,13461061,a,ag,1
NC_037332.1,NC_032654.1,11344184,13466108,13466113,g,gttatt,5
NC_037332.1,NC_032654.1,11345723,13467660,13467661,C,CA,1
NC_037332.1,NC_032654.1,11405125,13538036,13538037,g,ga,1
NC_037332.1,NC_032654.1,11427139,13560014,13560015,t,tc,1
NC_037332.1,NC_032654.1,11547394,13680129,13680136,a,ataggtgt,7
NC_037332.1,NC_032654.1,11547420,13680162,13680172,a,attcagttcag,10
NC_037332.1,NC_032654.1,11581767,13715815,13715816,a,at,1
NC_037332.1,NC_032654.1,11585447,13719496,13719497,g,ga,1
NC_037332.1,NC_032654.1,11605946,13739996,13739997,c,ca,1
NC_037332.1,NC_032654.1,11650816,13784921,13784922,c,ct,1
NC_037332.1,NC_032654.1,11738672,13871254,13871255,c,ca,1
NC_037332.1,NC_032654.1,11846687,13957346,13957347,t,ta,1
NC_037332.1,NC_032654.1,11956954,14076840,14076845,C,CACAAA,5
NC_037332.1,NC_032654.1,12096019,14215688,14215690,a,aac,2
NC_037332.1,NC_032654.1,12100408,14220079,14220080,G,GT,1
NC_037332.1,NC_032654.1,12117464,14237391,14237392,g,ga,1
NC_037332.1,NC_032654.1,12117616,14237546,14237547,t,tg,1
NC_037332.1,NC_032654.1,12117684,14237614,14237615,a,ag,1
NC_037332.1,NC_032654.1,12127492,14247426,14247428,C,CTY,2
NC_037332.1,NC_032654.1,12293954,14413927,14413930,t,tatc,3
NC_037332.1,NC_032654.1,12471127,14590892,14590893,T,TK,1
NC_037332.1,NC_032654.1,12474456,14594223,14594224,G,GC,1
NC_037332.1,NC_032654.1,12509868,14629638,14629639,t,tg,1
NC_037332.1,NC_032654.1,12511915,14631684,14631685,t,ta,1
NC_037332.1,NC_032654.1,12786398,14949710,14949711,t,ta,1
NC_037332.1,NC_032654.1,12849816,15013129,15013130,G,GR,1
NC_037332.1,NC_032654.1,12852787,15016101,15016103,c,caa,2
NC_037332.1,NC_032654.1,12881984,15045299,15045300,a,ac,1
NC_037332.1,NC_032654.1,12886362,15049678,15049679,t,tc,1
NC_037332.1,NC_032654.1,12935050,15099794,15099810,c,cagaggggcctggtggg,16
NC_037332.1,NC_032654.1,13013020,15178005,15178006,A,AC,1
NC_037332.1,NC_032654.1,13029563,15194770,15194773,c,caag,3
NC_037332.1,NC_032654.1,13056611,15221913,15221915,c,ctt,2
NC_037332.1,NC_032654.1,13057010,15222313,15222314,g,gt,1
NC_037332.1,NC_032654.1,13057568,15222706,15222707,a,ac,1
NC_037332.1,NC_032654.1,13112925,15280138,15280139,t,ta,1
NC_037332.1,NC_032654.1,13247238,15414787,15414788,t,ta,1
NC_037332.1,NC_032654.1,13249098,15416649,15416652,A,AAAT,3
NC_037332.1,NC_032654.1,13258753,15426320,15426323,g,gaaa,3
NC_037332.1,NC_032654.1,13293299,15460891,15460893,T,TCA,2
NC_037332.1,NC_032654.1,13320877,15488471,15488472,g,ga,1
NC_037332.1,NC_032654.1,13323817,15491413,15491417,t,tNNNN,4
NC_037332.1,NC_032654.1,13474417,15641956,15641958,c,ctt,2
NC_037332.1,NC_032654.1,13639461,15802821,15802822,A,AC,1
NC_037332.1,NC_032654.1,13766666,15931629,15931631,a,aNN,2
NC_037332.1,NC_032654.1,13790220,15968790,15968791,G,GT,1
NC_037332.1,NC_032654.1,13902354,16087028,16087048,t,ttatatatatatatatatata,20
NC_037332.1,NC_032654.1,13914208,16099596,16099597,t,tg,1
NC_037332.1,NC_032654.1,13914228,16099617,16099618,a,ag,1
NC_037332.1,NC_032654.1,13914292,16099682,16099684,c,cag,2
NC_037332.1,NC_032654.1,13981317,16166712,16166713,T,TG,1
NC_037332.1,NC_032654.1,14018134,16203532,16203533,t,tg,1
NC_037332.1,NC_032654.1,14243753,16496636,16496637,T,TK,1
NC_037332.1,NC_032654.1,14292082,16544734,16544735,A,AM,1
NC_037332.1,NC_032654.1,14292124,16544777,16544778,t,ta,1
NC_037332.1,NC_032654.1,14313592,16566908,16566910,c,ctg,2
NC_037332.1,NC_032654.1,14314374,16567692,16567693,t,tg,1
NC_037332.1,NC_032654.1,14318533,16571853,16571854,T,TA,1
NC_037332.1,NC_032654.1,14318937,16572258,16572261,t,ttta,3
NC_037332.1,NC_032654.1,14651737,16925354,16925355,G,GA,1
NC_037332.1,NC_032654.1,14651854,16925471,16925472,T,TC,1
NC_037332.1,NC_032654.1,14658019,16931636,16931638,A,AAC,2
NC_037332.1,NC_032654.1,14662395,16936014,16936016,a,aNN,2
NC_037332.1,NC_032654.1,14678298,16951925,16951926,A,AW,1
NC_037332.1,NC_032654.1,14687498,16961129,16961136,C,CTTGATGT,7
NC_037332.1,NC_032654.1,14695969,16969612,16969615,A,AGAR,3
NC_037332.1,NC_032654.1,14704333,16977973,16977974,T,TA,1
NC_037332.1,NC_032654.1,14717246,16990888,16990889,a,aN,1
NC_037332.1,NC_032654.1,14725494,16999138,16999141,c,caga,3
NC_037332.1,NC_032654.1,14772555,17046577,17046581,C,CTCTT,4
NC_037332.1,NC_032654.1,14784956,17058982,17058984,t,tNN,2
NC_037332.1,NC_032654.1,14858893,17132935,17132937,t,tNN,2
NC_037332.1,NC_032654.1,14908655,17182610,17182611,a,ac,1
NC_037332.1,NC_032654.1,14954287,17228247,17228250,A,ACTT,3
NC_037332.1,NC_032654.1,14954546,17228509,17228510,t,tc,1
NC_037332.1,NC_032654.1,14966551,17240515,17240519,t,tagag,4
NC_037332.1,NC_032654.1,14972106,17246074,17246075,T,TW,1
NC_037332.1,NC_032654.1,15048393,17322290,17322291,g,gc,1
NC_037332.1,NC_032654.1,15052728,17327285,17327287,g,gaa,2
NC_037332.1,NC_032654.1,15087803,17362410,17362411,t,tc,1
NC_037332.1,NC_032654.1,15092111,17366720,17366721,T,TW,1
NC_037332.1,NC_032654.1,15094536,17369147,17369148,G,GR,1
NC_037332.1,NC_032654.1,15125662,17400273,17400274,a,ag,1
NC_037332.1,NC_032654.1,15128307,17402926,17402927,A,AW,1
NC_037332.1,NC_032654.1,15131797,17406418,17406420,A,AAY,2
NC_037332.1,NC_032654.1,15196792,17471450,17471451,c,ct,1
NC_037332.1,NC_032654.1,15202397,17477056,17477057,A,AG,1
NC_037332.1,NC_032654.1,15215681,17490340,17490341,G,GR,1
NC_037332.1,NC_032654.1,15300676,17575084,17575085,T,TA,1
NC_037332.1,NC_032654.1,15362997,17637412,17637415,A,ATGT,3
NC_037332.1,NC_032654.1,15433788,17707195,17707197,T,TAA,2
NC_037332.1,NC_032654.1,15463460,17736875,17736876,t,tc,1
NC_037332.1,NC_032654.1,15470287,17743704,17743710,T,TAGagta,6
NC_037332.1,NC_032654.1,15479029,17752451,17752452,a,ag,1
NC_037332.1,NC_032654.1,15504329,17777755,17777756,A,AN,1
NC_037332.1,NC_032654.1,15519661,17793084,17793085,G,GA,1
NC_037332.1,NC_032654.1,15696931,17973881,17973882,a,ac,1
NC_037332.1,NC_032654.1,15697010,17973961,17973962,t,tg,1
NC_037332.1,NC_032654.1,15785200,18092446,18092448,t,taa,2
NC_037332.1,NC_032654.1,15790960,18097865,18097866,t,ta,1
NC_037332.1,NC_032654.1,15793479,18100385,18100395,G,GGTAGGTAGGT,10
NC_037332.1,NC_032654.1,15826235,18138922,18138923,t,ta,1
NC_037332.1,NC_032654.1,16000182,18324513,18324519,a,aNNNNNN,6
NC_037332.1,NC_032654.1,16032018,18356354,18356355,g,ga,1
NC_037332.1,NC_032654.1,16061381,18385719,18385720,T,TN,1
NC_037332.1,NC_032654.1,16114785,18439126,18439127,c,ct,1
NC_037332.1,NC_032654.1,16166770,18490567,18490568,c,ct,1
NC_037332.1,NC_032654.1,16181459,18505135,18505136,G,GT,1
NC_037332.1,NC_032654.1,16584583,18910150,18910151,c,ct,1
NC_037332.1,NC_032654.1,16605632,18935679,18935680,t,ta,1
NC_037332.1,NC_032654.1,16688923,19021900,19021901,t,tg,1
NC_037332.1,NC_032654.1,16688969,19021946,19021947,t,ta,1
NC_037332.1,NC_032654.1,17065228,19390577,19390578,a,ag,1
NC_037332.1,NC_032654.1,17233622,19575555,19575556,g,gt,1
NC_037332.1,NC_032654.1,17234216,19575796,19575797,g,ga,1
NC_037332.1,NC_032654.1,17272452,19611608,19611612,g,gctat,4
NC_037332.1,NC_032654.1,17370550,19709581,19709582,g,ga,1
NC_037332.1,NC_032654.1,17414942,19755643,19755646,A,AAAC,3
NC_037332.1,NC_032654.1,17424198,19764902,19764903,g,gc,1
NC_037332.1,NC_032654.1,17424209,19764914,19764916,t,tgg,2
NC_037332.1,NC_032654.1,17512265,19878185,19878187,c,ctt,2
NC_037332.1,NC_032654.1,17512640,19878562,19878563,t,tc,1
NC_037332.1,NC_032654.1,17516032,19881528,19881529,c,ca,1
NC_037332.1,NC_032654.1,17516998,19882495,19882498,a,aaag,3
NC_037332.1,NC_032654.1,17534069,19899569,19899570,g,gc,1
NC_037332.1,NC_032654.1,17635522,20003878,20003879,t,tg,1
NC_037332.1,NC_032654.1,17795699,20171584,20171585,C,CG,1
NC_037332.1,NC_032654.1,18143366,20517388,20517389,t,ta,1
NC_037332.1,NC_032654.1,18150283,20524308,20524309,A,AW,1
NC_037332.1,NC_032654.1,18150291,20524317,20524318,T,TK,1
NC_037332.1,NC_032654.1,18440831,20952807,20952808,G,GT,1
NC_037332.1,NC_032654.1,18440944,20952921,20952922,t,tg,1
NC_037332.1,NC_032654.1,18506909,21018950,21018951,A,AR,1
NC_037332.1,NC_032654.1,18571771,21083512,21083513,t,tN,1
NC_037332.1,NC_032654.1,18697555,21217622,21217646,t,ttacatatatatatatatatatata,24
NC_037332.1,NC_032654.1,18711970,21232061,21232062,t,tc,1
NC_037332.1,NC_032654.1,18733974,21257418,21257419,t,ta,1
NC_037332.1,NC_032654.1,18839358,21362802,21362803,c,ca,1
NC_037332.1,NC_032654.1,18923529,21536091,21536092,t,ta,1
NC_037332.1,NC_032654.1,18925181,21537744,21537748,G,GTGTC,4
NC_037332.1,NC_032654.1,19060421,21670374,21670375,g,gt,1
NC_037332.1,NC_032654.1,19338748,22000008,22000009,t,tg,1
NC_037332.1,NC_032654.1,19437132,22098390,22098391,a,ag,1
NC_037332.1,NC_032654.1,19448940,22110346,22110347,c,ca,1
NC_037332.1,NC_032654.1,19591987,22255667,22255668,t,ta,1
NC_037332.1,NC_032654.1,20156458,22864353,22864354,T,TY,1
NC_037332.1,NC_032654.1,20182277,22803620,22803621,t,tc,1
NC_037332.1,NC_032654.1,20186141,22807216,22807219,G,GATS,3
NC_037332.1,NC_032654.1,20199961,22821040,22821042,g,ggt,2
NC_037332.1,NC_032654.1,20211670,22832749,22832750,t,tg,1
NC_037332.1,NC_032654.1,20460503,23169179,23169180,g,ga,1
NC_037332.1,NC_032654.1,20460639,23169314,23169315,g,ga,1
NC_037332.1,NC_032654.1,20461111,23169781,23169782,t,tN,1
NC_037332.1,NC_032654.1,20551846,23260837,23260839,t,tNN,2
NC_037332.1,NC_032654.1,20706955,23424407,23424408,c,ct,1
NC_037332.1,NC_032654.1,20912908,23630139,23630174,T,TCGTGTGAGGCAGTACCTCNNNNNNNNNNNNNNNNN,35
NC_037332.1,NC_032654.1,20996602,23713693,23713694,G,GA,1
NC_037332.1,NC_032654.1,21329404,24117265,24117266,C,CT,1
NC_037332.1,NC_032654.1,21789045,24570327,24570328,c,ct,1
NC_037332.1,NC_032654.1,21859934,24641174,24641176,t,taa,2
NC_037332.1,NC_032654.1,22084406,24870561,24870562,t,ta,1
NC_037332.1,NC_032654.1,22139310,24925470,24925471,G,GK,1
NC_037332.1,NC_032654.1,22139648,24925809,24925810,T,TA,1
NC_037332.1,NC_032654.1,22246068,25032691,25032692,T,TK,1
NC_037332.1,NC_032654.1,22246099,25032723,25032724,G,GT,1
NC_037332.1,NC_032654.1,22289385,25084646,25084647,a,aR,1
NC_037332.1,NC_032654.1,22367627,25154977,25154978,c,ca,1
NC_037332.1,NC_032654.1,22422806,25211989,25211990,A,AG,1
NC_037332.1,NC_032654.1,22535167,25324149,25324152,A,AGTT,3
NC_037332.1,NC_032654.1,22636258,25432206,25432207,C,CT,1
NC_037332.1,NC_032654.1,22724559,25520165,25520184,T,TAATCACTTCAGGGAATTTY,19
NC_037332.1,NC_032654.1,22774950,25570465,25570470,T,TTAAAC,5
NC_037332.1,NC_032654.1,22935701,25735751,25735752,c,cg,1
NC_037332.1,NC_032654.1,23036714,25836766,25836767,a,ac,1
NC_037332.1,NC_032654.1,23104676,25904730,25904732,g,ggt,2
NC_037332.1,NC_032654.1,23143909,25943965,25943968,a,aaat,3
NC_037332.1,NC_032654.1,23207902,26007963,26007965,g,gtt,2
NC_037332.1,NC_032654.1,23234988,26035052,26035053,C,CY,1
NC_037332.1,NC_032654.1,23329585,26129644,26129653,T,TGCRTGTGTG,9
NC_037332.1,NC_032654.1,23367640,26167703,26167704,C,CN,1
NC_037332.1,NC_032654.1,23394155,26194225,26194226,t,ta,1
NC_037332.1,NC_032654.1,23435278,26230946,26230947,t,tN,1
NC_037332.1,NC_032654.1,23482828,26278500,26278501,C,CG,1
NC_037332.1,NC_032654.1,23522819,26318376,26318378,G,GAC,2
NC_037332.1,NC_032654.1,23522862,26318421,26318422,T,TC,1
NC_037332.1,NC_032654.1,23537656,26333215,26333216,g,ga,1
NC_037332.1,NC_032654.1,23552378,26347939,26347942,T,TGTC,3
NC_037332.1,NC_032654.1,23753273,26550291,26550292,T,TK,1
NC_037332.1,NC_032654.1,24159091,27015086,27015091,c,caattt,5
NC_037332.1,NC_032654.1,24159147,27015147,27015151,t,ttttg,4
NC_037332.1,NC_032654.1,24195175,27052076,27052080,t,tcttc,4
NC_037332.1,NC_032654.1,24332547,27211893,27211902,g,gggaaacagt,9
NC_037332.1,NC_032654.1,24478824,27359011,27359013,A,AGG,2
NC_037332.1,NC_032654.1,24542862,27423080,27423081,T,TC,1
NC_037332.1,NC_032654.1,24594051,27474293,27474295,C,CCA,2
NC_037332.1,NC_032654.1,24649876,27532170,27532171,G,GR,1
NC_037332.1,NC_032654.1,24652070,27534365,27534373,T,TGGGCCAAC,8
NC_037332.1,NC_032654.1,24715852,27598179,27598189,t,tNNNNNNNNNN,10
NC_037332.1,NC_032654.1,24953793,27864529,27864532,t,tctc,3
NC_037332.1,NC_032654.1,25403373,28276319,28276320,t,ta,1
NC_037332.1,NC_032654.1,25403395,28276342,28276343,g,ga,1
NC_037332.1,NC_032654.1,25403400,28276348,28276349,g,ga,1
NC_037332.1,NC_032654.1,25403408,28276357,28276358,a,at,1
NC_037332.1,NC_032654.1,25403432,28276382,28276383,g,ga,1
NC_037332.1,NC_032654.1,25403449,28276400,28276401,a,ag,1
NC_037332.1,NC_032654.1,25546881,28398209,28398211,T,TTG,2
NC_037332.1,NC_032654.1,25578899,28430221,28430222,T,TC,1
NC_037332.1,NC_032654.1,25781516,28639776,28639778,t,tta,2
NC_037332.1,NC_032654.1,25807569,28665831,28665833,t,tcc,2
NC_037332.1,NC_032654.1,25894825,28753059,28753060,T,TY,1
NC_037332.1,NC_032654.1,25962710,28822157,28822158,t,ta,1
NC_037332.1,NC_032654.1,26021031,28880386,28880387,T,TG,1
NC_037332.1,NC_032654.1,26021920,28881275,28881276,T,TK,1
NC_037332.1,NC_032654.1,26140670,28999774,28999787,G,Gaataaaattgcaa,13
NC_037332.1,NC_032654.1,26258981,29166875,29166879,t,ttttg,4
NC_037332.1,NC_032654.1,26483659,29440407,29440408,G,GA,1
NC_037332.1,NC_032654.1,26562358,29519319,29519352,G,GGCGGAGGGCGGGCGGGCGGGCRGAGGGCGGGCR,33
NC_037332.1,NC_032654.1,26564429,29521407,29521411,C,CTTTT,4
NC_037332.1,NC_032654.1,26565009,29521991,29521992,t,ta,1
NC_037332.1,NC_032654.1,26888980,29854313,29854314,G,GA,1
NC_037332.1,NC_032654.1,26978873,29944407,29944413,c,cctcgAT,6
NC_037332.1,NC_032654.1,27002168,29967694,29967718,g,ggtcGTTGTAATCGCAAAACTTNNN,24
NC_037332.1,NC_032654.1,27011541,29977093,29977094,g,gt,1
NC_037332.1,NC_032654.1,27027546,29993101,29993102,A,AG,1
NC_037332.1,NC_032654.1,27032168,29997724,29997726,C,CAG,2
NC_037332.1,NC_032654.1,27034614,30000173,30000174,T,TG,1
NC_037332.1,NC_032654.1,27034711,30000271,30000276,C,CCCAGG,5
NC_037332.1,NC_032654.1,27113482,30079687,30079688,C,CT,1
NC_037332.1,NC_032654.1,27288965,30195838,30195839,T,TC,1
NC_037332.1,NC_032654.1,27420906,30328026,30328035,T,TCATCCCTCA,9
NC_037332.1,NC_032654.1,27421016,30328145,30328146,G,GA,1
NC_037332.1,NC_032654.1,27630644,30538124,30538125,T,TC,1
NC_037332.1,NC_032654.1,27637132,30544608,30544614,a,actgttt,6
NC_037332.1,NC_032654.1,27654948,30547025,30547026,C,CR,1
NC_037332.1,NC_032654.1,27690697,30582719,30582720,C,CG,1
NC_037332.1,NC_032654.1,27700898,30592921,30592922,G,GA,1
NC_037332.1,NC_032654.1,27701032,30593058,30593059,C,CA,1
NC_037332.1,NC_032654.1,27739405,30631426,30631427,g,gt,1
NC_037332.1,NC_032654.1,27765467,30657743,30657762,G,GANNNNNNNNNNNNNNTGTC,19
NC_037332.1,NC_032654.1,27829498,30721983,30721984,T,TY,1
NC_037332.1,NC_032654.1,28007675,30896192,30896194,T,TAA,2
NC_037332.1,NC_032654.1,28048443,30936693,30936694,A,AN,1
NC_037332.1,NC_032654.1,28109641,30997930,30997931,C,CM,1
NC_037332.1,NC_032654.1,28125926,31014218,31014219,t,ta,1
NC_037332.1,NC_032654.1,28176819,31064907,31064908,G,GA,1
NC_037332.1,NC_032654.1,28389300,31245509,31245510,G,GC,1
NC_037332.1,NC_032654.1,28411020,31267231,31267232,t,ta,1
NC_037332.1,NC_032654.1,28411023,31267235,31267236,a,ag,1
NC_037332.1,NC_032654.1,28416375,31272588,31272589,A,AG,1
NC_037332.1,NC_032654.1,28915579,31872745,31872748,t,ttaa,3
NC_037332.1,NC_032654.1,29069170,32086535,32086536,a,ac,1
NC_037332.1,NC_032654.1,29070427,32087793,32087803,c,cgactgaactg,10
NC_037332.1,NC_032654.1,29095550,32112922,32112930,A,AAAARAATT,8
NC_037332.1,NC_032654.1,29262754,32279830,32279833,c,catt,3
NC_037332.1,NC_032654.1,29263051,32280130,32280131,g,gt,1
NC_037332.1,NC_032654.1,29352958,32369936,32369937,g,ga,1
NC_037332.1,NC_032654.1,29355140,32372118,32372119,A,AT,1
NC_037332.1,NC_032654.1,29463938,32481077,32481078,g,gt,1
NC_037332.1,NC_032654.1,29565576,32583000,32583001,t,tg,1
NC_037332.1,NC_032654.1,29577526,32594950,32594954,t,tNNNN,4
NC_037332.1,NC_032654.1,29600741,32618170,32618171,C,CT,1
NC_037332.1,NC_032654.1,29624925,32642351,32642352,T,TG,1
NC_037332.1,NC_032654.1,29624938,32642365,32642366,A,AG,1
NC_037332.1,NC_032654.1,29643274,32660701,32660705,C,CAATT,4
NC_037332.1,NC_032654.1,29655508,32672940,32672944,g,gacac,4
NC_037332.1,NC_032654.1,29925866,32943326,32943327,C,CT,1
NC_037332.1,NC_032654.1,30376203,33429492,33429494,a,aNN,2
NC_037332.1,NC_032654.1,30382404,33435695,33435696,a,ac,1
NC_037332.1,NC_032654.1,30425335,33478576,33478577,G,GK,1
NC_037332.1,NC_032654.1,30466553,33520331,33520332,a,at,1
NC_037332.1,NC_032654.1,30548338,33602312,33602313,A,AC,1
NC_037332.1,NC_032654.1,30548996,33602970,33602971,G,GT,1
NC_037332.1,NC_032654.1,30549297,33603272,33603273,C,CA,1
NC_037332.1,NC_032654.1,30549358,33603336,33603337,c,ct,1
NC_037332.1,NC_032654.1,30549425,33603404,33603405,T,TG,1
NC_037332.1,NC_032654.1,30549515,33603493,33603494,T,TC,1
NC_037332.1,NC_032654.1,30549578,33603556,33603557,c,ct,1
NC_037332.1,NC_032654.1,30549594,33603573,33603574,c,ca,1
NC_037332.1,NC_032654.1,30549628,33603608,33603610,A,AAT,2
NC_037332.1,NC_032654.1,30549724,33603706,33603707,g,gt,1
NC_037332.1,NC_032654.1,30549790,33603773,33603774,A,AG,1
NC_037332.1,NC_032654.1,30549839,33603820,33603821,G,GT,1
NC_037332.1,NC_032654.1,30549896,33603878,33603879,G,GT,1
NC_037332.1,NC_032654.1,30549974,33603952,33603953,G,GC,1
NC_037332.1,NC_032654.1,30549981,33603960,33603961,A,AC,1
NC_037332.1,NC_032654.1,30550127,33604106,33604107,t,tc,1
NC_037332.1,NC_032654.1,30550168,33604148,33604149,c,ct,1
NC_037332.1,NC_032654.1,30550178,33604159,33604162,g,ggat,3
NC_037332.1,NC_032654.1,30550187,33604171,33604172,c,ca,1
NC_037332.1,NC_032654.1,30550215,33604199,33604200,c,ct,1
NC_037332.1,NC_032654.1,30550312,33604296,33604297,T,TG,1
NC_037332.1,NC_032654.1,30550423,33604405,33604406,T,TG,1
NC_037332.1,NC_032654.1,30550543,33604524,33604525,C,CA,1
NC_037332.1,NC_032654.1,30550831,33604817,33604818,c,ca,1
NC_037332.1,NC_032654.1,30550891,33604877,33604878,T,TG,1
NC_037332.1,NC_032654.1,30551007,33604994,33604995,A,AC,1
NC_037332.1,NC_032654.1,30551035,33605023,33605024,T,TA,1
NC_037332.1,NC_032654.1,30551073,33605062,33605063,A,AG,1
NC_037332.1,NC_032654.1,30551161,33605151,33605152,T,TG,1
NC_037332.1,NC_032654.1,30551719,33605701,33605702,C,CR,1
NC_037332.1,NC_032654.1,30551791,33605774,33605775,G,GC,1
NC_037332.1,NC_032654.1,30551877,33605861,33605862,A,AT,1
NC_037332.1,NC_032654.1,30552056,33606039,33606040,A,AC,1
NC_037332.1,NC_032654.1,30552170,33606153,33606154,A,AC,1
NC_037332.1,NC_032654.1,30552513,33606497,33606498,g,ga,1
NC_037332.1,NC_032654.1,30552662,33606647,33606648,T,TC,1
NC_037332.1,NC_032654.1,30552688,33606674,33606675,A,AT,1
NC_037332.1,NC_032654.1,30552711,33606698,33606699,T,TG,1
NC_037332.1,NC_032654.1,30552896,33606884,33606885,C,CG,1
NC_037332.1,NC_032654.1,30553007,33606996,33606997,C,CA,1
NC_037332.1,NC_032654.1,30553137,33607128,33607129,T,TG,1
NC_037332.1,NC_032654.1,30553154,33607146,33607147,T,TG,1
NC_037332.1,NC_032654.1,30553631,33607622,33607623,T,TG,1
NC_037332.1,NC_032654.1,30553723,33607714,33607715,A,AG,1
NC_037332.1,NC_032654.1,30553757,33607749,33607750,C,CT,1
NC_037332.1,NC_032654.1,30553783,33607776,33607777,g,ga,1
NC_037332.1,NC_032654.1,30553931,33607923,33607924,C,CT,1
NC_037332.1,NC_032654.1,30553975,33607968,33607969,t,tg,1
NC_037332.1,NC_032654.1,30554218,33608210,33608211,T,TG,1
NC_037332.1,NC_032654.1,30554356,33608349,33608350,T,TA,1
NC_037332.1,NC_032654.1,30554371,33608365,33608366,T,TA,1
NC_037332.1,NC_032654.1,30555043,33609026,33609027,T,TC,1
NC_037332.1,NC_032654.1,30555502,33609469,33609470,A,AC,1
NC_037332.1,NC_032654.1,30555681,33609647,33609648,G,GC,1
NC_037332.1,NC_032654.1,30555938,33609899,33609900,C,CA,1
NC_037332.1,NC_032654.1,30556077,33610038,33610040,A,AAC,2
NC_037332.1,NC_032654.1,30556103,33610066,33610067,A,AG,1
NC_037332.1,NC_032654.1,30556125,33610089,33610090,A,AC,1
NC_037332.1,NC_032654.1,30556205,33610170,33610171,C,CA,1
NC_037332.1,NC_032654.1,30752127,33798433,33798437,A,AAGAT,4
NC_037332.1,NC_032654.1,30870507,33916852,33916853,G,GT,1
NC_037332.1,NC_032654.1,30973456,34018345,34018346,c,cN,1
NC_037332.1,NC_032654.1,31084467,34129246,34129247,T,TA,1
NC_037332.1,NC_032654.1,31362896,34577091,34577093,g,gaa,2
NC_037332.1,NC_032654.1,31817328,35010071,35010073,a,aNN,2
NC_037332.1,NC_032654.1,31875297,35067732,35067737,c,cttttt,5
NC_037332.1,NC_032654.1,31875318,35067758,35067762,a,agtac,4
NC_037332.1,NC_032654.1,31875363,35067807,35067809,a,att,2
NC_037332.1,NC_032654.1,31875382,35067828,35067829,a,aN,1
NC_037332.1,NC_032654.1,31875428,35067875,35067876,c,ct,1
NC_037332.1,NC_032654.1,31910947,35103380,35103385,T,TTTGAA,5
NC_037332.1,NC_032654.1,31951091,35143300,35143301,g,ga,1
NC_037332.1,NC_032654.1,32019903,35212745,35212747,c,cct,2
NC_037332.1,NC_032654.1,32387705,35580758,35580763,C,CAGATA,5
NC_037332.1,NC_032654.1,32387709,35580767,35580768,T,TG,1
NC_037332.1,NC_032654.1,32509344,35702422,35702423,t,tc,1
NC_037332.1,NC_032654.1,32518213,35711293,35711295,t,tta,2
NC_037332.1,NC_032654.1,32607279,35801223,35801224,C,CG,1
NC_037332.1,NC_032654.1,32636427,35832758,35832760,T,TAC,2
NC_037332.1,NC_032654.1,32649559,35865433,35865437,T,TCAGA,4
NC_037332.1,NC_032654.1,32652045,35867922,35867923,t,tc,1
NC_037332.1,NC_032654.1,32739144,35954840,35954842,A,AAC,2
NC_037332.1,NC_032654.1,32742156,35957859,35957861,t,tta,2
NC_037332.1,NC_032654.1,32743807,35959512,35959513,G,GK,1
NC_037332.1,NC_032654.1,32752707,35968414,35968422,G,GCTTTATCT,8
NC_037332.1,NC_032654.1,32752915,35968630,35968631,G,GA,1
NC_037332.1,NC_032654.1,32752936,35968652,35968653,G,GA,1
NC_037332.1,NC_032654.1,32755692,35971410,35971414,G,GCNNN,4
NC_037332.1,NC_032654.1,32765300,35981030,35981031,t,tg,1
NC_037332.1,NC_032654.1,32772495,35988245,35988254,a,acactgtttc,9
NC_037332.1,NC_032654.1,32773752,35989504,35989506,c,cta,2
NC_037332.1,NC_032654.1,32779281,35995083,35995084,c,ca,1
NC_037332.1,NC_032654.1,32782425,35998186,35998187,T,TC,1
NC_037332.1,NC_032654.1,32784676,36000421,36000422,c,ct,1
NC_037332.1,NC_032654.1,32784819,36000565,36000566,a,at,1
NC_037332.1,NC_032654.1,32818220,36033972,36033986,G,GATACTTCCAAAAAT,14
NC_037332.1,NC_032654.1,32884794,36100547,36100548,A,AG,1
NC_037332.1,NC_032654.1,32892965,36108721,36108722,A,AG,1
NC_037332.1,NC_032654.1,32915406,36131170,36131171,A,AW,1
NC_037332.1,NC_032654.1,32957272,36173048,36173051,a,aacc,3
NC_037332.1,NC_032654.1,32982185,36197964,36197968,t,ttgtg,4
NC_037332.1,NC_032654.1,33104177,36320105,36320109,a,atgtg,4
NC_037332.1,NC_032654.1,33109318,36325251,36325254,T,TTAA,3
NC_037332.1,NC_032654.1,33120062,36335991,36335992,G,GT,1
NC_037332.1,NC_032654.1,33124561,36340491,36340496,a,aatNNN,5
NC_037332.1,NC_032654.1,33192924,36408860,36408893,C,CATAAGGGTAATAATAAAGAAACGCACAAAGCAT,33
NC_037332.1,NC_032654.1,33318934,36534916,36534918,a,aNN,2
NC_037332.1,NC_032654.1,33411024,36627672,36627673,t,tc,1
NC_037332.1,NC_032654.1,33557603,36777343,36777352,G,GTATTCTTGT,9
NC_037332.1,NC_032654.1,33565897,36785644,36785645,c,ca,1
NC_037332.1,NC_032654.1,33566083,36785829,36785830,c,ca,1
NC_037332.1,NC_032654.1,33596438,36816176,36816181,c,ccccca,5
NC_037332.1,NC_032654.1,33596450,36816193,36816194,c,ct,1
NC_037332.1,NC_032654.1,33629723,36849472,36849473,T,TC,1
NC_037332.1,NC_032654.1,33659968,36879720,36879721,g,gt,1
NC_037332.1,NC_032654.1,33660646,36880399,36880400,t,tc,1
NC_037332.1,NC_032654.1,33667800,36887556,36887559,g,ggtt,3
NC_037332.1,NC_032654.1,33678945,36898747,36898748,a,ac,1
NC_037332.1,NC_032654.1,33694482,36914288,36914292,t,taatg,4
NC_037332.1,NC_032654.1,33698148,36917986,36917988,a,aat,2
NC_037332.1,NC_032654.1,33710331,36930170,36930172,C,CCT,2
NC_037332.1,NC_032654.1,33713820,36933643,36933644,T,TA,1
NC_037332.1,NC_032654.1,33720853,36940679,36940680,A,AC,1
NC_037332.1,NC_032654.1,33736722,36956552,36956553,t,ta,1
NC_037332.1,NC_032654.1,33746270,36966102,36966103,A,AC,1
NC_037332.1,NC_032654.1,33831451,37051290,37051291,A,AC,1
NC_037332.1,NC_032654.1,33902971,37122815,37122819,T,TATTA,4
NC_037332.1,NC_032654.1,33906057,37125907,37125908,a,at,1
NC_037332.1,NC_032654.1,33976509,37196118,37196119,a,aR,1
NC_037332.1,NC_032654.1,33983746,37203363,37203364,G,GA,1
NC_037332.1,NC_032654.1,34052078,37271880,37271881,G,GT,1
NC_037332.1,NC_032654.1,34173726,37396957,37396962,g,gactga,5
NC_037332.1,NC_032654.1,34306134,37529371,37529373,c,cag,2
NC_037332.1,NC_032654.1,34329688,37552930,37552931,c,ca,1
NC_037332.1,NC_032654.1,34329712,37552955,37552956,g,gc,1
NC_037332.1,NC_032654.1,34574295,37797671,37797672,a,ag,1
NC_037332.1,NC_032654.1,34574404,37797782,37797784,t,tta,2
NC_037332.1,NC_032654.1,34633585,37856974,37856976,a,agc,2
NC_037332.1,NC_032654.1,34634220,37857611,37857617,c,cccaagt,6
NC_037332.1,NC_032654.1,34636936,37860333,37860336,a,aaag,3
NC_037332.1,NC_032654.1,34740572,37963962,37963971,c,cttttttttt,9
NC_037332.1,NC_032654.1,34840913,38064317,38064318,G,GR,1
NC_037332.1,NC_032654.1,34871949,38095354,38095355,a,at,1
NC_037332.1,NC_032654.1,34925618,38149028,38149029,c,ct,1
NC_037332.1,NC_032654.1,35136709,38360123,38360125,G,GGK,2
NC_037332.1,NC_032654.1,35144128,38367547,38367548,A,AM,1
NC_037332.1,NC_032654.1,35148378,38371797,38371798,g,gc,1
NC_037332.1,NC_032654.1,35194916,38420170,38420172,t,tNN,2
NC_037332.1,NC_032654.1,35197564,38422821,38422822,c,ct,1
NC_037332.1,NC_032654.1,35354492,38582912,38582913,t,tc,1
NC_037332.1,NC_032654.1,35354528,38582949,38582952,t,taaa,3
NC_037332.1,NC_032654.1,35532474,38761085,38761086,C,CM,1
NC_037332.1,NC_032654.1,35532602,38761215,38761216,T,TY,1
NC_037332.1,NC_032654.1,35593794,38822315,38822327,c,cCTTTGAAAAATA,12
NC_037332.1,NC_032654.1,35704957,38932650,38932652,a,atg,2
NC_037332.1,NC_032654.1,35716570,38944265,38944266,T,TW,1
NC_037332.1,NC_032654.1,35719176,38946872,38946881,t,tagcagcagc,9
NC_037332.1,NC_032654.1,35847046,39075404,39075407,C,CTAA,3
NC_037332.1,NC_032654.1,35848525,39076885,39076886,C,CT,1
NC_037332.1,NC_032654.1,35848608,39076969,39076970,C,CA,1
NC_037332.1,NC_032654.1,35849259,39077623,39077624,a,ac,1
NC_037332.1,NC_032654.1,35852856,39081219,39081224,G,GTGAAC,5
NC_037332.1,NC_032654.1,35854404,39082769,39082770,A,AC,1
NC_037332.1,NC_032654.1,35950747,39179125,39179126,c,ca,1
NC_037332.1,NC_032654.1,35979459,39207837,39207838,t,tg,1
NC_037332.1,NC_032654.1,36011696,39240076,39240077,t,ta,1
NC_037332.1,NC_032654.1,36215031,39443417,39443436,a,acaaAGGATGACACCTCTAT,19
NC_037332.1,NC_032654.1,36230268,39458675,39458677,t,tNN,2
NC_037332.1,NC_032654.1,36295590,39524002,39524004,t,tNN,2
NC_037332.1,NC_032654.1,36436739,39667757,39667758,T,TK,1
NC_037332.1,NC_032654.1,36474505,39705506,39705507,a,at,1
NC_037332.1,NC_032654.1,36485793,39716803,39716804,A,AT,1
NC_037332.1,NC_032654.1,36580215,39811243,39811244,A,AT,1
NC_037332.1,NC_032654.1,36742763,39973842,39973851,c,cgCGGAGGGG,9
NC_037332.1,NC_032654.1,36743947,39975035,39975036,g,ga,1
NC_037332.1,NC_032654.1,36750204,39981292,39981293,g,ga,1
NC_037332.1,NC_032654.1,36758345,39989443,39989444,c,ca,1
NC_037332.1,NC_032654.1,36798379,40029399,40029401,A,ATT,2
NC_037332.1,NC_032654.1,36890247,40121281,40121282,T,TC,1
NC_037332.1,NC_032654.1,36907047,40138083,40138084,C,CT,1
NC_037332.1,NC_032654.1,36976255,40207293,40207296,c,ccaa,3
NC_037332.1,NC_032654.1,37070086,40301159,40301162,t,tggg,3
NC_037332.1,NC_032654.1,37096148,40330319,40330321,t,tta,2
NC_037332.1,NC_032654.1,37128404,40362572,40362574,c,ctt,2
NC_037332.1,NC_032654.1,37129848,40364018,40364047,a,aatgatatggacctaacagaagcagaagat,29
NC_037332.1,NC_032654.1,37132216,40366416,40366421,a,agtttt,5
NC_037332.1,NC_032654.1,37137348,40371525,40371527,c,caa,2
NC_037332.1,NC_032654.1,37140074,40374250,40374252,T,TGA,2
NC_037332.1,NC_032654.1,37177752,40411993,40411997,C,CAGAT,4
NC_037332.1,NC_032654.1,37177752,40448900,40448904,C,CAGAT,4
NC_037332.1,NC_032654.1,37179450,40450602,40450603,t,tN,1
NC_037332.1,NC_032654.1,37180532,40451685,40451686,a,at,1
NC_037332.1,NC_032654.1,37185832,40456987,40456991,t,taaag,4
NC_037332.1,NC_032654.1,37186511,40457669,40457671,a,aag,2
NC_037332.1,NC_032654.1,37186539,40457699,40457700,c,ct,1
NC_037332.1,NC_032654.1,37188230,40459391,40459392,g,gA,1
NC_037332.1,NC_032654.1,37344041,40612280,40612281,G,GA,1
NC_037332.1,NC_032654.1,37364222,40632488,40632492,C,CCAGA,4
NC_037332.1,NC_032654.1,37405398,40673660,40673662,g,gaa,2
NC_037332.1,NC_032654.1,37406237,40674501,40674502,T,TW,1
NC_037332.1,NC_032654.1,37426598,40694867,40694868,C,CS,1
NC_037332.1,NC_032654.1,37443676,40711988,40711989,t,ta,1
NC_037332.1,NC_032654.1,37684692,40954204,40954205,C,CT,1
NC_037332.1,NC_032654.1,37699934,40969397,40969398,T,TC,1
NC_037332.1,NC_032654.1,37735757,41005649,41005650,C,CA,1
NC_037332.1,NC_032654.1,37794043,41064262,41064264,C,CCT,2
NC_037332.1,NC_032654.1,37794131,41064353,41064354,C,CA,1
NC_037332.1,NC_032654.1,37833664,41103880,41103882,a,aac,2
NC_037332.1,NC_032654.1,37847998,41118030,41118032,a,aNN,2
NC_037332.1,NC_032654.1,38111184,41382712,41382713,g,gt,1
NC_037332.1,NC_032654.1,38333682,41608894,41608896,G,GGT,2
NC_037332.1,NC_032654.1,38379952,41655167,41655169,a,aNN,2
NC_037332.1,NC_032654.1,38635975,41913422,41913423,C,CA,1
NC_037332.1,NC_032654.1,38672185,41949626,41949627,T,TA,1
NC_037332.1,NC_032654.1,38732062,42008107,42008108,A,AC,1
NC_037332.1,NC_032654.1,39200531,42527612,42527614,T,TTA,2
NC_037332.1,NC_032654.1,39246924,42653341,42653342,c,ca,1
NC_037332.1,NC_032654.1,39287163,42693581,42693582,G,GA,1
NC_037332.1,NC_032654.1,39287207,42693625,42693626,G,GC,1
NC_037332.1,NC_032654.1,39293769,42700188,42700189,A,AW,1
NC_037332.1,NC_032654.1,39421164,42828446,42828448,a,att,2
NC_037332.1,NC_032654.1,39644586,43106773,43106776,t,taaa,3
NC_037332.1,NC_032654.1,39909983,43372697,43372698,A,AW,1
NC_037332.1,NC_032654.1,39924816,43387534,43387535,t,tg,1
NC_037332.1,NC_032654.1,39954732,43417470,43417474,C,CAGAA,4
NC_037332.1,NC_032654.1,39961428,43424171,43424176,t,taaata,5
NC_037332.1,NC_032654.1,39966228,43428975,43428976,c,ca,1
NC_037332.1,NC_032654.1,40137319,43527854,43527855,c,ct,1
NC_037332.1,NC_032654.1,40144015,43534552,43534553,A,AT,1
NC_037332.1,NC_032654.1,40168037,43558563,43558564,t,tg,1
NC_037332.1,NC_032654.1,40177605,43568131,43568132,G,GR,1
NC_037332.1,NC_032654.1,40198961,43592271,43592278,t,taaaatta,7
NC_037332.1,NC_032654.1,40208041,43601359,43601362,t,ttaa,3
NC_037332.1,NC_032654.1,40256049,43652515,43652518,c,caaa,3
NC_037332.1,NC_032654.1,40274837,43672064,43672065,c,ca,1
NC_037332.1,NC_032654.1,40283486,43680714,43680718,a,aNNNN,4
NC_037332.1,NC_032654.1,40302104,43699352,43699357,t,tttcta,5
NC_037332.1,NC_032654.1,40303891,43701145,43701146,T,TC,1
NC_037332.1,NC_032654.1,40315678,43713075,43713076,t,ta,1
NC_037332.1,NC_032654.1,40317974,43715141,43715145,a,aaatt,4
NC_037332.1,NC_032654.1,40318436,43715611,43715613,c,cca,2
NC_037332.1,NC_032654.1,40318444,43715621,43715624,g,gttc,3
NC_037332.1,NC_032654.1,40318450,43715630,43715631,t,tg,1
NC_037332.1,NC_032654.1,40341886,43738630,43738634,C,CAAAA,4
NC_037332.1,NC_032654.1,40342186,43738934,43738935,G,GA,1
NC_037332.1,NC_032654.1,40342243,43738992,43738993,C,CT,1
NC_037332.1,NC_032654.1,40344963,43741702,43741703,g,ga,1
NC_037332.1,NC_032654.1,40349292,43746032,43746033,g,gt,1
NC_037332.1,NC_032654.1,40350772,43747513,43747514,T,TA,1
NC_037332.1,NC_032654.1,40352628,43749359,43749368,G,GTTGTATACA,9
NC_037332.1,NC_032654.1,40356153,43752901,43752902,T,TA,1
NC_037332.1,NC_032654.1,40356601,43753350,43753353,a,aaat,3
NC_037332.1,NC_032654.1,40357172,43753925,43753926,A,AC,1
NC_037332.1,NC_032654.1,40357592,43754346,43754347,C,CY,1
NC_037332.1,NC_032654.1,40371286,43850509,43850510,T,TY,1
NC_037332.1,NC_032654.1,40377117,43856331,43856333,C,CCG,2
NC_037332.1,NC_032654.1,40380759,43859835,43859838,g,gtgc,3
NC_037332.1,NC_032654.1,40386293,43865333,43865334,T,TC,1
NC_037332.1,NC_032654.1,40434796,43913841,43913844,g,gtgt,3
NC_037332.1,NC_032654.1,40440162,43919206,43919207,t,ta,1
NC_037332.1,NC_032654.1,40474779,43953825,43953826,T,TK,1
NC_037332.1,NC_032654.1,40488256,43967299,43967300,t,tN,1
NC_037332.1,NC_032654.1,40498718,43977762,43977763,a,ac,1
NC_037332.1,NC_032654.1,40561445,44040498,44040499,c,ct,1
NC_037332.1,NC_032654.1,40582617,44061666,44061667,g,ga,1
NC_037332.1,NC_032654.1,40592669,44071717,44071718,T,TC,1
NC_037332.1,NC_032654.1,40677768,44156853,44156855,t,taa,2
NC_037332.1,NC_032654.1,40700367,44179640,44179641,a,ac,1
NC_037332.1,NC_032654.1,40866324,44345697,44345703,t,tNNNNNN,6
NC_037332.1,NC_032654.1,40901121,44380500,44380501,g,gt,1
NC_037332.1,NC_032654.1,41009769,44487863,44487864,t,tc,1
NC_037332.1,NC_032654.1,41260516,44738616,44738617,a,at,1
NC_037332.1,NC_032654.1,41260537,44738638,44738639,c,cg,1
NC_037332.1,NC_032654.1,41260607,44738709,44738710,g,gc,1
NC_037332.1,NC_032654.1,41260693,44738796,44738797,a,at,1
NC_037332.1,NC_032654.1,41261226,44739333,44739334,c,ca,1
NC_037332.1,NC_032654.1,41262046,44740155,44740156,a,ac,1
NC_037332.1,NC_032654.1,41262869,44740977,44740978,c,ca,1
NC_037332.1,NC_032654.1,41262934,44741043,44741044,g,ga,1
NC_037332.1,NC_032654.1,41262970,44741080,44741081,t,tg,1
NC_037332.1,NC_032654.1,41263007,44741118,44741119,g,ga,1
NC_037332.1,NC_032654.1,41263035,44741147,44741148,c,ca,1
NC_037332.1,NC_032654.1,41263046,44741159,44741160,c,ca,1
NC_037332.1,NC_032654.1,41263064,44741178,44741179,c,ca,1
NC_037332.1,NC_032654.1,41263108,44741223,44741224,c,ca,1
NC_037332.1,NC_032654.1,41263155,44741271,44741272,t,tc,1
NC_037332.1,NC_032654.1,41263208,44741325,44741326,t,ta,1
NC_037332.1,NC_032654.1,41263271,44741388,44741389,g,ga,1
NC_037332.1,NC_032654.1,41263281,44741399,44741400,c,ca,1
NC_037332.1,NC_032654.1,41263364,44741483,44741484,c,ca,1
NC_037332.1,NC_032654.1,41263402,44741522,44741523,a,ag,1
NC_037332.1,NC_032654.1,41263714,44741835,44741836,g,ga,1
NC_037332.1,NC_032654.1,41263826,44741948,44741949,a,at,1
NC_037332.1,NC_032654.1,41263852,44741975,44741976,t,ta,1
NC_037332.1,NC_032654.1,41263919,44742043,44742044,t,ta,1
NC_037332.1,NC_032654.1,41264029,44742154,44742155,g,ga,1
NC_037332.1,NC_032654.1,41264923,44743050,44743051,g,ga,1
NC_037332.1,NC_032654.1,41281748,44760212,44760214,c,cca,2
NC_037332.1,NC_032654.1,41286213,44764687,44764689,T,TAA,2
NC_037332.1,NC_032654.1,41287575,44766052,44766053,G,GK,1
NC_037332.1,NC_032654.1,41291417,44769978,44769979,A,AW,1
NC_037332.1,NC_032654.1,41293216,44771778,44771779,T,TK,1
NC_037332.1,NC_032654.1,41296631,44775196,44775199,a,aagg,3
NC_037332.1,NC_032654.1,41315588,44794174,44794175,t,tN,1
NC_037332.1,NC_032654.1,41341697,44820157,44820158,g,ga,1
NC_037332.1,NC_032654.1,41341821,44820281,44820282,g,gt,1
NC_037332.1,NC_032654.1,41341870,44820331,44820341,t,tgagcactgaa,10
NC_037332.1,NC_032654.1,41342073,44820544,44820545,t,tg,1
NC_037332.1,NC_032654.1,41403944,44875333,44875334,A,AN,1
NC_037332.1,NC_032654.1,41409769,44881183,44881184,c,ca,1
NC_037332.1,NC_032654.1,41411312,44882727,44882728,A,AC,1
NC_037332.1,NC_032654.1,41413872,44884941,44884942,t,tc,1
NC_037332.1,NC_032654.1,41423142,44894216,44894222,T,TTCTCAG,6
NC_037332.1,NC_032654.1,41428645,44899732,44899733,C,CY,1
NC_037332.1,NC_032654.1,41429580,44900668,44900673,g,gaagtt,5
NC_037332.1,NC_032654.1,41439701,44913642,44913643,A,AW,1
NC_037332.1,NC_032654.1,41443260,44917203,44917204,c,ct,1
NC_037332.1,NC_032654.1,41445783,44919726,44919729,a,aaag,3
NC_037332.1,NC_032654.1,41462154,44936096,44936101,a,actgat,5
NC_037332.1,NC_032654.1,41495727,44970071,44970073,C,CTT,2
NC_037332.1,NC_032654.1,41630250,45119082,45119083,t,ta,1
NC_037332.1,NC_032654.1,41706765,45200222,45200223,t,tg,1
NC_037332.1,NC_032654.1,41747586,45241880,45241881,t,tg,1
NC_037332.1,NC_032654.1,41902505,45413752,45413753,a,ac,1
NC_037332.1,NC_032654.1,42012753,45524002,45524003,a,aM,1
NC_037332.1,NC_032654.1,42242699,45735309,45735311,c,cta,2
NC_037332.1,NC_032654.1,42243551,45736163,45736164,a,ag,1
NC_037332.1,NC_032654.1,42296556,45789168,45789169,A,AC,1
NC_037332.1,NC_032654.1,42389316,45882475,45882485,g,gtttttatatt,10
NC_037332.1,NC_032654.1,42389482,45882651,45882657,T,TTTAAAG,6
NC_037332.1,NC_032654.1,42421157,45914329,45914330,A,AG,1
NC_037332.1,NC_032654.1,42446068,45939262,45939263,G,GT,1
NC_037332.1,NC_032654.1,42447349,45940550,45940573,a,atagccttgactagatgtaccttt,23
NC_037332.1,NC_032654.1,42453501,45946728,45946730,G,GTR,2
NC_037332.1,NC_032654.1,42467640,45960793,45960794,t,tc,1
NC_037332.1,NC_032654.1,42503407,45996564,45996565,A,AS,1
NC_037332.1,NC_032654.1,42506812,45999978,45999979,G,GN,1
NC_037332.1,NC_032654.1,42507439,46000606,46000639,T,TGCTGAGCCTTCTGAGCCGCGgagcaggagaggg,33
NC_037332.1,NC_032654.1,42514376,46007577,46007578,a,at,1
NC_037332.1,NC_032654.1,42724846,46197345,46197346,c,ct,1
NC_037332.1,NC_032654.1,42764639,46237132,46237133,T,TC,1
NC_037332.1,NC_032654.1,42791236,46263729,46263731,C,CAA,2
NC_037332.1,NC_032654.1,42918095,46390549,46390551,t,taa,2
NC_037332.1,NC_032654.1,42952473,46424933,46424934,a,ac,1
NC_037332.1,NC_032654.1,42952490,46424951,46424953,a,aaN,2
NC_037332.1,NC_032654.1,42962007,46434469,46434470,G,GT,1
NC_037332.1,NC_032654.1,43007724,46480655,46480656,a,at,1
NC_037332.1,NC_032654.1,43059716,46532791,46532792,g,ga,1
NC_037332.1,NC_032654.1,43072171,46545224,46545225,c,ca,1
NC_037332.1,NC_032654.1,43072224,46545278,46545295,t,ttgattNNNNNNNNNNNN,17
NC_037332.1,NC_032654.1,43075958,46549030,46549031,A,AG,1
NC_037332.1,NC_032654.1,43146626,46620457,46620458,A,AS,1
NC_037332.1,NC_032654.1,43224608,46698236,46698237,T,TY,1
NC_037332.1,NC_032654.1,43225491,46699593,46699594,a,at,1
NC_037332.1,NC_032654.1,43238185,46712289,46712290,T,TY,1
NC_037332.1,NC_032654.1,43246047,46720154,46720164,a,acaTACCTAGT,10
NC_037332.1,NC_032654.1,43251980,46726094,46726097,a,aaac,3
NC_037332.1,NC_032654.1,43256558,46730674,46730675,t,tc,1
NC_037332.1,NC_032654.1,43256619,46730736,46730737,c,ca,1
NC_037332.1,NC_032654.1,43256675,46730792,46730793,t,tc,1
NC_037332.1,NC_032654.1,43297126,46775852,46775853,g,ga,1
NC_037332.1,NC_032654.1,43314145,46792930,46792932,A,AAC,2
NC_037332.1,NC_032654.1,43315658,46794452,46794455,t,taca,3
NC_037332.1,NC_032654.1,43330110,46808925,46808941,a,atgGANNNNNNNNNNNN,16
NC_037332.1,NC_032654.1,43340673,46819508,46819509,c,ct,1
NC_037332.1,NC_032654.1,43350344,46829201,46829204,t,ttaa,3
NC_037332.1,NC_032654.1,43362061,46868580,46868581,T,TG,1
NC_037332.1,NC_032654.1,43367104,46873625,46873626,c,ca,1
NC_037332.1,NC_032654.1,43373681,46880206,46880207,a,ag,1
NC_037332.1,NC_032654.1,43377614,46884141,46884142,g,gt,1
NC_037332.1,NC_032654.1,43384249,46890829,46890852,A,ACATGGCTGCTGGGCAAGAAACTT,23
NC_037332.1,NC_032654.1,43385964,46892569,46892571,a,att,2
NC_037332.1,NC_032654.1,43385973,46892580,46892581,a,at,1
NC_037332.1,NC_032654.1,43386709,46893317,46893319,A,ATR,2
NC_037332.1,NC_032654.1,43459589,46970475,46970476,a,ac,1
NC_037332.1,NC_032654.1,43590127,47101223,47101224,g,gt,1
NC_037332.1,NC_032654.1,43617311,47127470,47127471,T,TC,1
NC_037332.1,NC_032654.1,43622509,47132668,47132669,G,GA,1
NC_037332.1,NC_032654.1,43713671,47223850,47223857,G,GNNNNNNN,7
NC_037332.1,NC_032654.1,43821824,47333177,47333178,t,ta,1
NC_037332.1,NC_032654.1,43843275,47354629,47354639,g,gccgtctggac,10
NC_037332.1,NC_032654.1,44228879,47818349,47818351,c,caa,2
NC_037332.1,NC_032654.1,44241855,47782658,47782659,T,TC,1
NC_037332.1,NC_032654.1,44242841,47783645,47783646,a,at,1
NC_037332.1,NC_032654.1,44244522,47785327,47785331,C,CAAAT,4
NC_037332.1,NC_032654.1,44292513,47854586,47854587,G,GA,1
NC_037332.1,NC_032654.1,44292601,47854675,47854676,C,CG,1
NC_037332.1,NC_032654.1,44359581,47920596,47920597,a,ag,1
NC_037332.1,NC_032654.1,44384908,47945875,47945878,a,aMAC,3
NC_037332.1,NC_032654.1,44397929,47958899,47958900,T,TG,1
NC_037332.1,NC_032654.1,44418741,47979193,47979194,t,ta,1
NC_037332.1,NC_032654.1,44475793,48046663,48046664,c,ca,1
NC_037332.1,NC_032654.1,44524268,48095030,48095032,t,tga,2
NC_037332.1,NC_032654.1,44564887,48135654,48135655,G,GT,1
NC_037332.1,NC_032654.1,44708690,48281197,48281198,A,AM,1
NC_037332.1,NC_032654.1,44708735,48281243,48281244,G,GT,1
NC_037332.1,NC_032654.1,44710425,48282934,48282935,T,TC,1
NC_037332.1,NC_032654.1,44886293,48497478,48497479,G,GK,1
NC_037332.1,NC_032654.1,44919235,48533692,48533693,a,aN,1
NC_037332.1,NC_032654.1,44919577,48534037,48534038,g,ga,1
NC_037332.1,NC_032654.1,44919798,48534262,48534263,c,ct,1
NC_037332.1,NC_032654.1,44973093,48587560,48587561,c,ct,1
NC_037332.1,NC_032654.1,44973743,48588211,48588212,c,ca,1
NC_037332.1,NC_032654.1,45097180,48770344,48770345,G,GR,1
NC_037332.1,NC_032654.1,45296739,48971395,48971396,T,TK,1
NC_037332.1,NC_032654.1,45536744,49284620,49284622,t,tNN,2
NC_037332.1,NC_032654.1,45957545,49751817,49751819,c,ctt,2
NC_037332.1,NC_032654.1,46308617,50106390,50106392,t,tNN,2
NC_037332.1,NC_032654.1,46328166,50125941,50125942,c,ct,1
NC_037332.1,NC_032654.1,46350325,50167553,50167554,G,GW,1
NC_037332.1,NC_032654.1,46350332,50167561,50167562,C,CG,1
NC_037332.1,NC_032654.1,46370947,50122261,50122262,t,ta,1
NC_037332.1,NC_032654.1,46371042,50122165,50122166,c,ca,1
NC_037332.1,NC_032654.1,46721958,50561490,50561491,A,AR,1
NC_037332.1,NC_032654.1,46870588,50713032,50713033,T,TC,1
NC_037332.1,NC_032654.1,46885913,50728274,50728275,G,GA,1
NC_037332.1,NC_032654.1,47025895,50879075,50879076,g,ga,1
NC_037332.1,NC_032654.1,47418529,51360010,51360011,G,GA,1
NC_037332.1,NC_032654.1,47507263,51448984,51448985,g,gt,1
NC_037332.1,NC_032654.1,47545972,51487468,51487469,G,GC,1
NC_037332.1,NC_032654.1,47555232,51496730,51496731,A,AT,1
NC_037332.1,NC_032654.1,47555237,51496736,51496737,A,AC,1
NC_037332.1,NC_032654.1,47659071,51600840,51600841,T,TC,1
NC_037332.1,NC_032654.1,47873936,51819204,51819205,A,AR,1
NC_037332.1,NC_032654.1,48055972,52001761,52001762,a,ag,1
NC_037332.1,NC_032654.1,48108911,52054907,52054908,c,ct,1
NC_037332.1,NC_032654.1,48120922,53232001,53232002,A,AT,1
NC_037332.1,NC_032654.1,48169035,53280208,53280209,A,AM,1
NC_037332.1,NC_032654.1,48347645,52300866,52300867,C,CT,1
NC_037332.1,NC_032654.1,48348749,52301802,52301804,C,CNN,2
NC_037332.1,NC_032654.1,48916695,52870913,52870914,T,TA,1
NC_037332.1,NC_032654.1,48940541,52894765,52894766,A,AC,1
NC_037332.1,NC_032654.1,48984895,52936315,52936316,c,ca,1
NC_037332.1,NC_032654.1,48984898,52936319,52936323,a,acaat,4
NC_037332.1,NC_032654.1,49080532,53031704,53031705,G,GA,1
NC_037332.1,NC_032654.1,49117744,53068709,53068710,T,TA,1
NC_037332.1,NC_032654.1,49938653,54091483,54091484,T,TA,1
NC_037332.1,NC_032654.1,49947171,54100002,54100003,t,tc,1
NC_037332.1,NC_032654.1,50009790,54162620,54162645,G,GNNNNNNNNNNNNNNNNNNNNNNNNN,25
NC_037332.1,NC_032654.1,50232666,54392624,54392625,c,ca,1
NC_037332.1,NC_032654.1,50232990,54392949,54392952,c,caag,3
NC_037332.1,NC_032654.1,50233168,54393130,54393132,c,cat,2
NC_037332.1,NC_032654.1,50233600,54393561,54393562,g,ga,1
NC_037332.1,NC_032654.1,50233742,54393704,54393705,c,ca,1
NC_037332.1,NC_032654.1,50442017,54608493,54608494,a,at,1
NC_037332.1,NC_032654.1,50491628,54657898,54657899,t,ta,1
NC_037332.1,NC_032654.1,50491690,54657961,54657962,g,gt,1
NC_037332.1,NC_032654.1,50568055,54734371,54734372,C,CT,1
NC_037332.1,NC_032654.1,50587840,54754158,54754159,G,GS,1
NC_037332.1,NC_032654.1,50709562,54877968,54877969,t,ta,1
NC_037332.1,NC_032654.1,50728745,54897145,54897146,G,GA,1
NC_037332.1,NC_032654.1,50728971,54897371,54897374,T,TAAA,3
NC_037332.1,NC_032654.1,50813084,54983113,54983114,t,tK,1
NC_037332.1,NC_032654.1,51051873,55223127,55223142,C,CCTCATACCTCACTGA,15
NC_037332.1,NC_032654.1,51061900,55233178,55233185,C,CACTTCTA,7
NC_037332.1,NC_032654.1,51469186,55708958,55708962,a,aNNNN,4
NC_037332.1,NC_032654.1,51559954,55800367,55800369,a,aNN,2
NC_037332.1,NC_032654.1,51564898,55805314,55805316,g,gta,2
NC_037332.1,NC_032654.1,51707017,55946870,55946871,G,GA,1
NC_037332.1,NC_032654.1,51724963,55964818,55964819,T,TA,1
NC_037332.1,NC_032654.1,51749403,55989456,55989457,a,at,1
NC_037332.1,NC_032654.1,51771243,56011257,56011275,t,tgaaagaagagaaagaaga,18
NC_037332.1,NC_032654.1,51792000,56037068,56037069,a,ag,1
NC_037332.1,NC_032654.1,52071024,56299668,56299670,a,att,2
NC_037332.1,NC_032654.1,52174211,56402547,56402548,T,TC,1
NC_037332.1,NC_032654.1,52227170,56457163,56457164,t,tc,1
NC_037332.1,NC_032654.1,52299166,56528679,56528680,A,AT,1
NC_037332.1,NC_032654.1,52399176,56630512,56630522,a,ataTCCNNNNN,10
NC_037332.1,NC_032654.1,52417721,56649081,56649082,t,ta,1
NC_037332.1,NC_032654.1,52417754,56649115,56649139,c,cctttgatcattatgtagtgtcctt,24
NC_037332.1,NC_032654.1,52720832,56961009,56961010,t,tg,1
NC_037332.1,NC_032654.1,52809514,57049694,57049695,a,at,1
NC_037332.1,NC_032654.1,52810175,57050356,57050359,a,aaag,3
NC_037332.1,NC_032654.1,52825999,57085509,57085511,t,tNN,2
NC_037332.1,NC_032654.1,53130605,57395754,57395755,t,ta,1
NC_037332.1,NC_032654.1,53133819,57398968,57398969,C,CT,1
NC_037332.1,NC_032654.1,53275607,57541438,57541439,A,AG,1
NC_037332.1,NC_032654.1,53502337,57771652,57771654,a,atg,2
NC_037332.1,NC_032654.1,53573175,57838263,57838264,t,tc,1
NC_037332.1,NC_032654.1,53657272,57922370,57922371,T,TG,1
NC_037332.1,NC_032654.1,53669059,57934160,57934161,t,tc,1
NC_037332.1,NC_032654.1,53767991,58033736,58033737,t,tc,1
NC_037332.1,NC_032654.1,53767994,58033740,58033741,g,gt,1
NC_037332.1,NC_032654.1,53917957,58183729,58183730,T,TA,1
NC_037332.1,NC_032654.1,53949885,58215658,58215659,G,GC,1
NC_037332.1,NC_032654.1,54043493,58312524,58312531,g,gaaagtga,7
NC_037332.1,NC_032654.1,54044679,58313717,58313718,g,gt,1
NC_037332.1,NC_032654.1,54183331,58455747,58455749,c,caa,2
NC_037332.1,NC_032654.1,54258671,58531095,58531096,t,tc,1
NC_037332.1,NC_032654.1,54412240,58684704,58684706,C,CGG,2
NC_037332.1,NC_032654.1,54453791,58726258,58726259,t,tN,1
NC_037332.1,NC_032654.1,54818545,59120001,59120005,g,gtata,4
NC_037332.1,NC_032654.1,54975814,59284559,59284562,T,TAGA,3
NC_037332.1,NC_032654.1,55080044,59388028,59388029,t,ta,1
NC_037332.1,NC_032654.1,55295235,59603540,59603541,A,AG,1
NC_037332.1,NC_032654.1,55337077,59645164,59645165,g,gc,1
NC_037332.1,NC_032654.1,55340187,59648275,59648276,c,ca,1
NC_037332.1,NC_032654.1,55569909,59880161,59880163,t,ttg,2
NC_037332.1,NC_032654.1,55950153,60286437,60286438,G,GA,1
NC_037332.1,NC_032654.1,56007494,60343617,60343618,T,TY,1
NC_037332.1,NC_032654.1,56024759,60360883,60360884,g,ga,1
NC_037332.1,NC_032654.1,56076570,60442921,60442923,a,aNN,2
NC_037332.1,NC_032654.1,56242472,60630333,60630334,C,CK,1
NC_037332.1,NC_032654.1,56313419,60701064,60701065,g,gc,1
NC_037332.1,NC_032654.1,56345516,60732971,60732977,G,GTGTTAC,6
NC_037332.1,NC_032654.1,56406222,60793914,60793915,G,GA,1
NC_037332.1,NC_032654.1,56526226,60913728,60913729,C,CA,1
NC_037332.1,NC_032654.1,56627961,61049531,61049535,t,taccc,4
NC_037332.1,NC_032654.1,56637126,61058702,61058703,T,TA,1
NC_037332.1,NC_032654.1,56703256,61146663,61146668,a,ataagt,5
NC_037332.1,NC_032654.1,56735965,61179378,61179379,c,ct,1
NC_037332.1,NC_032654.1,56798097,61241490,61241492,c,ccg,2
NC_037332.1,NC_032654.1,56800865,61244260,61244261,C,CT,1
NC_037332.1,NC_032654.1,56800872,61244268,61244269,T,TG,1
NC_037332.1,NC_032654.1,56800909,61244306,61244309,A,ACTT,3
NC_037332.1,NC_032654.1,56800935,61244335,61244336,A,AM,1
NC_037332.1,NC_032654.1,56905913,61349149,61349150,c,ct,1
NC_037332.1,NC_032654.1,56992928,61435308,61435309,G,GT,1
NC_037332.1,NC_032654.1,57598684,62041939,62041941,t,tNN,2
NC_037332.1,NC_032654.1,57624829,62067685,62067686,t,tc,1
NC_037332.1,NC_032654.1,57692041,62134891,62134892,a,at,1
NC_037332.1,NC_032654.1,57787700,62234199,62234204,T,TCTTGA,5
NC_037332.1,NC_032654.1,57825004,62272826,62272834,g,gtggtgtgt,8
NC_037332.1,NC_032654.1,57828306,62276142,62276144,a,agt,2
NC_037332.1,NC_032654.1,57877806,62325071,62325072,C,CA,1
NC_037332.1,NC_032654.1,57892917,62340183,62340189,C,CTTAGGT,6
NC_037332.1,NC_032654.1,57893011,62340283,62340288,A,AACTTT,5
NC_037332.1,NC_032654.1,57926698,62373976,62373982,T,TAATNNN,6
NC_037332.1,NC_032654.1,57956469,62403740,62403741,a,ag,1
NC_037332.1,NC_032654.1,58082370,62533082,62533084,c,ctg,2
NC_037332.1,NC_032654.1,58082628,62533342,62533343,t,tc,1
NC_037332.1,NC_032654.1,58181428,62610642,62610643,t,tg,1
NC_037332.1,NC_032654.1,58267327,62696192,62696193,c,ca,1
NC_037332.1,NC_032654.1,58431245,62860373,62860374,a,at,1
NC_037332.1,NC_032654.1,58434428,62863551,62863552,G,GT,1
NC_037332.1,NC_032654.1,58595293,63024404,63024405,G,GR,1
NC_037332.1,NC_032654.1,58631733,63061016,63061017,A,AC,1
NC_037332.1,NC_032654.1,58719129,63271201,63271203,a,aNN,2
NC_037332.1,NC_032654.1,58831204,63365386,63365398,A,ATTAGAAATCTCC,12
NC_037332.1,NC_032654.1,58832234,63366428,63366443,g,gttcagttcagttcaa,15
NC_037332.1,NC_032654.1,58833564,63367775,63367778,c,caaa,3
NC_037332.1,NC_032654.1,58835220,63369425,63369426,g,ga,1
NC_037332.1,NC_032654.1,58835397,63369603,63369604,T,TA,1
NC_037332.1,NC_032654.1,58838256,63372682,63372687,C,CCTTTA,5
NC_037332.1,NC_032654.1,58838609,63373042,63373043,c,ca,1
NC_037332.1,NC_032654.1,58840106,63374534,63374535,a,ag,1
NC_037332.1,NC_032654.1,58840596,63375024,63375039,a,aaaggtccgtctagtc,15
NC_037332.1,NC_032654.1,58841858,63376298,63376302,C,CAGAT,4
NC_037332.1,NC_032654.1,58842898,63377340,63377341,g,ga,1
NC_037332.1,NC_032654.1,58842898,63079576,63079577,g,ga,1
NC_037332.1,NC_032654.1,58843333,63377778,63377779,c,ct,1
NC_037332.1,NC_032654.1,58843333,63080014,63080015,c,ct,1
NC_037332.1,NC_032654.1,58843428,63377874,63377875,T,TG,1
NC_037332.1,NC_032654.1,58843428,63080110,63080111,T,TG,1
NC_037332.1,NC_032654.1,58844612,63081295,63081296,C,CT,1
NC_037332.1,NC_032654.1,58844641,63379087,63379089,C,CTA,2
NC_037332.1,NC_032654.1,58844641,63081325,63081327,C,CTA,2
NC_037332.1,NC_032654.1,58844712,63379160,63379164,a,atttt,4
NC_037332.1,NC_032654.1,58844712,63081398,63081402,a,atttt,4
NC_037332.1,NC_032654.1,58845861,63380287,63380288,A,AW,1
NC_037332.1,NC_032654.1,58846946,63083611,63083612,c,ct,1
NC_037332.1,NC_032654.1,58847609,63382036,63382037,G,GT,1
NC_037332.1,NC_032654.1,58848134,63382551,63382552,t,ta,1
NC_037332.1,NC_032654.1,58848187,63382605,63382606,T,TA,1
NC_037332.1,NC_032654.1,58849360,63383779,63383780,c,cA,1
NC_037332.1,NC_032654.1,58850264,63384681,63384682,a,ac,1
NC_037332.1,NC_032654.1,58850904,63385297,63385298,c,ct,1
NC_037332.1,NC_032654.1,58851532,63385908,63385912,t,tNNNN,4
NC_037332.1,NC_032654.1,58858611,63392989,63392990,A,AG,1
NC_037332.1,NC_032654.1,58859162,63393541,63393549,A,ATTCCTAAC,8
NC_037332.1,NC_032654.1,58887223,63124276,63124284,c,caaaacaaa,8
NC_037332.1,NC_032654.1,58962956,63437626,63437627,t,ta,1
NC_037332.1,NC_032654.1,58977938,63452749,63452754,t,tttcac,5
NC_037332.1,NC_032654.1,59016324,63493288,63493289,g,ga,1
NC_037332.1,NC_032654.1,59234554,63799246,63799247,a,ag,1
NC_037332.1,NC_032654.1,59236614,63801307,63801308,a,ac,1
NC_037332.1,NC_032654.1,59267636,63837183,63837184,c,ct,1
NC_037332.1,NC_032654.1,59281507,63855194,63855196,A,AAC,2
NC_037332.1,NC_032654.1,59297880,63871774,63871775,T,TC,1
NC_037332.1,NC_032654.1,59324991,63899356,63899357,G,GN,1
NC_037332.1,NC_032654.1,59362395,63936284,63936285,T,TC,1
NC_037332.1,NC_032654.1,59549997,64118522,64118523,A,AG,1
NC_037332.1,NC_032654.1,59550395,64118920,64118922,a,aat,2
NC_037332.1,NC_032654.1,59555237,64123684,64123686,t,tNN,2
NC_037332.1,NC_032654.1,59619724,64188272,64188273,A,AG,1
NC_037332.1,NC_032654.1,59619729,64188278,64188279,A,AC,1
NC_037332.1,NC_032654.1,59619751,64188302,64188303,g,ga,1
NC_037332.1,NC_032654.1,59639634,64207598,64207599,A,AC,1
NC_037332.1,NC_032654.1,59778250,64244810,64244818,g,gtttttttt,8
NC_037332.1,NC_032654.1,60088718,64500019,64500020,G,GT,1
NC_037332.1,NC_032654.1,60175181,64586483,64586484,T,TC,1
NC_037332.1,NC_032654.1,60639614,65133138,65133139,T,TG,1
NC_037332.1,NC_032654.1,60749008,65247266,65247272,t,tACTaca,6
NC_037332.1,NC_032654.1,60749072,65247336,65247338,c,cct,2
NC_037332.1,NC_032654.1,60861593,65407462,65407463,t,tg,1
NC_037332.1,NC_032654.1,60872537,65418408,65418409,t,tg,1
NC_037332.1,NC_032654.1,61074868,65620504,65620505,A,AT,1
NC_037332.1,NC_032654.1,61468953,65972852,65972854,a,aat,2
NC_037332.1,NC_032654.1,61632016,66258826,66258827,a,ag,1
NC_037332.1,NC_032654.1,61632036,66258847,66258848,g,gc,1
NC_037332.1,NC_032654.1,62600801,67244645,67244646,G,GT,1
NC_037332.1,NC_032654.1,62756407,67401516,67401517,t,ta,1
NC_037332.1,NC_032654.1,62781825,67426732,67426733,c,cA,1
NC_037332.1,NC_032654.1,62781842,67426750,67426751,G,GC,1
NC_037332.1,NC_032654.1,62925559,67570140,67570143,A,ACAT,3
NC_037332.1,NC_032654.1,62993044,67637629,67637630,T,TA,1
NC_037332.1,NC_032654.1,62993056,67637642,67637644,C,CGA,2
NC_037332.1,NC_032654.1,62993068,67637656,67637657,A,AT,1
NC_037332.1,NC_032654.1,63102987,67747337,67747338,t,tg,1
NC_037332.1,NC_032654.1,63164518,67836880,67836881,g,gt,1
NC_037332.1,NC_032654.1,63430420,68140246,68140247,A,AT,1
NC_037332.1,NC_032654.1,63613723,68349578,68349582,t,taaaa,4
NC_037332.1,NC_032654.1,63646559,68382417,68382418,c,ct,1
NC_037332.1,NC_032654.1,63856408,68646274,68646275,g,gc,1
NC_037332.1,NC_032654.1,63973701,68769594,68769595,t,ta,1
NC_037332.1,NC_032654.1,64180304,68982248,68982249,A,AT,1
NC_037332.1,NC_032654.1,64196549,68998755,68998756,T,TC,1
NC_037332.1,NC_032654.1,64253406,69057006,69057007,G,GA,1
NC_037332.1,NC_032654.1,64278696,69082291,69082292,g,ga,1
NC_037332.1,NC_032654.1,64282871,69086466,69086470,c,caaat,4
NC_037332.1,NC_032654.1,64367270,69170848,69170849,T,TA,1
NC_037332.1,NC_032654.1,64427125,69230705,69230706,a,at,1
NC_037332.1,NC_032654.1,64446227,69249813,69249815,a,act,2
NC_037332.1,NC_032654.1,64588427,69392894,69392899,t,ttttta,5
NC_037332.1,NC_032654.1,64671114,69475591,69475592,g,gt,1
NC_037332.1,NC_032654.1,64721146,69525456,69525457,a,at,1
NC_037332.1,NC_032654.1,65009896,69813194,69813195,t,tg,1
NC_037332.1,NC_032654.1,65087045,69891309,69891311,T,TAA,2
NC_037332.1,NC_032654.1,65659549,70473638,70473639,G,GR,1
NC_037332.1,NC_032654.1,65688456,70502547,70502548,C,CG,1
NC_037332.1,NC_032654.1,65837486,70649078,70649079,a,ag,1
NC_037332.1,NC_032654.1,65927540,70738722,70738723,a,at,1
NC_037332.1,NC_032654.1,65927768,70738957,70738960,c,cttY,3
NC_037332.1,NC_032654.1,65938634,70749826,70749827,C,CM,1
NC_037332.1,NC_032654.1,65981178,70792375,70792379,c,ctctt,4
NC_037332.1,NC_032654.1,66233537,71044858,71044868,C,CTTAAANNNNN,10
NC_037332.1,NC_032654.1,66233572,71044903,71044908,T,TAGATC,5
NC_037332.1,NC_032654.1,66360424,71171517,71171518,A,AT,1
NC_037332.1,NC_032654.1,66729461,71540533,71540534,T,TC,1
NC_037332.1,NC_032654.1,66736420,71547560,71547561,G,GR,1
NC_037332.1,NC_032654.1,66780571,71591822,71591823,C,CA,1
NC_037332.1,NC_032654.1,67062746,71873471,71873472,C,CT,1
NC_037332.1,NC_032654.1,67128571,71939332,71939335,A,ATTC,3
NC_037332.1,NC_032654.1,67165063,71975833,71975834,t,ta,1
NC_037332.1,NC_032654.1,67169602,71980373,71980374,g,gt,1
NC_037332.1,NC_032654.1,67176476,72011470,72011471,g,gc,1
NC_037332.1,NC_032654.1,67187123,71997897,71997898,A,AN,1
NC_037332.1,NC_032654.1,67236065,72071097,72071098,C,CA,1
NC_037332.1,NC_032654.1,67242098,72077131,72077137,c,caaaaaa,6
NC_037332.1,NC_032654.1,67342719,72175250,72175251,t,ta,1
NC_037332.1,NC_032654.1,67372592,72205125,72205149,T,TNNNNNNNNNNNNNNNNNNNNNNNN,24
NC_037332.1,NC_032654.1,67380633,72266480,72266482,a,aNN,2
NC_037332.1,NC_032654.1,67392541,72278390,72278391,T,TC,1
NC_037332.1,NC_032654.1,67515134,72400984,72400986,G,GAA,2
NC_037332.1,NC_032654.1,67560160,72462724,72462728,C,CYCAM,4
NC_037332.1,NC_032654.1,67787149,72690693,72690694,G,GK,1
NC_037332.1,NC_032654.1,67907604,72811172,72811177,C,CCAGCT,5
NC_037332.1,NC_032654.1,67972499,72876120,72876121,C,CT,1
NC_037332.1,NC_032654.1,67972505,72876127,72876135,C,CCCTGAAAT,8
NC_037332.1,NC_032654.1,68053959,72957498,72957499,A,AR,1
NC_037332.1,NC_032654.1,68060793,72964243,72964248,C,CTTCAT,5
NC_037332.1,NC_032654.1,68186684,73089214,73089215,T,TC,1
NC_037332.1,NC_032654.1,68251031,73154313,73154314,T,TG,1
NC_037332.1,NC_032654.1,68286381,73189668,73189693,T,TGTCATCAGGTTTTTGGTCCCTGGTG,25
NC_037332.1,NC_032654.1,68288248,73191560,73191562,T,TCC,2
NC_037332.1,NC_032654.1,68291829,73195144,73195147,t,tctc,3
NC_037332.1,NC_032654.1,68298888,73202211,73202212,g,ga,1
NC_037332.1,NC_032654.1,68622609,73525274,73525275,t,tg,1
NC_037332.1,NC_032654.1,68772041,73674707,73674710,C,CNNN,3
NC_037332.1,NC_032654.1,68772453,73675122,73675123,c,ca,1
NC_037332.1,NC_032654.1,68844234,73746909,73746910,A,AT,1
NC_037332.1,NC_032654.1,68928878,73832288,73832289,C,CS,1
NC_037332.1,NC_032654.1,68986545,73901909,73901910,A,AC,1
NC_037332.1,NC_032654.1,69067717,74054477,74054478,c,ca,1
NC_037332.1,NC_032654.1,69080616,74068249,74068250,t,tc,1
NC_037332.1,NC_032654.1,69111908,74099525,74099526,a,ag,1
NC_037332.1,NC_032654.1,69580426,74601314,74601315,C,CA,1
NC_037332.1,NC_032654.1,69596732,74617627,74617640,T,TAAGTGTTACAATG,13
NC_037332.1,NC_032654.1,69608907,74629815,74629817,C,CTT,2
NC_037332.1,NC_032654.1,69681610,74702576,74702577,g,ga,1
NC_037332.1,NC_032654.1,69707352,74728349,74728350,G,GA,1
NC_037332.1,NC_032654.1,69720661,74741659,74741660,a,at,1
NC_037332.1,NC_032654.1,69852653,74875588,74875589,t,tc,1
NC_037332.1,NC_032654.1,69981146,75003903,75003904,C,CM,1
NC_037332.1,NC_032654.1,70124826,75148260,75148261,G,GC,1
NC_037332.1,NC_032654.1,70124869,75148304,75148305,A,AT,1
NC_037332.1,NC_032654.1,70141913,75165349,75165350,T,TC,1
NC_037332.1,NC_032654.1,70290310,75313754,75313755,g,gt,1
NC_037332.1,NC_032654.1,70426492,75457888,75457893,g,gtccat,5
NC_037332.1,NC_032654.1,71055546,76087192,76087194,a,aaM,2
NC_037332.1,NC_032654.1,71313356,76359091,76359095,T,TTTAG,4
NC_037332.1,NC_032654.1,71324242,76369970,76369973,C,CTAG,3
NC_037332.1,NC_032654.1,71328857,76374586,76374588,A,ATC,2
NC_037332.1,NC_032654.1,71364559,76410287,76410288,t,tg,1
NC_037332.1,NC_032654.1,71376754,76422490,76422492,C,CTT,2
NC_037332.1,NC_032654.1,71381270,76427022,76427026,t,ttggg,4
NC_037332.1,NC_032654.1,71389691,76435452,76435455,T,TAGA,3
NC_037332.1,NC_032654.1,71397205,76442970,76442971,T,TC,1
NC_037332.1,NC_032654.1,71400054,76445820,76445824,A,ATAAS,4
NC_037332.1,NC_032654.1,71411714,76457484,76457487,T,TCCC,3
NC_037332.1,NC_032654.1,72302638,77348630,77348631,G,GT,1
NC_037332.1,NC_032654.1,72429968,77562781,77562782,g,gc,1
NC_037332.1,NC_032654.1,72592240,77725168,77725169,a,ac,1
NC_037332.1,NC_032654.1,72799125,77966451,77966452,a,ag,1
NC_037332.1,NC_032654.1,72890140,78057466,78057468,a,aNN,2
NC_037332.1,NC_032654.1,73064660,78218388,78218389,T,TC,1
NC_037332.1,NC_032654.1,73385110,78649032,78649033,c,cg,1
NC_037332.1,NC_032654.1,73652011,78909978,78909979,G,GR,1
NC_037332.1,NC_032654.1,73709672,78967646,78967647,T,TK,1
NC_037332.1,NC_032654.1,73756570,79014428,79014429,G,GS,1
NC_037332.1,NC_032654.1,73759803,79017662,79017668,A,AACAAAG,6
NC_037332.1,NC_032654.1,73759991,79017856,79017857,G,GA,1
NC_037332.1,NC_032654.1,73858737,79196676,79196677,a,ac,1
NC_037332.1,NC_032654.1,73901072,79238990,79238991,a,ag,1
NC_037332.1,NC_032654.1,73940414,79278336,79278337,t,tc,1
NC_037332.1,NC_032654.1,73940468,79278391,79278421,a,acttatatgcagcgtacatcatgagaaacgc,30
NC_037332.1,NC_032654.1,74252544,79581341,79581347,T,TACATCC,6
NC_037332.1,NC_032654.1,74252787,79581590,79581591,a,ag,1
NC_037332.1,NC_032654.1,74263238,79592198,79592199,t,ta,1
NC_037332.1,NC_032654.1,74325567,79745060,79745075,c,caatccatgaacatgg,15
NC_037332.1,NC_032654.1,74375842,79795805,79795806,G,GT,1
NC_037332.1,NC_032654.1,74375868,79795832,79795833,C,CM,1
NC_037332.1,NC_032654.1,74375876,79795841,79795842,C,CA,1
NC_037332.1,NC_032654.1,74376634,79796601,79796602,t,ta,1
NC_037332.1,NC_032654.1,74403337,79823307,79823308,t,tc,1
NC_037332.1,NC_032654.1,74606180,80026153,80026155,A,ATC,2
NC_037332.1,NC_032654.1,74606185,80026160,80026161,C,CA,1
NC_037332.1,NC_032654.1,74657133,80077111,80077113,a,aNN,2
NC_037332.1,NC_032654.1,74722097,80142104,80142106,A,ANN,2
NC_037332.1,NC_032654.1,74744889,80164964,80164965,G,GR,1
NC_037332.1,NC_032654.1,74765550,80185627,80185628,C,CS,1
NC_037332.1,NC_032654.1,74800148,80220238,80220243,a,agggag,5
NC_037332.1,NC_032654.1,74813225,80233328,80233329,a,ac,1
NC_037332.1,NC_032654.1,74830958,80251000,80251001,G,GC,1
NC_037332.1,NC_032654.1,74947576,80369281,80369282,T,TA,1
NC_037332.1,NC_032654.1,74991693,80413399,80413400,A,AN,1
NC_037332.1,NC_032654.1,74993725,80415431,80415432,G,GA,1
NC_037332.1,NC_032654.1,75147217,80595530,80595531,T,TG,1
NC_037332.1,NC_032654.1,75189969,80637924,80637926,c,cag,2
NC_037332.1,NC_032654.1,75302602,80750998,80750999,g,ga,1
NC_037332.1,NC_032654.1,75339363,80787768,80787769,T,TW,1
NC_037332.1,NC_032654.1,75344692,80793097,80793098,c,ct,1
NC_037332.1,NC_032654.1,75348329,80796735,80796745,t,tNNNNNNNNNN,10
NC_037332.1,NC_032654.1,75360435,80808851,80808854,C,CCCM,3
NC_037332.1,NC_032654.1,75389370,80837807,80837808,g,gt,1
NC_037332.1,NC_032654.1,75405167,80853607,80853612,C,CCCCCM,5
NC_037332.1,NC_032654.1,75464046,80912488,80912492,c,ctgca,4
NC_037332.1,NC_032654.1,75520152,80968621,80968624,G,GTCC,3
NC_037332.1,NC_032654.1,75520152,81187139,81187142,G,GTCC,3
NC_037332.1,NC_032654.1,75625139,81057758,81057759,G,GT,1
NC_037332.1,NC_032654.1,75753117,81299689,81299695,g,gagaaat,6
NC_037332.1,NC_032654.1,75775572,81323522,81323524,A,AAT,2
NC_037332.1,NC_032654.1,75790768,81338720,81338722,G,GTA,2
NC_037332.1,NC_032654.1,75790806,81338760,81338762,G,GCA,2
NC_037332.1,NC_032654.1,75819353,81367310,81367311,C,CT,1
NC_037332.1,NC_032654.1,75927993,81474939,81474943,g,gcaca,4
NC_037332.1,NC_032654.1,76123653,81685749,81685750,g,gc,1
NC_037332.1,NC_032654.1,76156917,81719042,81719044,g,ggt,2
NC_037332.1,NC_032654.1,76180918,81743046,81743050,g,gtttt,4
NC_037332.1,NC_032654.1,76187638,81749773,81749774,a,ag,1
NC_037332.1,NC_032654.1,76187648,81749784,81749785,a,ag,1
NC_037332.1,NC_032654.1,76210093,81772430,81772431,G,GS,1
NC_037332.1,NC_032654.1,76220548,81781324,81781325,T,TC,1
NC_037332.1,NC_032654.1,76227406,81788294,81788296,a,aag,2
NC_037332.1,NC_032654.1,76281148,81854085,81854086,c,ct,1
NC_037332.1,NC_032654.1,76283632,81856570,81856571,C,CM,1
NC_037332.1,NC_032654.1,76391092,81983904,81983909,c,caactg,5
NC_037332.1,NC_032654.1,76438011,82030579,82030580,T,TG,1
NC_037332.1,NC_032654.1,76474656,82068457,82068458,a,ag,1
NC_037332.1,NC_032654.1,76488558,82083942,82083943,a,ac,1
NC_037332.1,NC_032654.1,76635099,82135540,82135541,T,TY,1
NC_037332.1,NC_032654.1,76669008,82169480,82169482,C,CYA,2
NC_037332.1,NC_032654.1,76684822,82185469,82185473,g,gYaca,4
NC_037332.1,NC_032654.1,76685728,82186379,82186380,G,GK,1
NC_037332.1,NC_032654.1,76724088,82426918,82426919,g,gt,1
NC_037332.1,NC_032654.1,76749136,82451900,82451903,T,TATG,3
NC_037332.1,NC_032654.1,76750011,82452778,82452779,C,CT,1
NC_037332.1,NC_032654.1,76755940,82458712,82458713,C,CA,1
NC_037332.1,NC_032654.1,76829796,82360527,82360529,g,gcc,2
NC_037332.1,NC_032654.1,76829871,82360604,82360607,c,caNN,3
NC_037332.1,NC_032654.1,76943237,82621648,82621653,a,aaaaag,5
NC_037332.1,NC_032654.1,76950832,82629248,82629250,c,caa,2
NC_037332.1,NC_032654.1,77040100,82718800,82718801,c,ct,1
NC_037332.1,NC_032654.1,77121039,82799812,82799813,t,ta,1
NC_037332.1,NC_032654.1,77231524,82907488,82907489,A,AC,1
NC_037332.1,NC_032654.1,77284688,82960654,82960655,a,ac,1
NC_037332.1,NC_032654.1,77589739,83265378,83265379,c,ca,1
NC_037332.1,NC_032654.1,77742039,83417109,83417110,g,gR,1
NC_037332.1,NC_032654.1,77742268,83417339,83417387,a,acgaGCGANNNNNNNNNNNNNNNNNNNNNNNNNNNNNNNNNNNNNNNNN,48
NC_037332.1,NC_032654.1,78047971,83719761,83719764,a,aaat,3
NC_037332.1,NC_032654.1,78317413,83987553,83987554,T,TC,1
NC_037332.1,NC_032654.1,78338572,84009325,84009326,a,ac,1
NC_037332.1,NC_032654.1,78697398,84370903,84370904,G,GR,1
NC_037332.1,NC_032654.1,78766504,84440013,84440015,t,tta,2
NC_037332.1,NC_032654.1,78806364,84500612,84500613,G,GA,1
NC_037332.1,NC_032654.1,79540466,85385113,85385114,C,CA,1
NC_037332.1,NC_032654.1,79597290,85446819,85446820,g,ga,1
NC_037332.1,NC_032654.1,79617662,85467192,85467193,g,ga,1
NC_037332.1,NC_032654.1,79679614,85528712,85528717,t,tggaac,5
NC_037332.1,NC_032654.1,79681733,85531228,85531229,t,tN,1
NC_037332.1,NC_032654.1,79778900,85629497,85629498,a,at,1
NC_037332.1,NC_032654.1,79939252,85790183,85790186,c,cagg,3
NC_037332.1,NC_032654.1,79948788,85799722,85799724,A,AAT,2
NC_037332.1,NC_032654.1,79958065,85809002,85809003,G,GR,1
NC_037332.1,NC_032654.1,79971115,85822053,85822054,g,ga,1
NC_037332.1,NC_032654.1,79980562,85831628,85831629,c,ct,1
NC_037332.1,NC_032654.1,80049364,85901738,85901739,C,CT,1
NC_037332.1,NC_032654.1,80077076,85929461,85929462,g,ga,1
NC_037332.1,NC_032654.1,80095744,85948125,85948133,t,tNNNNNNNN,8
NC_037332.1,NC_032654.1,80098162,85950556,85950558,c,ctt,2
NC_037332.1,NC_032654.1,80559667,86411805,86411807,a,aNN,2
NC_037332.1,NC_032654.1,80720980,86583881,86583882,g,gK,1
NC_037332.1,NC_032654.1,80721192,86584095,86584096,T,TC,1
NC_037332.1,NC_032654.1,80770933,86651587,86651588,g,ga,1
NC_037332.1,NC_032654.1,80959655,86934596,86934597,t,tc,1
NC_037332.1,NC_032654.1,80976176,86950874,86950875,t,tc,1
NC_037332.1,NC_032654.1,81127597,87103178,87103179,C,CA,1
NC_037332.1,NC_032654.1,81132416,87108037,87108038,a,ag,1
NC_037332.1,NC_032654.1,81326663,87307438,87307439,g,ga,1
NC_037332.1,NC_032654.1,81469965,87454234,87454235,T,TC,1
NC_037332.1,NC_032654.1,81469996,87454266,87454267,A,AM,1
NC_037332.1,NC_032654.1,81632719,87616991,87616992,t,tg,1
NC_037332.1,NC_032654.1,81645477,87630583,87630584,g,gt,1
NC_037332.1,NC_032654.1,81688391,87673512,87673519,g,gaaagtga,7
NC_037332.1,NC_032654.1,81710966,87696092,87696093,G,GA,1
NC_037332.1,NC_032654.1,81718716,87703844,87703848,g,gagtc,4
NC_037332.1,NC_032654.1,81942316,87928486,87928488,c,ctg,2
NC_037332.1,NC_032654.1,81942320,87928492,87928493,c,ct,1
NC_037332.1,NC_032654.1,81942528,87928701,87928702,c,ct,1
NC_037332.1,NC_032654.1,81948940,87935114,87935115,t,tg,1
NC_037332.1,NC_032654.1,81962832,87949003,87949005,g,gaa,2
NC_037332.1,NC_032654.1,81963194,87949366,87949372,a,aaaacat,6
NC_037332.1,NC_032654.1,81963268,87949446,87949447,t,tc,1
NC_037332.1,NC_032654.1,81964058,87950232,87950233,T,TA,1
NC_037332.1,NC_032654.1,82038399,88024514,88024515,t,tg,1
NC_037332.1,NC_032654.1,82048724,88034834,88034835,t,tg,1
NC_037332.1,NC_032654.1,82063491,88049604,88049605,C,CG,1
NC_037332.1,NC_032654.1,82088506,88074634,88074635,g,gc,1
NC_037332.1,NC_032654.1,82088526,88074655,88074656,a,ag,1
NC_037332.1,NC_032654.1,82110782,88096912,88096913,C,CT,1
NC_037332.1,NC_032654.1,82299466,88290650,88290651,c,ca,1
NC_037332.1,NC_032654.1,82328643,88319829,88319830,A,AM,1
NC_037332.1,NC_032654.1,82379038,88370287,88370289,G,GAA,2
NC_037332.1,NC_032654.1,82400331,88393824,88393825,C,CG,1
NC_037332.1,NC_032654.1,82518987,88512530,88512531,T,TA,1
NC_037332.1,NC_032654.1,82520220,88513764,88513765,g,gt,1
NC_037332.1,NC_032654.1,82533119,88526664,88526666,a,aNN,2
NC_037332.1,NC_032654.1,82533912,88527460,88527461,T,TA,1
NC_037332.1,NC_032654.1,82547313,88540862,88540863,c,ct,1
NC_037332.1,NC_032654.1,82558199,88551751,88551752,g,gt,1
NC_037332.1,NC_032654.1,82572391,88566075,88566077,t,tNN,2
NC_037332.1,NC_032654.1,82676550,88673182,88673183,T,TY,1
NC_037332.1,NC_032654.1,82720188,88719256,88719257,A,AG,1
NC_037332.1,NC_032654.1,82751342,88752888,88752889,A,AT,1
NC_037332.1,NC_032654.1,82778747,88781877,88781879,c,cca,2
NC_037332.1,NC_032654.1,82834301,88837433,88837434,C,CA,1
NC_037332.1,NC_032654.1,82839954,88843087,88843088,c,ct,1
NC_037332.1,NC_032654.1,82896047,88911285,88911286,c,ct,1
NC_037332.1,NC_032654.1,82896064,88911303,88911305,c,cca,2
NC_037332.1,NC_032654.1,82896068,88911309,88911310,t,ta,1
NC_037332.1,NC_032654.1,82896086,88911328,88911329,t,ta,1
NC_037332.1,NC_032654.1,82896093,88911336,88911337,c,ca,1
NC_037332.1,NC_032654.1,82922994,88937461,88937462,t,tg,1
NC_037332.1,NC_032654.1,82938743,88953847,88953849,G,GGA,2
NC_037332.1,NC_032654.1,83046337,89060835,89060837,G,GAT,2
NC_037332.1,NC_032654.1,83103607,89118103,89118104,c,ct,1
NC_037332.1,NC_032654.1,83173406,89269586,89269587,t,tc,1
NC_037332.1,NC_032654.1,83173481,89269662,89269663,c,cg,1
NC_037332.1,NC_032654.1,83352702,89468240,89468242,C,CCT,2
NC_037332.1,NC_032654.1,83428347,89543851,89543852,T,TK,1
NC_037332.1,NC_032654.1,83602993,89718514,89718523,g,gcccaTCTaa,9
NC_037332.1,NC_032654.1,83603057,89718588,89718589,t,tc,1
NC_037332.1,NC_032654.1,83682167,89797713,89797717,G,GGTTA,4
NC_037332.1,NC_032654.1,83727134,89842545,89842546,c,ct,1
NC_037332.1,NC_032654.1,83908956,90023254,90023256,A,AAT,2
NC_037332.1,NC_032654.1,83936916,90051219,90051220,g,gt,1
NC_037332.1,NC_032654.1,83967147,90081450,90081507,t,tctgtttgttcccCAGCTCTGNNNNNNNNNNNNNNNNNNNNNNNNNNNNNGCCAAAaa,57
NC_037332.1,NC_032654.1,84282224,90462216,90462217,T,TY,1
NC_037332.1,NC_032654.1,84648157,90866673,90866674,c,ct,1
NC_037332.1,NC_032654.1,84687799,90906257,90906258,a,ag,1
NC_037332.1,NC_032654.1,84849391,91067852,91067853,g,ga,1
NC_037332.1,NC_032654.1,85009390,91227982,91227983,a,ag,1
NC_037332.1,NC_032654.1,85018027,91236620,91236623,A,AGCC,3
NC_037332.1,NC_032654.1,85028130,91247426,91247428,a,aNN,2
NC_037332.1,NC_032654.1,85029902,91249200,91249201,T,TA,1
NC_037332.1,NC_032654.1,85035410,91254710,91254711,a,ag,1
NC_037332.1,NC_032654.1,85036330,91255628,91255634,t,ttgaaag,6
NC_037332.1,NC_032654.1,85064574,91283804,91283805,t,ta,1
NC_037332.1,NC_032654.1,85064583,91283814,91283815,g,gc,1
NC_037332.1,NC_032654.1,85064599,91283831,91283832,g,ga,1
NC_037332.1,NC_032654.1,85128321,91347649,91347650,c,ca,1
NC_037332.1,NC_032654.1,85185710,91405065,91405068,C,CTGT,3
NC_037332.1,NC_032654.1,85185714,91405072,91405074,T,TTG,2
NC_037332.1,NC_032654.1,85206076,91425430,91425431,T,TA,1
NC_037332.1,NC_032654.1,85320530,91539892,91539893,g,ga,1
NC_037332.1,NC_032654.1,85395371,91600607,91600608,g,ga,1
NC_037332.1,NC_032654.1,85395525,91600762,91600763,T,TC,1
NC_037332.1,NC_032654.1,85395578,91600816,91600817,C,CA,1
NC_037332.1,NC_032654.1,85396656,91601895,91601896,c,ct,1
NC_037332.1,NC_032654.1,85397262,91602502,91602504,a,atg,2
NC_037332.1,NC_032654.1,85399927,91605171,91605175,A,AGACT,4
NC_037332.1,NC_032654.1,85431468,91636790,91636791,C,CA,1
NC_037332.1,NC_032654.1,85473640,91678977,91678978,T,TK,1
NC_037332.1,NC_032654.1,85517157,91722509,91722510,a,ag,1
NC_037332.1,NC_032654.1,85601092,91806249,91806250,G,GT,1
NC_037332.1,NC_032654.1,85644113,91849273,91849274,t,tc,1
NC_037332.1,NC_032654.1,85730777,91935934,91935938,a,aNNNN,4
NC_037332.1,NC_032654.1,85732059,91937220,91937228,a,aNNNNNNNN,8
NC_037332.1,NC_032654.1,85750783,91955941,91955942,T,TG,1
NC_037332.1,NC_032654.1,85763806,91968966,91968971,T,TAGGTG,5
NC_037332.1,NC_032654.1,85772578,91977745,91977751,t,tNNNNNN,6
NC_037332.1,NC_032654.1,85904590,92109764,92109765,t,tc,1
NC_037332.1,NC_032654.1,86001283,92206465,92206466,t,tY,1
NC_037332.1,NC_032654.1,86124713,92329877,92329878,c,ca,1
NC_037332.1,NC_032654.1,86131714,92336879,92336880,t,ta,1
NC_037332.1,NC_032654.1,86205329,92451210,92451213,C,CCAA,3
NC_037332.1,NC_032654.1,86206885,92452772,92452774,A,ATC,2
NC_037332.1,NC_032654.1,86207608,92453498,92453499,t,ta,1
NC_037332.1,NC_032654.1,86245854,92491745,92491746,c,ct,1
NC_037332.1,NC_032654.1,86251898,92497790,92497791,g,gt,1
NC_037332.1,NC_032654.1,86349846,92604326,92604327,c,ct,1
NC_037332.1,NC_032654.1,86388303,92642795,92642796,T,TA,1
NC_037332.1,NC_032654.1,86402201,92656701,92656710,t,tagcagcagc,9
NC_037332.1,NC_032654.1,86405137,92659647,92659651,A,ACTTT,4
NC_037332.1,NC_032654.1,86405701,92660214,92660240,A,AACACACATTTAATCTCTATCCCATAM,26
NC_037332.1,NC_032654.1,86409918,92664463,92664464,g,gt,1
NC_037332.1,NC_032654.1,86438046,92692595,92692596,c,ca,1
NC_037332.1,NC_032654.1,86453619,92708169,92708170,A,AW,1
NC_037332.1,NC_032654.1,86462728,92717277,92717278,T,TW,1
NC_037332.1,NC_032654.1,86523978,92778720,92778721,G,GT,1
NC_037332.1,NC_032654.1,86540027,92794770,92794771,T,TG,1
NC_037332.1,NC_032654.1,86567080,92821820,92821821,T,TA,1
NC_037332.1,NC_032654.1,86622597,92876175,92876178,T,TTAY,3
NC_037332.1,NC_032654.1,86628729,92882311,92882313,a,agg,2
NC_037332.1,NC_032654.1,86636781,92890375,92890377,t,tta,2
NC_037332.1,NC_032654.1,86666860,92920465,92920472,a,atggcatc,7
NC_037332.1,NC_032654.1,86666974,92920586,92920597,a,atgcttgctcct,11
NC_037332.1,NC_032654.1,86722051,92974982,92974983,G,GR,1
NC_037332.1,NC_032654.1,86722141,92975073,92975074,T,TG,1
NC_037332.1,NC_032654.1,86724876,92977802,92977803,c,ca,1
NC_037332.1,NC_032654.1,86731729,92984657,92984717,G,GCCCCNNNNNNNNNNNNNNNNNNNNNNNNNNNNNNNNNNNNNNNNTACTTCCCCTATAATT,60
NC_037332.1,NC_032654.1,86776486,93029091,93029094,g,gtaa,3
NC_037332.1,NC_032654.1,86791577,93044185,93044198,t,ttgctgtctcgtac,13
NC_037332.1,NC_032654.1,86800820,93053443,93053444,c,cS,1
NC_037332.1,NC_032654.1,86805639,93058355,93058356,a,aW,1
NC_037332.1,NC_032654.1,86868258,93121137,93121143,g,gtgtgtS,6
NC_037332.1,NC_032654.1,86939344,93184317,93184319,a,aat,2
NC_037332.1,NC_032654.1,86942436,93187412,93187414,a,agg,2
NC_037332.1,NC_032654.1,86966211,93235922,93235924,t,tgg,2
NC_037332.1,NC_032654.1,86973592,93243306,93243307,T,TY,1
NC_037332.1,NC_032654.1,86981635,93251278,93251279,A,AC,1
NC_037332.1,NC_032654.1,87006978,93277075,93277076,t,tc,1
NC_037332.1,NC_032654.1,87011285,93281375,93281376,g,ga,1
NC_037332.1,NC_032654.1,87046452,93316882,93316884,G,GAT,2
NC_037332.1,NC_032654.1,87047740,93318173,93318176,c,cTTA,3
NC_037332.1,NC_032654.1,87083821,93336882,93336884,C,CAT,2
NC_037332.1,NC_032654.1,87191916,93493399,93493409,c,cagagaagcct,10
NC_037332.1,NC_032654.1,87207136,93508622,93508623,c,ct,1
NC_037332.1,NC_032654.1,87207150,93508637,93508638,c,ct,1
NC_037332.1,NC_032654.1,87417019,93573298,93573300,C,CTG,2
NC_037332.1,NC_032654.1,87433662,93590082,93590083,t,ta,1
NC_037332.1,NC_032654.1,87434242,93590664,93590666,c,ctt,2
NC_037332.1,NC_032654.1,87436479,93592903,93592904,t,tW,1
NC_037332.1,NC_032654.1,87440196,93596620,93596621,T,TA,1
NC_037332.1,NC_032654.1,87454131,93610011,93610012,c,ct,1
NC_037332.1,NC_032654.1,87608808,93764710,93764711,A,AC,1
NC_037332.1,NC_032654.1,87764694,93919658,93919659,t,ta,1
NC_037332.1,NC_032654.1,87769535,93924494,93924495,T,TG,1
NC_037332.1,NC_032654.1,87831641,93986849,93986850,T,TY,1
NC_037332.1,NC_032654.1,87833376,93988585,93988586,C,CA,1
NC_037332.1,NC_032654.1,87837084,93991750,93991751,t,tY,1
NC_037332.1,NC_032654.1,87838857,93993517,93993518,A,AM,1
NC_037332.1,NC_032654.1,87914342,94069998,94069999,T,TG,1
NC_037332.1,NC_032654.1,87965777,94121437,94121443,a,aNNNNNN,6
NC_037332.1,NC_032654.1,88037095,94194948,94194949,c,ct,1
NC_037332.1,NC_032654.1,88037095,94219857,94219858,c,ct,1
NC_037332.1,NC_032654.1,88048243,94231010,94231011,a,ac,1
NC_037332.1,NC_032654.1,88195062,94383768,94383769,A,AW,1
NC_037332.1,NC_032654.1,88210289,94398603,94398605,T,TTG,2
NC_037332.1,NC_032654.1,88228101,94416428,94416429,t,tg,1
NC_037332.1,NC_032654.1,88242080,94430408,94430410,C,CTT,2
NC_037332.1,NC_032654.1,88271074,94460612,94460616,T,TANNN,4
NC_037332.1,NC_032654.1,88285203,94501853,94501854,c,ca,1
NC_037332.1,NC_032654.1,88310314,94527122,94527127,A,AGAAAT,5
NC_037332.1,NC_032654.1,88314360,94531166,94531170,g,ggttt,4
NC_037332.1,NC_032654.1,88337890,94554531,94554533,G,GTT,2
NC_037332.1,NC_032654.1,88358422,94574728,94574729,C,CG,1
NC_037332.1,NC_032654.1,88359180,94575486,94575488,a,aac,2
NC_037332.1,NC_032654.1,88485592,94701429,94701432,T,TGTA,3
NC_037332.1,NC_032654.1,88496691,94712539,94712540,c,ct,1
NC_037332.1,NC_032654.1,88515880,94731731,94731732,a,ac,1
NC_037332.1,NC_032654.1,88515906,94731758,94731762,a,aaatg,4
NC_037332.1,NC_032654.1,88526916,94742899,94742916,A,ATTGCAAAANNNNNNNNN,17
NC_037332.1,NC_032654.1,88534022,94750021,94750027,a,aaaagtg,6
NC_037332.1,NC_032654.1,88535670,94751672,94751674,a,act,2
NC_037332.1,NC_032654.1,88537589,94753607,94753610,t,tttc,3
NC_037332.1,NC_032654.1,88538607,94754628,94754631,T,TTAC,3
NC_037332.1,NC_032654.1,88539288,94755312,94755314,T,TTR,2
NC_037332.1,NC_032654.1,88539658,94755684,94755685,c,ca,1
NC_037332.1,NC_032654.1,88547618,94763841,94763844,a,attt,3
NC_037332.1,NC_032654.1,88564616,94780821,94780823,a,aat,2
NC_037332.1,NC_032654.1,88564629,94780836,94780837,g,gc,1
NC_037332.1,NC_032654.1,88565320,94781515,94781518,G,GGTA,3
NC_037332.1,NC_032654.1,88657171,94873378,94873380,T,TTG,2
NC_037332.1,NC_032654.1,88657800,94874010,94874011,T,TY,1
NC_037332.1,NC_032654.1,88665063,94881268,94881269,C,CT,1
NC_037332.1,NC_032654.1,88715360,94931582,94931583,c,ct,1
NC_037332.1,NC_032654.1,88749202,94965453,94965460,c,ctcctcct,7
NC_037332.1,NC_032654.1,88751064,94967545,94967546,T,TY,1
NC_037332.1,NC_032654.1,88763259,94981922,94981928,g,gtttttt,6
NC_037332.1,NC_032654.1,88769283,94987722,94987723,t,tg,1
NC_037332.1,NC_032654.1,88777848,94996293,94996294,G,GK,1
NC_037332.1,NC_032654.1,88780473,94998920,94998921,A,AW,1
NC_037332.1,NC_032654.1,88807443,95025894,95025939,a,acctaacCATTGNNNNNNNNNNNNNNNNNNNNNNNNNNNNNNNNNN,45
NC_037332.1,NC_032654.1,88866887,95085387,95085388,c,ct,1
NC_037332.1,NC_032654.1,88871386,95089887,95089888,t,ta,1
NC_037332.1,NC_032654.1,88872220,95090723,95090738,A,AGTAGCRCTTTGGATR,15
NC_037332.1,NC_032654.1,88913087,95192220,95192221,A,AR,1
NC_037332.1,NC_032654.1,88934675,95213738,95213739,t,ta,1
NC_037332.1,NC_032654.1,89007795,95249609,95249613,g,gtttt,4
NC_037332.1,NC_032654.1,89049079,95290900,95290901,T,TG,1
NC_037332.1,NC_032654.1,89052314,95294137,95294139,c,caa,2
NC_037332.1,NC_032654.1,89052458,95294283,95294284,a,ag,1
NC_037332.1,NC_032654.1,89083080,95324905,95324907,c,cat,2
NC_037332.1,NC_032654.1,89089515,95331344,95331348,T,TTAAG,4
NC_037332.1,NC_032654.1,89094268,95336108,95336109,A,AW,1
NC_037332.1,NC_032654.1,89148637,95390817,95390818,c,ca,1
NC_037332.1,NC_032654.1,89152536,95394714,95394715,C,CA,1
NC_037332.1,NC_032654.1,89152557,95394736,95394737,g,gt,1
NC_037332.1,NC_032654.1,89152564,95394744,95394745,c,ct,1
NC_037332.1,NC_032654.1,89173774,95415799,95415801,t,tca,2
NC_037332.1,NC_032654.1,89246339,95488377,95488378,c,ct,1
NC_037332.1,NC_032654.1,89276961,95518999,95519000,c,ca,1
NC_037332.1,NC_032654.1,89276997,95519036,95519037,T,TG,1
NC_037332.1,NC_032654.1,89429118,95670849,95670850,a,aW,1
NC_037332.1,NC_032654.1,89454356,95696089,95696090,C,CG,1
NC_037332.1,NC_032654.1,89485481,95727214,95727215,A,AW,1
NC_037332.1,NC_032654.1,89595521,95837255,95837256,A,AN,1
NC_037332.1,NC_032654.1,89639322,95934117,95934119,t,tNN,2
NC_037332.1,NC_032654.1,89726285,96021296,96021297,t,ta,1
NC_037332.1,NC_032654.1,89844435,96147687,96147688,a,ac,1
NC_037332.1,NC_032654.1,89844456,96147709,96147715,c,cgtgaag,6
NC_037332.1,NC_032654.1,89853593,96156847,96156848,C,CS,1
NC_037332.1,NC_032654.1,89863165,96166421,96166422,C,CS,1
NC_037332.1,NC_032654.1,89977889,96281177,96281178,C,CA,1
NC_037332.1,NC_032654.1,90017484,96320775,96320778,g,gaaa,3
NC_037332.1,NC_032654.1,90102664,96405951,96405953,g,gtt,2
NC_037332.1,NC_032654.1,90106232,96409521,96409522,c,cg,1
NC_037332.1,NC_032654.1,90250809,96727697,96727699,t,tNN,2
NC_037332.1,NC_032654.1,90402584,96879265,96879271,c,caaaaaa,6
NC_037332.1,NC_032654.1,90407593,96884273,96884280,A,AACTGGAG,7
NC_037332.1,NC_032654.1,90540390,97017166,97017167,c,ca,1
NC_037332.1,NC_032654.1,90550858,97027635,97027642,t,ttaaaaag,7
NC_037332.1,NC_032654.1,90623600,97100402,97100403,g,gt,1
NC_037332.1,NC_032654.1,90682828,97159615,97159616,C,CA,1
NC_037332.1,NC_032654.1,90698594,97175387,97175388,a,at,1
NC_037332.1,NC_032654.1,90698604,97175398,97175404,a,attttat,6
NC_037332.1,NC_032654.1,90709336,97186763,97186764,g,gc,1
NC_037332.1,NC_032654.1,90778430,97255979,97255980,g,ga,1
NC_037332.1,NC_032654.1,90808473,97285960,97285961,g,ga,1
NC_037332.1,NC_032654.1,90959165,97437028,97437029,G,GA,1
NC_037332.1,NC_032654.1,91012699,97491600,97491612,T,TGGGGACTGATCC,12
NC_037332.1,NC_032654.1,91029135,97508069,97508070,G,GC,1
NC_037332.1,NC_032654.1,91033324,97512279,97512280,t,tg,1
NC_037332.1,NC_032654.1,91064297,97543267,97543268,T,TA,1
NC_037332.1,NC_032654.1,91125721,97604692,97604693,g,ga,1
NC_037332.1,NC_032654.1,91181251,97660223,97660224,T,TA,1
NC_037332.1,NC_032654.1,91187316,97666289,97666291,a,aNN,2
NC_037332.1,NC_032654.1,91214626,97693601,97693603,t,tcc,2
NC_037332.1,NC_032654.1,91271417,97750546,97750547,C,CG,1
NC_037332.1,NC_032654.1,91306249,97785452,97785453,a,ac,1
NC_037332.1,NC_032654.1,91383355,97866986,97866988,t,tNN,2
NC_037332.1,NC_032654.1,91407680,97891313,97891314,A,AM,1
NC_037332.1,NC_032654.1,91419060,97902694,97902695,C,CS,1
NC_037332.1,NC_032654.1,91473771,97957408,97957409,C,CT,1
NC_037332.1,NC_032654.1,91482611,97966251,97966252,c,ca,1
NC_037332.1,NC_032654.1,91652664,98222321,98222322,g,gc,1
NC_037332.1,NC_032654.1,91748821,98318402,98318404,c,cat,2
NC_037332.1,NC_032654.1,91995672,98649609,98649610,c,ct,1
NC_037332.1,NC_032654.1,92328615,98974316,98974317,a,ac,1
NC_037332.1,NC_032654.1,92482852,99128994,99128995,a,ac,1
NC_037332.1,NC_032654.1,92505764,99151908,99151909,t,ta,1
NC_037332.1,NC_032654.1,92510880,99157025,99157028,g,ggaa,3
NC_037332.1,NC_032654.1,92518930,99165071,99165072,t,ta,1
NC_037332.1,NC_032654.1,92535001,99181143,99181144,A,AG,1
NC_037332.1,NC_032654.1,92644076,99290156,99290157,g,gR,1
NC_037332.1,NC_032654.1,92680187,99326241,99326242,t,tg,1
NC_037332.1,NC_032654.1,92702848,99348961,99348962,A,AT,1
NC_037332.1,NC_032654.1,92724123,99372330,99372337,t,tgtttttg,7
NC_037332.1,NC_032654.1,92809444,99464010,99464011,A,AC,1
NC_037332.1,NC_032654.1,92809450,99464017,99464018,G,GA,1
NC_037332.1,NC_032654.1,92809455,99464023,99464024,T,TA,1
NC_037332.1,NC_032654.1,92809464,99464033,99464034,G,GC,1
NC_037332.1,NC_032654.1,92867952,99522964,99522967,a,actt,3
NC_037332.1,NC_032654.1,92868131,99523146,99523158,g,ggtaccttcagaa,12
NC_037332.1,NC_032654.1,92868428,99523455,99523457,c,caa,2
NC_037332.1,NC_032654.1,93310995,99966275,99966276,g,ga,1
NC_037332.1,NC_032654.1,93533705,100190007,100190009,t,tca,2
NC_037332.1,NC_032654.1,93533756,100190060,100190063,t,tgaa,3
NC_037332.1,NC_032654.1,93706544,100372630,100372631,t,ta,1
NC_037332.1,NC_032654.1,93859205,100527269,100527270,t,tg,1
NC_037332.1,NC_032654.1,93859215,100527280,100527281,t,tg,1
NC_037332.1,NC_032654.1,93945172,100612967,100612968,A,AC,1
NC_037332.1,NC_032654.1,94107922,100776042,100776043,T,TG,1
NC_037332.1,NC_032654.1,94116157,100784267,100784268,t,ta,1
NC_037332.1,NC_032654.1,94116185,100784296,100784297,t,ta,1
NC_037332.1,NC_032654.1,94145207,100813322,100813337,G,GAGTGAGGGAGGTGGT,15
NC_037332.1,NC_032654.1,94193185,100861333,100861334,G,GT,1
NC_037332.1,NC_032654.1,94290181,100958353,100958354,G,GC,1
NC_037332.1,NC_032654.1,94306506,100974679,100974681,a,aNt,2
NC_037332.1,NC_032654.1,94347765,101016028,101016029,A,AY,1
NC_037332.1,NC_032654.1,94368488,101034688,101034708,c,cNNNNNNNNNNNNNNNNNNNN,20
NC_037332.1,NC_032654.1,94512343,101178579,101178580,A,AC,1
NC_037332.1,NC_032654.1,94541779,101208017,101208018,A,AC,1
NC_037332.1,NC_032654.1,94542510,101208749,101208750,g,ga,1
NC_037332.1,NC_032654.1,94661787,101373062,101373064,T,TTG,2
NC_037332.1,NC_032654.1,94668897,101380176,101380177,C,CY,1
NC_037332.1,NC_032654.1,94869693,101616646,101616647,A,AM,1
NC_037332.1,NC_032654.1,94880981,101627935,101627936,a,at,1
NC_037332.1,NC_032654.1,94928818,101675475,101675476,T,TY,1
NC_037332.1,NC_032654.1,95111307,101857031,101857032,T,TY,1
NC_037332.1,NC_032654.1,95247946,101993630,101993631,T,TC,1
NC_037332.1,NC_032654.1,95406598,102152333,102152335,a,atg,2
NC_037332.1,NC_032654.1,95479645,102225664,102225665,t,tW,1
NC_037332.1,NC_032654.1,95517217,102326423,102326425,c,cat,2
NC_037332.1,NC_032654.1,95592272,102411000,102411001,g,ga,1
NC_037332.1,NC_032654.1,95704150,102525773,102525774,g,ga,1
NC_037332.1,NC_032654.1,95842192,102644442,102644443,g,gt,1
NC_037332.1,NC_032654.1,95863305,102665556,102665557,t,tg,1
NC_037332.1,NC_032654.1,96035845,102837742,102837743,T,TC,1
NC_037332.1,NC_032654.1,96085586,102887484,102887485,a,at,1
NC_037332.1,NC_032654.1,96085658,102887558,102887559,g,ga,1
NC_037332.1,NC_032654.1,96085684,102887585,102887586,t,tg,1
NC_037332.1,NC_032654.1,96203771,103032704,103032706,T,TTA,2
NC_037332.1,NC_032654.1,96219051,103047987,103047992,C,CTTGCA,5
NC_037332.1,NC_032654.1,96219614,103048555,103048556,c,ca,1
NC_037332.1,NC_032654.1,96235069,103064015,103064016,a,at,1
NC_037332.1,NC_032654.1,96430896,103260497,103260498,t,tg,1
NC_037332.1,NC_032654.1,96430937,103260539,103260540,a,ag,1
NC_037332.1,NC_032654.1,96653726,103490428,103490429,A,AT,1
NC_037332.1,NC_032654.1,96726682,103564432,103564442,g,gattttttttt,10
NC_037332.1,NC_032654.1,96741301,103579092,103579093,c,ca,1
NC_037332.1,NC_032654.1,96787673,103625472,103625475,A,AAAG,3
NC_037332.1,NC_032654.1,96829048,103667151,103667167,a,aattccatcacttccac,16
NC_037332.1,NC_032654.1,96906337,103762464,103762465,A,AC,1
NC_037332.1,NC_032654.1,97069546,103928478,103928481,A,AAAT,3
NC_037332.1,NC_032654.1,97311419,104169397,104169398,A,AR,1
NC_037332.1,NC_032654.1,97505319,104400350,104400351,G,GA,1
NC_037332.1,NC_032654.1,97510069,104404895,104404896,t,ta,1
NC_037332.1,NC_032654.1,97510110,104404937,104404938,c,ct,1
NC_037332.1,NC_032654.1,97822343,104800033,104800041,G,GGCGCTCNN,8
NC_037332.1,NC_032654.1,98126817,105166243,105166244,T,TY,1
NC_037332.1,NC_032654.1,98584148,105685565,105685567,c,cta,2
NC_037332.1,NC_032654.1,98650682,105752168,105752169,t,tg,1
NC_037332.1,NC_032654.1,98933236,106085414,106085426,g,gacatggaacaac,12
NC_037332.1,NC_032654.1,98933241,106085431,106085432,t,tg,1
NC_037332.1,NC_032654.1,98971855,106123861,106123863,a,aNN,2
NC_037332.1,NC_032654.1,99015272,106167277,106167278,A,AC,1
NC_037332.1,NC_032654.1,99015806,106167810,106167811,t,tN,1
NC_037332.1,NC_032654.1,99016450,106168445,106168447,G,GGA,2
NC_037332.1,NC_032654.1,99016481,106168478,106168479,G,GA,1
NC_037332.1,NC_032654.1,99016509,106168507,106168508,g,ga,1
NC_037332.1,NC_032654.1,99016769,106168766,106168767,G,GA,1
NC_037332.1,NC_032654.1,99016824,106168822,106168823,G,GT,1
NC_037332.1,NC_032654.1,99017181,106169181,106169182,T,TG,1
NC_037332.1,NC_032654.1,99019544,106171544,106171545,g,ga,1
NC_037332.1,NC_032654.1,99019628,106171628,106171629,c,ct,1
NC_037332.1,NC_032654.1,99020222,106172224,106172226,A,AAG,2
NC_037332.1,NC_032654.1,99025437,106177443,106177444,t,ta,1
NC_037332.1,NC_032654.1,99044628,106196222,106196223,g,gt,1
NC_037332.1,NC_032654.1,99071722,106223307,106223308,T,TA,1
NC_037332.1,NC_032654.1,99084669,106236254,106236256,t,tta,2
NC_037332.1,NC_032654.1,99143689,106295275,106295276,T,TA,1
NC_037332.1,NC_032654.1,99154849,106307699,106307706,T,TAATTGAC,7
NC_037332.1,NC_032654.1,99159402,106312289,106312290,c,ct,1
NC_037332.1,NC_032654.1,99170097,106322977,106322982,A,AACTAG,5
NC_037332.1,NC_032654.1,99170374,106323259,106323260,A,AT,1
NC_037332.1,NC_032654.1,99170481,106323367,106323374,C,CGTACTTA,7
NC_037332.1,NC_032654.1,99257064,106454363,106454364,g,ga,1
NC_037332.1,NC_032654.1,99270466,106467766,106467767,A,AT,1
NC_037332.1,NC_032654.1,99277401,106453129,106453131,g,gta,2
NC_037332.1,NC_032654.1,99286007,106435248,106435249,a,ag,1
NC_037332.1,NC_032654.1,99286077,106435319,106435325,A,AAACAAc,6
NC_037332.1,NC_032654.1,99286828,106436075,106436076,t,tc,1
NC_037332.1,NC_032654.1,99287146,106436394,106436395,G,GA,1
NC_037332.1,NC_032654.1,99287268,106436517,106436518,t,tc,1
NC_037332.1,NC_032654.1,99287420,106436669,106436670,C,CA,1
NC_037332.1,NC_032654.1,99287719,106436969,106436970,T,TC,1
NC_037332.1,NC_032654.1,99287783,106437034,106437035,T,TA,1
NC_037332.1,NC_032654.1,99289846,106439099,106439100,T,TA,1
NC_037332.1,NC_032654.1,99289986,106439240,106439242,g,gaa,2
NC_037332.1,NC_032654.1,99291619,106440875,106440876,C,Ca,1
NC_037332.1,NC_032654.1,99291982,106441238,106441239,t,ta,1
NC_037332.1,NC_032654.1,99292337,106441594,106441595,A,AG,1
NC_037332.1,NC_032654.1,99292433,106441691,106441692,C,CA,1
NC_037332.1,NC_032654.1,99292513,106441772,106441773,T,TA,1
NC_037332.1,NC_032654.1,99292885,106442146,106442147,G,GA,1
NC_037332.1,NC_032654.1,99295262,106444524,106444525,a,ag,1
NC_037332.1,NC_032654.1,99297143,106446406,106446407,G,GC,1
NC_037332.1,NC_032654.1,99315593,106447172,106447178,A,ATCTATT,6
NC_037332.1,NC_032654.1,99315705,106447290,106447292,T,TTC,2
NC_037332.1,NC_032654.1,99318959,106450544,106450548,T,TCAAA,4
NC_037332.1,NC_032654.1,99318959,106425866,106425870,T,TCAAA,4
NC_037332.1,NC_032654.1,99320824,106427737,106427738,c,ct,1
NC_037332.1,NC_032654.1,99330604,106437520,106437521,G,GT,1
NC_037332.1,NC_032654.1,99438094,106554571,106554578,t,tagTNNNN,7
NC_037332.1,NC_032654.1,99801271,107077665,107077666,g,gc,1
NC_037332.1,NC_032654.1,100037700,107249619,107249621,G,GAA,2
NC_037332.1,NC_032654.1,100037745,107249666,107249667,G,GC,1
NC_037332.1,NC_032654.1,100046753,107266306,107266307,t,tc,1
NC_037332.1,NC_032654.1,100079734,107298081,107298082,T,TA,1
NC_037332.1,NC_032654.1,100093080,107311417,107311426,A,AAGNNNNNNN,9
NC_037332.1,NC_032654.1,100165719,107384432,107384433,A,AC,1
NC_037332.1,NC_032654.1,100183778,107402494,107402506,a,atatatgtacatg,12
NC_037332.1,NC_032654.1,100183784,107402512,107402516,a,atatg,4
NC_037332.1,NC_032654.1,100187851,107467901,107467902,a,ac,1
NC_037332.1,NC_032654.1,100240382,107520711,107520712,t,ta,1
NC_037332.1,NC_032654.1,100304176,107584508,107584509,A,AC,1
NC_037332.1,NC_032654.1,100913229,108106863,108106864,A,AM,1
NC_037332.1,NC_032654.1,101071953,108264661,108264662,c,ca,1
NC_037332.1,NC_032654.1,101087152,108279862,108279863,T,TK,1
NC_037332.1,NC_032654.1,101108710,108301421,108301422,c,ca,1
NC_037332.1,NC_032654.1,101223720,108428523,108428524,t,ta,1
NC_037332.1,NC_032654.1,101366164,108574425,108574427,C,CTG,2
NC_037332.1,NC_032654.1,101431318,108640083,108640085,g,gaa,2
NC_037332.1,NC_032654.1,101866620,109049293,109049294,G,GC,1
NC_037332.1,NC_032654.1,101943900,109157414,109157417,C,CATT,3
NC_037332.1,NC_032654.1,101960449,109173964,109173965,T,TC,1
NC_037332.1,NC_032654.1,101971228,109184744,109184745,A,AG,1
NC_037332.1,NC_032654.1,101971716,109185226,109185227,T,TA,1
NC_037332.1,NC_032654.1,101971745,109185256,109185257,T,TA,1
NC_037332.1,NC_032654.1,101971916,109185426,109185427,A,AT,1
NC_037332.1,NC_032654.1,101976573,109197732,109197733,g,ga,1
NC_037332.1,NC_032654.1,101977163,109198317,109198320,G,GAGA,3
NC_037332.1,NC_032654.1,101982181,109203338,109203339,g,ga,1
NC_037332.1,NC_032654.1,101986039,109207197,109207198,c,ct,1
NC_037332.1,NC_032654.1,101993151,109214311,109214312,g,gt,1
NC_037332.1,NC_032654.1,101993175,109214336,109214339,c,catt,3
NC_037332.1,NC_032654.1,102006844,109228008,109228009,C,CA,1
NC_037332.1,NC_032654.1,102007202,109228367,109228369,T,TTA,2
NC_037332.1,NC_032654.1,102046187,109268580,109268581,c,ct,1
NC_037332.1,NC_032654.1,102053927,109276615,109276616,A,AG,1
NC_037332.1,NC_032654.1,102054286,109276975,109276977,A,AAG,2
NC_037332.1,NC_032654.1,102054467,109277158,109277164,c,catTGTT,6
NC_037332.1,NC_032654.1,102054639,109277336,109277337,G,GT,1
NC_037332.1,NC_032654.1,102074218,109296911,109296912,A,AT,1
NC_037332.1,NC_032654.1,102074298,109296992,109296993,T,TA,1
NC_037332.1,NC_032654.1,102074341,109297036,109297037,G,GC,1
NC_037332.1,NC_032654.1,102074718,109297411,109297412,g,gc,1
NC_037332.1,NC_032654.1,102109561,109325452,109325454,g,gtt,2
NC_037332.1,NC_032654.1,102121478,109337370,109337371,T,TC,1
NC_037332.1,NC_032654.1,102122260,109338151,109338161,C,CCAATGTCAGT,10
NC_037332.1,NC_032654.1,102122260,109397758,109397768,C,CCAATGTCAGT,10
NC_037332.1,NC_032654.1,102122329,109338230,109338231,A,AT,1
NC_037332.1,NC_032654.1,102122329,109397837,109397838,A,AT,1
NC_037332.1,NC_032654.1,102122465,109338367,109338374,T,TGATAGAG,7
NC_037332.1,NC_032654.1,102122465,109397974,109397981,T,TGATAGAG,7
NC_037332.1,NC_032654.1,102125505,109341414,109341419,T,TGGAAG,5
NC_037332.1,NC_032654.1,102125821,109341735,109341742,g,gagtgggt,7
NC_037332.1,NC_032654.1,102125999,109341920,109341921,T,TA,1
NC_037332.1,NC_032654.1,102127979,109403496,109403497,a,ac,1
NC_037332.1,NC_032654.1,102137593,109413112,109413113,A,AN,1
NC_037332.1,NC_032654.1,102160289,109435806,109435808,t,ttg,2
NC_037332.1,NC_032654.1,102160363,109435882,109435883,G,GN,1
NC_037332.1,NC_032654.1,102161457,109436979,109436988,G,GACACAAAAA,9
NC_037332.1,NC_032654.1,102179548,109455064,109455065,A,AG,1
NC_037332.1,NC_032654.1,102179650,109455167,109455187,C,CTCTATACTCAAGTTTGAGTG,20
NC_037332.1,NC_032654.1,102180389,109455926,109455927,C,CT,1
NC_037332.1,NC_032654.1,102180627,109456165,109456166,T,TG,1
NC_037332.1,NC_032654.1,102216656,110034959,110034960,t,tg,1
NC_037332.1,NC_032654.1,102242187,110060727,110060728,a,at,1
NC_037332.1,NC_032654.1,102242822,110061363,110061364,g,gc,1
NC_037332.1,NC_032654.1,102351080,110171180,110171181,g,ga,1
NC_037332.1,NC_032654.1,102400699,110401605,110401606,g,ga,1
NC_037332.1,NC_032654.1,102435512,110252735,110252736,t,tg,1
NC_037332.1,NC_032654.1,102521606,110387674,110387675,t,ta,1
NC_037332.1,NC_032654.1,102533998,110400066,110400068,g,gtt,2
NC_037332.1,NC_032654.1,102534928,110400997,110400998,g,gt,1
NC_037332.1,NC_032654.1,102535231,110401301,110401302,a,at,1
NC_037332.1,NC_032654.1,102535231,109942722,109942723,a,at,1
NC_037332.1,NC_032654.1,102642341,109843733,109843734,c,ca,1
NC_037332.1,NC_032654.1,102651470,109834590,109834592,T,TTC,2
NC_037332.1,NC_032654.1,102657028,109829029,109829031,t,tta,2
NC_037332.1,NC_032654.1,102657043,109829010,109829014,g,gaaat,4
NC_037332.1,NC_032654.1,102659079,109826998,109827000,T,TTA,2
NC_037332.1,NC_032654.1,102660743,109825319,109825325,c,ccaaaag,6
NC_037332.1,NC_032654.1,102662892,109823168,109823171,A,AGAG,3
NC_037332.1,NC_032654.1,102662973,109823086,109823087,C,CA,1
NC_037332.1,NC_032654.1,102669488,109816573,109816574,A,AG,1
NC_037332.1,NC_032654.1,102681709,109804207,109804208,a,ag,1
NC_037332.1,NC_032654.1,102719582,109766451,109766452,t,tg,1
NC_037332.1,NC_032654.1,102733587,109752464,109752465,g,ga,1
NC_037332.1,NC_032654.1,102767739,109716235,109716238,t,tttg,3
NC_037332.1,NC_032654.1,102772372,109711586,109711601,G,GGCACACATGGGGTCT,15
NC_037332.1,NC_032654.1,102773113,109710842,109710846,A,ATCTC,4
NC_037332.1,NC_032654.1,103922135,110506151,110506152,G,GS,1
NC_037332.1,NC_032654.1,103939353,110523372,110523373,T,TG,1
NC_037332.1,NC_032654.1,104040409,110623898,110623915,G,GCCTCACGCCTTCCTTCS,17
NC_037332.1,NC_032654.1,104044457,110627964,110627965,A,AG,1
NC_037332.1,NC_032654.1,104049078,110707850,110707852,G,GGC,2
NC_037332.1,NC_032654.1,104049097,110707871,110707872,G,GT,1
NC_037332.1,NC_032654.1,104049114,110707889,110707890,T,TG,1
NC_037332.1,NC_032654.1,104049345,110708120,110708141,C,CGGGGCCTCACTAGTACTGGCG,21
NC_037332.1,NC_032654.1,104049360,110708156,110708157,C,CA,1
NC_037332.1,NC_032654.1,104051208,110710005,110710006,A,AG,1
NC_037332.1,NC_032654.1,104058396,110717183,110717184,t,ta,1
NC_037332.1,NC_032654.1,104060468,110719255,110719256,t,tc,1
NC_037332.1,NC_032654.1,104067401,110726188,110726189,G,GC,1
NC_037332.1,NC_032654.1,104178738,110838639,110838640,C,CA,1
NC_037332.1,NC_032654.1,104199904,110859813,110859814,g,gt,1
NC_037332.1,NC_032654.1,104366949,111025951,111025952,A,AT,1
NC_037332.1,NC_032654.1,104383895,111042895,111042896,T,TW,1
NC_037332.1,NC_032654.1,104384053,111043056,111043057,A,AC,1
NC_037332.1,NC_032654.1,104412717,111071657,111071658,t,tc,1
NC_037332.1,NC_032654.1,104427661,111086606,111086607,T,TA,1
NC_037332.1,NC_032654.1,104434620,111093571,111093572,a,at,1
NC_037332.1,NC_032654.1,104461331,111120261,111120262,T,TA,1
NC_037332.1,NC_032654.1,104476612,111134970,111134972,g,gga,2
NC_037332.1,NC_032654.1,104510786,111169391,111169400,a,aaataactgt,9
NC_037332.1,NC_032654.1,104514447,111173061,111173062,t,tK,1
NC_037332.1,NC_032654.1,104516308,111174918,111174924,T,TTCTCCA,6
NC_037332.1,NC_032654.1,104518020,111176635,111176640,C,CAGTGG,5
NC_037332.1,NC_032654.1,104518028,111176648,111176649,A,AG,1
NC_037332.1,NC_032654.1,104518033,111176654,111176658,A,AAGGG,4
NC_037332.1,NC_032654.1,104611258,111269888,111269889,A,AG,1
NC_037332.1,NC_032654.1,104706386,111365483,111365484,A,AG,1
NC_037332.1,NC_032654.1,104707075,111366173,111366175,t,tca,2
NC_037332.1,NC_032654.1,104808735,111467841,111467842,A,AR,1
NC_037332.1,NC_032654.1,104838157,111497034,111497035,c,ct,1
NC_037332.1,NC_032654.1,104893590,111553146,111553147,c,ct,1
NC_037332.1,NC_032654.1,104904852,111563183,111563186,t,tttg,3
NC_037332.1,NC_032654.1,104909583,111571474,111571475,c,ca,1
NC_037332.1,NC_032654.1,104942293,111604185,111604186,C,CY,1
NC_037332.1,NC_032654.1,105017025,111680064,111680065,a,at,1
NC_037332.1,NC_032654.1,105018348,111681410,111681412,t,tNN,2
NC_037332.1,NC_032654.1,105039395,111702460,111702464,G,GTATT,4
NC_037332.1,NC_032654.1,105044088,111707165,111707166,A,AG,1
NC_037332.1,NC_032654.1,105047349,111710427,111710430,c,caaa,3
NC_037332.1,NC_032654.1,105049432,111712513,111712514,A,AT,1
NC_037332.1,NC_032654.1,105073276,111736399,111736400,T,TG,1
NC_037332.1,NC_032654.1,105085172,111748313,111748314,A,AR,1
NC_037332.1,NC_032654.1,105102172,111765326,111765327,G,GR,1
NC_037332.1,NC_032654.1,105106074,111769228,111769229,t,tc,1
NC_037332.1,NC_032654.1,105148703,111811939,111811941,C,CCT,2
NC_037332.1,NC_032654.1,105149226,111812464,111812465,c,ct,1
NC_037332.1,NC_032654.1,105160075,111823330,111823337,t,tattttcc,7
NC_037332.1,NC_032654.1,105160630,111823892,111823894,a,att,2
NC_037332.1,NC_032654.1,105163944,111827206,111827207,c,ct,1
NC_037332.1,NC_032654.1,105164877,111828141,111828142,c,ct,1
NC_037332.1,NC_032654.1,105172508,111835776,111835777,a,at,1
NC_037332.1,NC_032654.1,105178162,111841433,111841434,T,TY,1
NC_037332.1,NC_032654.1,105179195,111842466,111842467,C,CA,1
NC_037332.1,NC_032654.1,105250679,111913664,111913665,g,gc,1
NC_037332.1,NC_032654.1,105306135,111969204,111969205,a,at,1
NC_037332.1,NC_032654.1,105306674,111969744,111969761,g,gactttatttttatgggc,17
NC_037332.1,NC_032654.1,105341603,112004488,112004489,c,cg,1
NC_037332.1,NC_032654.1,105345054,112007941,112007942,c,ct,1
NC_037332.1,NC_032654.1,105439952,112102565,112102566,a,at,1
NC_037332.1,NC_032654.1,105479114,112140697,112140703,A,ATAAACT,6
NC_037332.1,NC_032654.1,105645117,112306537,112306538,g,ga,1
NC_037332.1,NC_032654.1,105663852,112325273,112325274,C,CM,1
NC_037332.1,NC_032654.1,105772633,112434065,112434066,T,TC,1
NC_037332.1,NC_032654.1,105786354,112447784,112447785,t,tg,1
NC_037332.1,NC_032654.1,105839566,112501169,112501171,A,AAG,2
NC_037332.1,NC_032654.1,105839583,112501188,112501189,T,TG,1
NC_037332.1,NC_032654.1,105859773,112521380,112521381,a,ac,1
NC_037332.1,NC_032654.1,105872378,112533986,112533987,C,CM,1
NC_037332.1,NC_032654.1,105876926,112538535,112538536,g,ga,1
NC_037332.1,NC_032654.1,105904016,112565564,112565565,t,tg,1
NC_037332.1,NC_032654.1,105904665,112566214,112566215,g,gt,1
NC_037332.1,NC_032654.1,106049253,112710364,112710365,G,GA,1
NC_037332.1,NC_032654.1,106151387,112821529,112821530,G,GR,1
NC_037332.1,NC_032654.1,106177887,112848028,112848034,T,TTGACTC,6
NC_037332.1,NC_032654.1,106183266,112853417,112853419,g,gca,2
NC_037332.1,NC_032654.1,106183945,112854098,112854099,T,TG,1
NC_037332.1,NC_032654.1,106197138,112867306,112867307,A,AC,1
NC_037332.1,NC_032654.1,106197207,112867373,112867374,A,AK,1
NC_037332.1,NC_032654.1,106219144,112889429,112889430,c,ct,1
NC_037332.1,NC_032654.1,106260601,112933464,112933467,A,ACTT,3
NC_037332.1,NC_032654.1,106357617,113029770,113029772,G,GTT,2
NC_037332.1,NC_032654.1,106557228,113223180,113223181,T,TA,1
NC_037332.1,NC_032654.1,106579237,113245192,113245203,A,ACCTCTCTGCCC,11
NC_037332.1,NC_032654.1,106670456,113336461,113336468,a,agtcatTG,7
NC_037332.1,NC_032654.1,106808018,113473585,113473586,C,CA,1
NC_037332.1,NC_032654.1,106861773,113526163,113526164,t,ta,1
NC_037332.1,NC_032654.1,106886529,113550920,113550921,C,CA,1
NC_037332.1,NC_032654.1,107431117,114132506,114132507,T,TA,1
NC_037332.1,NC_032654.1,107534633,114236025,114236026,t,ta,1
NC_037332.1,NC_032654.1,107541517,114242911,114242912,c,cg,1
NC_037332.1,NC_032654.1,107771033,114476134,114476135,c,ct,1
NC_037332.1,NC_032654.1,107771332,114476434,114476435,g,gt,1
NC_037332.1,NC_032654.1,107824975,114530434,114530436,A,ACC,2
NC_037332.1,NC_032654.1,108016544,114721559,114721579,g,gcaNNNNNNNNNNNNNNNNNN,20
NC_037332.1,NC_032654.1,108045670,114750661,114750662,T,TK,1
NC_037332.1,NC_032654.1,108168232,114872728,114872729,g,gt,1
NC_037332.1,NC_032654.1,108193728,114898078,114898080,t,tNN,2
NC_037332.1,NC_032654.1,108420187,115122556,115122557,a,at,1
NC_037332.1,NC_032654.1,108488591,115263440,115263441,c,ca,1
NC_037332.1,NC_032654.1,108488594,115263444,115263445,a,ac,1
NC_037332.1,NC_032654.1,108488762,115263613,115263614,a,aT,1
NC_037332.1,NC_032654.1,108682732,115472961,115472962,T,TG,1
NC_037332.1,NC_032654.1,108726277,115516508,115516514,C,CCCAAGT,6
NC_037332.1,NC_032654.1,108769749,115559983,115560001,G,Gctgattaaaaatacaaaa,18
NC_037332.1,NC_032654.1,108787446,115577883,115577884,T,TN,1
NC_037332.1,NC_032654.1,108809188,115599515,115599520,c,ctcttt,5
NC_037332.1,NC_032654.1,108818764,115609096,115609097,C,CY,1
NC_037332.1,NC_032654.1,109171941,115986618,115986619,C,CT,1
NC_037332.1,NC_032654.1,109208112,116022789,116022790,C,CG,1
NC_037332.1,NC_032654.1,109459782,116274479,116274480,C,CG,1
NC_037332.1,NC_032654.1,109459801,116274499,116274500,C,CS,1
NC_037332.1,NC_032654.1,109738778,116602394,116602395,G,GS,1
NC_037332.1,NC_032654.1,109794701,116658524,116658530,a,atttttt,6
NC_037332.1,NC_032654.1,109802774,116666604,116666611,A,ACTTTAAG,7
NC_037332.1,NC_032654.1,109827186,116691048,116691049,G,GS,1
NC_037332.1,NC_032654.1,109973501,116838334,116838335,C,CS,1
NC_037332.1,NC_032654.1,110058635,116925288,116925289,A,AC,1
NC_037332.1,NC_032654.1,110072269,116939061,116939063,A,AAN,2
NC_037332.1,NC_032654.1,110110554,116977355,116977356,G,GS,1
NC_037332.1,NC_032654.1,110171090,117041566,117041567,T,TG,1
NC_037332.1,NC_032654.1,110171101,117041578,117041579,G,GA,1
NC_037332.1,NC_032654.1,110256983,117127613,117127614,T,Tg,1
NC_037332.1,NC_032654.1,110263950,117134581,117134591,g,gactgaactga,10
NC_037332.1,NC_032654.1,110354893,117225541,117225543,C,CCT,2
NC_037332.1,NC_032654.1,110464715,117334160,117334161,c,ca,1
NC_037332.1,NC_032654.1,110555050,117434312,117434313,a,ac,1
NC_037332.1,NC_032654.1,110694114,117644624,117644625,G,GT,1
NC_037332.1,NC_032654.1,110733165,117682603,117682604,A,AC,1
NC_037332.1,NC_032654.1,110763825,117713264,117713265,t,ta,1
NC_037332.1,NC_032654.1,110845771,117813802,117813803,T,TG,1
NC_037332.1,NC_032654.1,110852539,117820571,117820572,a,ac,1
NC_037332.1,NC_032654.1,111030154,117975768,117975769,G,GS,1
NC_037332.1,NC_032654.1,111049128,117994370,117994371,C,CY,1
NC_037332.1,NC_032654.1,111080237,118025481,118025482,T,TK,1
NC_037332.1,NC_032654.1,111223298,118168191,118168192,a,aN,1
NC_037332.1,NC_032654.1,111223668,118168562,118168564,c,caa,2
NC_037332.1,NC_032654.1,111223892,118168786,118168787,c,ct,1
NC_037332.1,NC_032654.1,111331378,118275617,118275618,A,AM,1
NC_037332.1,NC_032654.1,111391487,118336947,118336948,A,AM,1
NC_037332.1,NC_032654.1,111445297,118391125,118391128,C,CATG,3
NC_037332.1,NC_032654.1,111489111,118434935,118434936,c,ca,1
NC_037332.1,NC_032654.1,111690625,118636757,118636759,a,aag,2
NC_037332.1,NC_032654.1,111787800,118734049,118734053,t,ttaaa,4
NC_037332.1,NC_032654.1,111787821,118734074,118734083,c,caaaaaacag,9
NC_037332.1,NC_032654.1,111926680,118875384,118875385,a,at,1
NC_037332.1,NC_032654.1,112143801,119093033,119093034,a,ag,1
NC_037332.1,NC_032654.1,112144426,119093657,119093663,g,gttatga,6
NC_037332.1,NC_032654.1,112197592,119146899,119146900,a,ac,1
NC_037332.1,NC_032654.1,112336667,119286686,119286687,G,GC,1
NC_037332.1,NC_032654.1,112337109,119287129,119287131,A,ACT,2
NC_037332.1,NC_032654.1,112412367,119362386,119362387,G,GS,1
NC_037332.1,NC_032654.1,112435588,119385610,119385611,C,CA,1
NC_037332.1,NC_032654.1,112454048,119404191,119404192,A,AG,1
NC_037332.1,NC_032654.1,112518872,119469022,119469024,A,ATT,2
NC_037332.1,NC_032654.1,112690862,119639239,119639240,G,GA,1
NC_037332.1,NC_032654.1,112690868,119639246,119639247,G,GA,1
NC_037332.1,NC_032654.1,112904170,119851335,119851336,T,TY,1
NC_037332.1,NC_032654.1,112959337,119911945,119911946,T,TG,1
NC_037332.1,NC_032654.1,112964010,119917194,119917195,t,tY,1
NC_037332.1,NC_032654.1,113194087,120146559,120146560,C,CA,1
NC_037332.1,NC_032654.1,113200336,120152716,120152717,G,GA,1
NC_037332.1,NC_032654.1,113257489,120210488,120210491,A,AAGG,3
NC_037332.1,NC_032654.1,113266882,120219884,120219885,A,AC,1
NC_037332.1,NC_032654.1,113313785,120267057,120267058,T,TC,1
NC_037332.1,NC_032654.1,113343467,120296694,120296695,A,AG,1
NC_037332.1,NC_032654.1,113390489,120344660,120344661,G,GA,1
NC_037332.1,NC_032654.1,113397574,120351746,120351747,a,at,1
NC_037332.1,NC_032654.1,113522056,120484177,120484178,c,cS,1
NC_037332.1,NC_032654.1,113536926,120499459,120499460,T,TG,1
NC_037332.1,NC_032654.1,113608038,120571400,120571401,c,ct,1
NC_037332.1,NC_032654.1,113766471,120738594,120738595,a,ac,1
NC_037332.1,NC_032654.1,113797868,120769992,120769993,C,CA,1
NC_037332.1,NC_032654.1,113955007,120925519,120925521,T,TNN,2
NC_037332.1,NC_032654.1,113965940,120936456,120936457,A,AC,1
NC_037332.1,NC_032654.1,114036305,121007104,121007105,G,GS,1
NC_037332.1,NC_032654.1,114101868,121131120,121131121,C,CM,1
NC_037332.1,NC_032654.1,114154135,121184416,121184417,C,CA,1
NC_037332.1,NC_032654.1,114797535,121292276,121292277,T,TY,1
NC_037332.1,NC_032654.1,114851022,121347578,121347579,C,CA,1
NC_037332.1,NC_032654.1,115233667,121832276,121832277,t,tg,1
NC_037332.1,NC_032654.1,115325771,121923496,121923497,C,CG,1
NC_037332.1,NC_032654.1,115325950,121923676,121923677,G,GA,1
NC_037332.1,NC_032654.1,115393175,121990468,121990469,T,TG,1
NC_037332.1,NC_032654.1,115393466,121990759,121990760,G,GC,1
NC_037332.1,NC_032654.1,115487998,122085307,122085309,C,CCA,2
NC_037332.1,NC_032654.1,115490894,122088213,122088214,A,AG,1
NC_037332.1,NC_032654.1,115586209,122178031,122178045,C,CACTGGCCACCAAGA,14
NC_037332.1,NC_032654.1,115626078,122217926,122217927,g,gt,1
NC_037332.1,NC_032654.1,115711057,122315382,122315383,T,TG,1
NC_037332.1,NC_032654.1,115749409,122353731,122353734,c,catg,3
NC_037332.1,NC_032654.1,115749420,122353745,122353749,t,tttga,4
NC_037332.1,NC_032654.1,115884899,122497860,122497861,T,TC,1
NC_037332.1,NC_032654.1,115909931,122523259,122523260,T,TC,1
NC_037332.1,NC_032654.1,116024721,122638039,122638040,c,ct,1
NC_037332.1,NC_032654.1,116322878,123004577,123004579,T,TNN,2
NC_037332.1,NC_032654.1,116322988,123004689,123004690,A,AG,1
NC_037332.1,NC_032654.1,116323011,123004713,123004714,t,tg,1
NC_037332.1,NC_032654.1,116323624,123005327,123005328,T,TC,1
NC_037332.1,NC_032654.1,116363037,123057474,123057475,G,GA,1
NC_037332.1,NC_032654.1,116369326,123063765,123063766,A,AT,1
NC_037332.1,NC_032654.1,116392844,123086622,123086623,C,CG,1
NC_037332.1,NC_032654.1,116424651,123118431,123118432,T,TA,1
NC_037332.1,NC_032654.1,116486469,123179355,123179356,t,tY,1
NC_037332.1,NC_032654.1,116542489,123239845,123239846,A,AC,1
NC_037332.1,NC_032654.1,116542489,123268144,123268145,A,AC,1
NC_037332.1,NC_032654.1,116549084,123246441,123246442,T,TC,1
NC_037332.1,NC_032654.1,116621658,123326952,123326953,G,GA,1
NC_037332.1,NC_032654.1,116643675,123348963,123348964,A,AM,1
NC_037332.1,NC_032654.1,116661446,123366736,123366761,G,GTGCCGTCACTCNNNNNNNNNNNNNN,25
NC_037332.1,NC_032654.1,116732717,123438465,123438467,a,aNN,2
NC_037332.1,NC_032654.1,116886588,123613649,123613650,G,GA,1
NC_037332.1,NC_032654.1,116901818,123628902,123628903,T,TK,1
NC_037332.1,NC_032654.1,116901839,123628924,123628925,A,AM,1
NC_037332.1,NC_032654.1,116903355,123630442,123630459,G,GNNNNNNNNNNNNNNNNN,17
NC_037332.1,NC_032654.1,116987430,123708477,123708478,T,TG,1
NC_037332.1,NC_032654.1,117007835,123728875,123728876,C,CA,1
NC_037332.1,NC_032654.1,117037249,123758307,123758313,A,AAGGCAG,6
NC_037332.1,NC_032654.1,117043357,123764421,123764426,G,GCCCCC,5
NC_037332.1,NC_032654.1,117097932,123819036,123819037,G,GC,1
NC_037332.1,NC_032654.1,117099447,123820552,123820556,t,tgtgY,4
NC_037332.1,NC_032654.1,117099990,123821099,123821100,G,GS,1
NC_037332.1,NC_032654.1,117235080,123958515,123958516,t,tg,1
NC_037332.1,NC_032654.1,117254519,123978452,123978453,C,CG,1
NC_037332.1,NC_032654.1,117298048,124231038,124231040,c,cct,2
NC_037332.1,NC_032654.1,117385134,124157849,124157850,T,TA,1
NC_037332.1,NC_032654.1,117426880,124200529,124200530,C,CT,1
NC_037332.1,NC_032654.1,117750334,124731933,124731934,A,AM,1
NC_037332.1,NC_032654.1,117806959,124789012,124789013,g,gt,1
NC_037332.1,NC_032654.1,117826306,124808360,124808361,g,gt,1
NC_037332.1,NC_032654.1,117843325,124824185,124824186,T,TA,1
NC_037332.1,NC_032654.1,117951139,124932719,124932720,a,at,1
NC_037332.1,NC_032654.1,117974993,124956625,124956626,G,GR,1
NC_037332.1,NC_032654.1,118089560,125074490,125074491,t,tc,1
NC_037332.1,NC_032654.1,118162303,125169360,125169361,A,AM,1
NC_037332.1,NC_032654.1,118306692,125289156,125289157,G,GT,1
NC_037332.1,NC_032654.1,118306695,125289160,125289162,A,AGT,2
NC_037332.1,NC_032654.1,118347833,125329452,125329456,G,GNNNN,4
NC_037332.1,NC_032654.1,118358250,125339873,125339875,A,ATT,2
NC_037332.1,NC_032654.1,118373182,125354806,125354807,G,GA,1
NC_037332.1,NC_032654.1,118391548,125372926,125372927,t,ta,1
NC_037332.1,NC_032654.1,118398046,125379424,125379438,G,GNNNNNNNNNNNNNN,14
NC_037332.1,NC_032654.1,118575495,125556263,125556264,T,TA,1
