Reference ID,Query ID,Reference POS,Query POS,Query END,REF,ALT,SVLEN
NC_037347.1,NC_032669.1,217253,2967543,2967557,g,gcgggctatagtcca,14
NC_037347.1,NC_032669.1,220621,2964045,2964050,T,TGCAGC,5
NC_037347.1,NC_032669.1,222192,2962470,2962471,g,gt,1
NC_037347.1,NC_032669.1,224347,2960320,2960322,A,ATG,2
NC_037347.1,NC_032669.1,224824,2959841,2959844,C,CAGA,3
NC_037347.1,NC_032669.1,3024051,3043849,3043850,t,tg,1
NC_037347.1,NC_032669.1,3126323,3147584,3147585,c,ct,1
NC_037347.1,NC_032669.1,3183837,3205621,3205622,t,ta,1
NC_037347.1,NC_032669.1,3208084,3229866,3229867,A,AG,1
NC_037347.1,NC_032669.1,3254295,3276210,3276211,T,TA,1
NC_037347.1,NC_032669.1,3627298,3653083,3653084,A,AT,1
NC_037347.1,NC_032669.1,3691526,3717185,3717186,T,TG,1
NC_037347.1,NC_032669.1,3691585,3717245,3717246,A,AG,1
NC_037347.1,NC_032669.1,4009073,4035794,4035796,a,act,2
NC_037347.1,NC_032669.1,4022189,4048912,4048913,G,GK,1
NC_037347.1,NC_032669.1,4149904,4174527,4174528,a,at,1
NC_037347.1,NC_032669.1,4204973,4239090,4239091,G,GS,1
NC_037347.1,NC_032669.1,4213914,4248032,4248033,C,CA,1
NC_037347.1,NC_032669.1,4321472,4356642,4356643,G,GA,1
NC_037347.1,NC_032669.1,4321490,4356660,4356661,C,CT,1
NC_037347.1,NC_032669.1,4383487,4418668,4418669,g,ga,1
NC_037347.1,NC_032669.1,4407951,4443134,4443135,C,CN,1
NC_037347.1,NC_032669.1,4526680,4561991,4561992,c,ct,1
NC_037347.1,NC_032669.1,4565996,4601232,4601233,C,CS,1
NC_037347.1,NC_032669.1,4595825,4631072,4631073,G,GS,1
NC_037347.1,NC_032669.1,4598057,4633305,4633306,T,TC,1
NC_037347.1,NC_032669.1,4644519,4679779,4679780,g,gt,1
NC_037347.1,NC_032669.1,4652637,4687901,4687903,C,CCA,2
NC_037347.1,NC_032669.1,4675166,4710435,4710436,g,gt,1
NC_037347.1,NC_032669.1,4786528,4821513,4821518,A,AAGTNN,5
NC_037347.1,NC_032669.1,4875158,4910114,4910115,a,ag,1
NC_037347.1,NC_032669.1,4934624,4969588,4969589,C,CA,1
NC_037347.1,NC_032669.1,4942958,4977841,4977847,t,tagcagc,6
NC_037347.1,NC_032669.1,4961031,4995922,4995924,t,tNN,2
NC_037347.1,NC_032669.1,5028605,5063522,5063523,t,tc,1
NC_037347.1,NC_032669.1,5095884,5131118,5131120,g,ggc,2
NC_037347.1,NC_032669.1,5096014,5131247,5131249,c,ctg,2
NC_037347.1,NC_032669.1,5096428,5131663,5131664,t,tg,1
NC_037347.1,NC_032669.1,5164333,5199595,5199596,a,ac,1
NC_037347.1,NC_032669.1,5243165,5285906,5285907,c,ct,1
NC_037347.1,NC_032669.1,5381795,5423897,5423898,T,TA,1
NC_037347.1,NC_032669.1,5503958,5579160,5579163,C,CTTA,3
NC_037347.1,NC_032669.1,5539724,5615746,5615749,C,CATT,3
NC_037347.1,NC_032669.1,5591086,5666900,5666902,c,caa,2
NC_037347.1,NC_032669.1,5591092,5666908,5666910,t,tca,2
NC_037347.1,NC_032669.1,5662445,5737689,5737690,A,AW,1
NC_037347.1,NC_032669.1,5719209,5797419,5797420,A,AG,1
NC_037347.1,NC_032669.1,5733299,5811338,5811339,g,gc,1
NC_037347.1,NC_032669.1,5739296,5817337,5817338,t,tc,1
NC_037347.1,NC_032669.1,5767872,5845912,5845913,C,CY,1
NC_037347.1,NC_032669.1,5791399,5869406,5869407,T,TG,1
NC_037347.1,NC_032669.1,5837891,5915747,5915748,t,tc,1
NC_037347.1,NC_032669.1,5839389,5917249,5917250,g,ga,1
NC_037347.1,NC_032669.1,5891089,5968929,5968930,t,tg,1
NC_037347.1,NC_032669.1,5896935,5974779,5974780,C,CA,1
NC_037347.1,NC_032669.1,5912354,5990191,5990192,a,at,1
NC_037347.1,NC_032669.1,5923004,6000852,6000853,C,CT,1
NC_037347.1,NC_032669.1,5974816,6052683,6052684,c,ct,1
NC_037347.1,NC_032669.1,5977717,6055585,6055589,t,ttgac,4
NC_037347.1,NC_032669.1,5984609,6062482,6062483,a,at,1
NC_037347.1,NC_032669.1,6045847,6123718,6123719,C,CG,1
NC_037347.1,NC_032669.1,6097300,6194001,6194002,T,TY,1
NC_037347.1,NC_032669.1,6098008,6194710,6194711,g,gc,1
NC_037347.1,NC_032669.1,6115729,6212430,6212431,G,GT,1
NC_037347.1,NC_032669.1,6245042,6342001,6342002,C,CA,1
NC_037347.1,NC_032669.1,6325323,6422829,6422830,A,AG,1
NC_037347.1,NC_032669.1,6374720,6534509,6534511,t,tNN,2
NC_037347.1,NC_032669.1,6420694,6580485,6580486,A,AG,1
NC_037347.1,NC_032669.1,6508897,6668566,6668574,t,ttttttcta,8
NC_037347.1,NC_032669.1,6517171,6676849,6676850,a,ac,1
NC_037347.1,NC_032669.1,6533318,6692997,6692998,C,CY,1
NC_037347.1,NC_032669.1,6537900,6697229,6697232,T,TTTS,3
NC_037347.1,NC_032669.1,6545295,6704624,6704625,A,AW,1
NC_037347.1,NC_032669.1,6547072,6706405,6706406,c,ct,1
NC_037347.1,NC_032669.1,6548413,6707748,6707749,C,CS,1
NC_037347.1,NC_032669.1,6549184,6708518,6708520,c,cct,2
NC_037347.1,NC_032669.1,6549767,6709103,6709104,a,ac,1
NC_037347.1,NC_032669.1,6551173,6710510,6710511,C,CM,1
NC_037347.1,NC_032669.1,6572909,6732236,6732238,G,GAT,2
NC_037347.1,NC_032669.1,6627557,6786953,6786954,c,ct,1
NC_037347.1,NC_032669.1,6704764,6859234,6859236,a,aat,2
NC_037347.1,NC_032669.1,6706313,6860785,6860787,a,aat,2
NC_037347.1,NC_032669.1,6712717,6867200,6867203,T,TGGG,3
NC_037347.1,NC_032669.1,6714596,6869082,6869083,c,ct,1
NC_037347.1,NC_032669.1,6728897,6884166,6884167,t,tc,1
NC_037347.1,NC_032669.1,6741383,6896653,6896654,C,CG,1
NC_037347.1,NC_032669.1,6747481,6902759,6902763,T,TTAAG,4
NC_037347.1,NC_032669.1,6766912,6922197,6922202,T,TTCTTA,5
NC_037347.1,NC_032669.1,6780093,6935382,6935383,G,GK,1
NC_037347.1,NC_032669.1,6785290,6940580,6940581,g,gt,1
NC_037347.1,NC_032669.1,6789030,6944320,6944321,G,GC,1
NC_037347.1,NC_032669.1,6803277,6975893,6975902,A,AACTGTGTAC,9
NC_037347.1,NC_032669.1,6819720,6992346,6992353,T,TTTGCAAG,7
NC_037347.1,NC_032669.1,6821326,6993960,6993961,a,at,1
NC_037347.1,NC_032669.1,6878162,7049849,7049850,A,AT,1
NC_037347.1,NC_032669.1,6885724,7057358,7057360,C,CAT,2
NC_037347.1,NC_032669.1,6927058,7165622,7165623,c,ct,1
NC_037347.1,NC_032669.1,6953642,7192103,7192104,G,GA,1
NC_037347.1,NC_032669.1,6988342,7226918,7226919,A,AR,1
NC_037347.1,NC_032669.1,7006015,7244480,7244481,C,CT,1
NC_037347.1,NC_032669.1,7012055,7250584,7250585,a,at,1
NC_037347.1,NC_032669.1,7021362,7259891,7259892,t,ta,1
NC_037347.1,NC_032669.1,7025651,7264179,7264181,C,CAG,2
NC_037347.1,NC_032669.1,7027276,7265807,7265808,a,at,1
NC_037347.1,NC_032669.1,7029551,7268091,7268092,G,GT,1
NC_037347.1,NC_032669.1,7030022,7268562,7268563,T,TG,1
NC_037347.1,NC_032669.1,7031495,7270037,7270038,t,ta,1
NC_037347.1,NC_032669.1,7188067,7435717,7435718,T,TW,1
NC_037347.1,NC_032669.1,7293441,7541529,7541530,A,AG,1
NC_037347.1,NC_032669.1,7392424,7683804,7683808,c,cgcgt,4
NC_037347.1,NC_032669.1,7402231,7693612,7693613,C,CT,1
NC_037347.1,NC_032669.1,7412653,7704035,7704042,C,CTCAGAGT,7
NC_037347.1,NC_032669.1,7453917,7745299,7745300,C,CG,1
NC_037347.1,NC_032669.1,7455414,7746584,7746585,G,GR,1
NC_037347.1,NC_032669.1,7492799,7784381,7784382,G,GS,1
NC_037347.1,NC_032669.1,7510591,7802030,7802032,C,CAT,2
NC_037347.1,NC_032669.1,7588770,7880281,7880296,A,AAGCNNNNNNNNNNNN,15
NC_037347.1,NC_032669.1,7611243,7902771,7902772,t,tc,1
NC_037347.1,NC_032669.1,7627992,7919521,7919524,a,acct,3
NC_037347.1,NC_032669.1,7628575,7920107,7920108,t,ta,1
NC_037347.1,NC_032669.1,7670811,7962887,7962889,t,tta,2
NC_037347.1,NC_032669.1,7682898,7974940,7974941,T,TA,1
NC_037347.1,NC_032669.1,7731905,8023850,8023851,T,TC,1
NC_037347.1,NC_032669.1,7761374,8053406,8053407,a,aR,1
NC_037347.1,NC_032669.1,7766886,8058931,8058932,A,AG,1
NC_037347.1,NC_032669.1,7769723,8061765,8061767,G,GAA,2
NC_037347.1,NC_032669.1,7818389,8130519,8130520,T,TW,1
NC_037347.1,NC_032669.1,7869224,8181797,8181798,g,gc,1
NC_037347.1,NC_032669.1,7883352,8196365,8196366,A,AT,1
NC_037347.1,NC_032669.1,7923423,8239483,8239487,g,gagca,4
NC_037347.1,NC_032669.1,7931072,8247149,8247150,a,aR,1
NC_037347.1,NC_032669.1,7966300,8281326,8281327,c,ct,1
NC_037347.1,NC_032669.1,7968551,8283578,8283579,T,TG,1
NC_037347.1,NC_032669.1,7977142,8292181,8292182,C,CY,1
NC_037347.1,NC_032669.1,7979672,8294714,8294716,g,gga,2
NC_037347.1,NC_032669.1,8004883,8320277,8320281,T,TGAAK,4
NC_037347.1,NC_032669.1,8010863,8374620,8374621,T,TA,1
NC_037347.1,NC_032669.1,8061180,8424935,8424936,A,AR,1
NC_037347.1,NC_032669.1,8093264,8457012,8457013,C,CT,1
NC_037347.1,NC_032669.1,8097077,8460825,8460826,t,ta,1
NC_037347.1,NC_032669.1,8110997,8474748,8474753,C,CCAGAG,5
NC_037347.1,NC_032669.1,8111052,8474808,8474809,A,AR,1
NC_037347.1,NC_032669.1,8138095,8501862,8501863,c,ct,1
NC_037347.1,NC_032669.1,8141283,8505051,8505052,G,GC,1
NC_037347.1,NC_032669.1,8150306,8514078,8514079,A,AC,1
NC_037347.1,NC_032669.1,8169466,8533240,8533241,T,TY,1
NC_037347.1,NC_032669.1,8186369,8547998,8547999,G,GK,1
NC_037347.1,NC_032669.1,8187403,8549034,8549035,A,AT,1
NC_037347.1,NC_032669.1,8206264,8567901,8567921,T,TATTGTTGCAGATATCTGTAC,20
NC_037347.1,NC_032669.1,8212834,8574486,8574487,C,CT,1
NC_037347.1,NC_032669.1,8233587,8595250,8595251,t,ta,1
NC_037347.1,NC_032669.1,8262643,8624307,8624308,G,GR,1
NC_037347.1,NC_032669.1,8294322,8655868,8655869,T,TA,1
NC_037347.1,NC_032669.1,8295957,8657442,8657443,A,AT,1
NC_037347.1,NC_032669.1,8307756,8669242,8669244,a,aNN,2
NC_037347.1,NC_032669.1,8357802,8719290,8719293,g,gtgt,3
NC_037347.1,NC_032669.1,8392137,8754014,8754015,a,ac,1
NC_037347.1,NC_032669.1,8435211,8801559,8801560,G,GC,1
NC_037347.1,NC_032669.1,8438486,8804836,8804837,T,TC,1
NC_037347.1,NC_032669.1,8628771,9017419,9017420,G,GC,1
NC_037347.1,NC_032669.1,8634122,9022773,9022777,c,ccttt,4
NC_037347.1,NC_032669.1,8634614,9023269,9023270,A,AT,1
NC_037347.1,NC_032669.1,8638123,9026779,9026780,A,AT,1
NC_037347.1,NC_032669.1,8641098,9029755,9029756,A,AC,1
NC_037347.1,NC_032669.1,8676190,9064871,9064873,g,gtt,2
NC_037347.1,NC_032669.1,8708232,9342078,9342079,a,ac,1
NC_037347.1,NC_032669.1,8722152,9356335,9356337,g,gga,2
NC_037347.1,NC_032669.1,8963608,9598278,9598279,C,CY,1
NC_037347.1,NC_032669.1,8970905,9605576,9605577,T,TW,1
NC_037347.1,NC_032669.1,8970959,9605631,9605632,A,AM,1
NC_037347.1,NC_032669.1,8971261,9605935,9605936,C,CN,1
NC_037347.1,NC_032669.1,8971645,9606320,9606321,A,AW,1
NC_037347.1,NC_032669.1,9096518,9734395,9734396,c,ct,1
NC_037347.1,NC_032669.1,9099508,9737388,9737390,g,gta,2
NC_037347.1,NC_032669.1,9101640,9739525,9739526,g,ga,1
NC_037347.1,NC_032669.1,9110630,9748515,9748522,T,TCCTTGTC,7
NC_037347.1,NC_032669.1,9111865,9749765,9749767,a,atg,2
NC_037347.1,NC_032669.1,9112107,9750009,9750010,g,gt,1
NC_037347.1,NC_032669.1,9128601,9766502,9766503,G,GS,1
NC_037347.1,NC_032669.1,9199595,9917735,9917736,C,CT,1
NC_037347.1,NC_032669.1,9203157,9921298,9921302,a,aNNNN,4
NC_037347.1,NC_032669.1,9256850,9975015,9975016,C,CY,1
NC_037347.1,NC_032669.1,9274108,9992280,9992281,a,ag,1
NC_037347.1,NC_032669.1,9286711,10004889,10004890,T,TG,1
NC_037347.1,NC_032669.1,9316684,10034790,10034791,G,GY,1
NC_037347.1,NC_032669.1,9333656,10051765,10051766,g,gK,1
NC_037347.1,NC_032669.1,9342382,10060492,10060493,g,gt,1
NC_037347.1,NC_032669.1,9373633,10091493,10091494,C,CA,1
NC_037347.1,NC_032669.1,9404184,10122047,10122048,t,ta,1
NC_037347.1,NC_032669.1,9514891,10241525,10241526,a,at,1
NC_037347.1,NC_032669.1,9568515,10295069,10295070,A,AG,1
NC_037347.1,NC_032669.1,9588478,10315058,10315081,T,TTTTGGAAATCCAACAGGCCCTTG,23
NC_037347.1,NC_032669.1,9607296,10333904,10333905,T,TG,1
NC_037347.1,NC_032669.1,9637929,10364401,10364403,A,AGG,2
NC_037347.1,NC_032669.1,9690759,10417242,10417243,T,TY,1
NC_037347.1,NC_032669.1,9691660,10418153,10418154,g,gK,1
NC_037347.1,NC_032669.1,9692253,10418747,10418749,A,AAT,2
NC_037347.1,NC_032669.1,9697518,10424014,10424030,G,GTYTAAGCACATGCCAR,16
NC_037347.1,NC_032669.1,9698956,10425468,10425469,A,AG,1
NC_037347.1,NC_032669.1,9710885,10437405,10437407,a,act,2
NC_037347.1,NC_032669.1,9711292,10437814,10437815,t,tc,1
NC_037347.1,NC_032669.1,9714796,10441032,10441033,A,AG,1
NC_037347.1,NC_032669.1,9714946,10441183,10441184,C,CM,1
NC_037347.1,NC_032669.1,9715594,10441832,10441833,a,ag,1
NC_037347.1,NC_032669.1,9746795,10479357,10479358,a,ag,1
NC_037347.1,NC_032669.1,9753049,10485613,10485625,t,tctcatggcagtg,12
NC_037347.1,NC_032669.1,9798064,10530244,10530245,T,TA,1
NC_037347.1,NC_032669.1,9971902,10556808,10556809,c,ca,1
NC_037347.1,NC_032669.1,9989616,10574512,10574516,a,aaaat,4
NC_037347.1,NC_032669.1,9989623,10574523,10574529,a,aaaaaac,6
NC_037347.1,NC_032669.1,9994587,10579499,10579500,t,tK,1
NC_037347.1,NC_032669.1,10020235,10605180,10605181,A,AT,1
NC_037347.1,NC_032669.1,10027929,10612879,10612880,A,AT,1
NC_037347.1,NC_032669.1,10036121,10621075,10621077,A,AAC,2
NC_037347.1,NC_032669.1,10043348,10628299,10628300,t,ta,1
NC_037347.1,NC_032669.1,10045497,10630451,10630452,A,AG,1
NC_037347.1,NC_032669.1,10065764,10650727,10650729,t,tta,2
NC_037347.1,NC_032669.1,10178569,10764656,10764657,c,ct,1
NC_037347.1,NC_032669.1,10181745,10767833,10767835,c,cca,2
NC_037347.1,NC_032669.1,10181747,10767837,10767838,t,ta,1
NC_037347.1,NC_032669.1,10181791,10767881,10767882,g,gc,1
NC_037347.1,NC_032669.1,10181806,10767897,10767898,t,tg,1
NC_037347.1,NC_032669.1,10181844,10767936,10767937,a,ag,1
NC_037347.1,NC_032669.1,10187464,10774658,10774659,C,CA,1
NC_037347.1,NC_032669.1,10386718,10994744,10994745,A,AC,1
NC_037347.1,NC_032669.1,10395689,11003700,11003701,a,ag,1
NC_037347.1,NC_032669.1,10427316,11035263,11035264,G,GA,1
NC_037347.1,NC_032669.1,10457302,11056010,11056011,t,ta,1
NC_037347.1,NC_032669.1,10457305,11056014,11056015,t,tg,1
NC_037347.1,NC_032669.1,10481218,11079889,11079890,t,ta,1
NC_037347.1,NC_032669.1,10520709,11119384,11119386,A,AAC,2
NC_037347.1,NC_032669.1,10555723,11154397,11154399,a,aac,2
NC_037347.1,NC_032669.1,10565170,11163847,11163848,T,TC,1
NC_037347.1,NC_032669.1,10566064,11164743,11164744,t,tg,1
NC_037347.1,NC_032669.1,10567856,11166536,11166541,a,actgat,5
NC_037347.1,NC_032669.1,10606474,11205162,11205163,G,GC,1
NC_037347.1,NC_032669.1,10608628,11207317,11207318,A,AT,1
NC_037347.1,NC_032669.1,10610906,11209598,11209599,T,TA,1
NC_037347.1,NC_032669.1,10612482,11211175,11211187,G,GGGCTTTTCTATT,12
NC_037347.1,NC_032669.1,10622682,11221384,11221385,A,AR,1
NC_037347.1,NC_032669.1,10639682,11238384,11238385,C,CT,1
NC_037347.1,NC_032669.1,10729279,11328403,11328404,c,cg,1
NC_037347.1,NC_032669.1,10729290,11328382,11328392,c,caggcaatagt,10
NC_037347.1,NC_032669.1,10779799,11458776,11458777,t,ta,1
NC_037347.1,NC_032669.1,10781731,11275999,11276000,t,ta,1
NC_037347.1,NC_032669.1,10781731,11460709,11460710,t,ta,1
NC_037347.1,NC_032669.1,10798983,11258756,11258757,C,CT,1
NC_037347.1,NC_032669.1,10798983,11477952,11477953,C,CT,1
NC_037347.1,NC_032669.1,10803166,11482130,11482135,a,actgag,5
NC_037347.1,NC_032669.1,10818299,11497266,11497273,c,ctttcact,7
NC_037347.1,NC_032669.1,10839307,11518282,11518283,t,ta,1
NC_037347.1,NC_032669.1,10861740,11540712,11540713,t,ta,1
NC_037347.1,NC_032669.1,10902546,11581576,11581577,C,CT,1
NC_037347.1,NC_032669.1,10904329,11583361,11583384,A,ACTGTTCTGACAACAGTGTCACGT,23
NC_037347.1,NC_032669.1,10985796,11664853,11664854,g,gt,1
NC_037347.1,NC_032669.1,10999765,11678825,11678826,A,AC,1
NC_037347.1,NC_032669.1,11037598,11716646,11716647,c,ca,1
NC_037347.1,NC_032669.1,11065394,11744450,11744451,g,gt,1
NC_037347.1,NC_032669.1,11069611,11761049,11761050,g,ga,1
NC_037347.1,NC_032669.1,11070308,11761746,11761748,a,atc,2
NC_037347.1,NC_032669.1,11073542,11764976,11764977,t,ta,1
NC_037347.1,NC_032669.1,11074147,11765582,11765590,g,ggtggccaa,8
NC_037347.1,NC_032669.1,11074199,11765642,11765643,a,ag,1
NC_037347.1,NC_032669.1,11076472,11767918,11767919,g,gc,1
NC_037347.1,NC_032669.1,11091186,11782685,11782688,c,ctgt,3
NC_037347.1,NC_032669.1,11097645,11789917,11789919,T,TTG,2
NC_037347.1,NC_032669.1,11107956,11800234,11800235,C,CT,1
NC_037347.1,NC_032669.1,11120567,11812888,11812890,C,CTG,2
NC_037347.1,NC_032669.1,11127105,11819428,11819429,T,TA,1
NC_037347.1,NC_032669.1,11137393,11829724,11829727,A,ATGT,3
NC_037347.1,NC_032669.1,11137742,11830076,11830078,t,tga,2
NC_037347.1,NC_032669.1,11139972,11832308,11832315,g,gagatcaa,7
NC_037347.1,NC_032669.1,11175760,11868109,11868110,T,TG,1
NC_037347.1,NC_032669.1,11214440,11906814,11906819,a,acatac,5
NC_037347.1,NC_032669.1,11215463,11907843,11907846,c,cctt,3
NC_037347.1,NC_032669.1,11255570,11947939,11947941,C,CAT,2
NC_037347.1,NC_032669.1,11256854,11949225,11949229,G,GGGGA,4
NC_037347.1,NC_032669.1,11293488,11985870,11985877,A,AGTGCCCT,7
NC_037347.1,NC_032669.1,11312355,12004747,12004748,t,ta,1
NC_037347.1,NC_032669.1,11313331,12005724,12005732,A,AGAGGGGGT,8
NC_037347.1,NC_032669.1,11331296,12023695,12023697,c,cta,2
NC_037347.1,NC_032669.1,11354374,12046777,12046778,A,AC,1
NC_037347.1,NC_032669.1,11387384,12079813,12079815,a,aNN,2
NC_037347.1,NC_032669.1,11416958,12109407,12109412,g,ggggga,5
NC_037347.1,NC_032669.1,11429766,12122099,12122100,C,CA,1
NC_037347.1,NC_032669.1,11458358,12150689,12150693,G,GATAK,4
NC_037347.1,NC_032669.1,11461085,12153422,12153423,G,GT,1
NC_037347.1,NC_032669.1,11461453,12153811,12153813,A,ATR,2
NC_037347.1,NC_032669.1,11470274,12162652,12162655,A,ATTT,3
NC_037347.1,NC_032669.1,11470284,12162665,12162674,T,TTTGATTCTC,9
NC_037347.1,NC_032669.1,11525192,12217691,12217697,t,tagcagc,6
NC_037347.1,NC_032669.1,11557296,12251382,12251383,t,ta,1
NC_037347.1,NC_032669.1,11560418,12254509,12254510,t,tg,1
NC_037347.1,NC_032669.1,11656932,12382064,12382068,G,GACCA,4
NC_037347.1,NC_032669.1,11664042,12389186,12389187,a,aN,1
NC_037347.1,NC_032669.1,11670881,12277870,12277872,A,AAT,2
NC_037347.1,NC_032669.1,11670881,12396027,12396029,A,AAT,2
NC_037347.1,NC_032669.1,11721152,12446315,12446317,a,aNN,2
NC_037347.1,NC_032669.1,11749943,12475113,12475114,G,GA,1
NC_037347.1,NC_032669.1,11776196,12501368,12501369,c,ct,1
NC_037347.1,NC_032669.1,11831221,12555952,12555953,c,ca,1
NC_037347.1,NC_032669.1,11855956,12580688,12580689,t,ta,1
NC_037347.1,NC_032669.1,11884113,12608847,12608848,a,ac,1
NC_037347.1,NC_032669.1,11885369,12610105,12610117,a,acaagttccaggg,12
NC_037347.1,NC_032669.1,12039248,12764002,12764004,C,CTA,2
NC_037347.1,NC_032669.1,12039379,12764135,12764136,G,GT,1
NC_037347.1,NC_032669.1,12134322,12859113,12859115,t,tNN,2
NC_037347.1,NC_032669.1,12158498,12883291,12883292,T,TC,1
NC_037347.1,NC_032669.1,12173035,12897620,12897621,A,AG,1
NC_037347.1,NC_032669.1,12174373,12898963,12898964,A,AG,1
NC_037347.1,NC_032669.1,12189485,12914074,12914075,T,TY,1
NC_037347.1,NC_032669.1,12232681,12957281,12957282,G,GT,1
NC_037347.1,NC_032669.1,12285227,13009630,13009631,C,CY,1
NC_037347.1,NC_032669.1,12292307,13016711,13016712,A,AG,1
NC_037347.1,NC_032669.1,12294773,13019178,13019179,T,TG,1
NC_037347.1,NC_032669.1,12327976,13056039,13056040,G,GA,1
NC_037347.1,NC_032669.1,12376613,13104314,13104318,A,ATGAC,4
NC_037347.1,NC_032669.1,12379464,13107172,13107182,a,aacacatacac,10
NC_037347.1,NC_032669.1,12380560,13108278,13108279,t,tg,1
NC_037347.1,NC_032669.1,12380566,13108285,13108288,c,cttt,3
NC_037347.1,NC_032669.1,12503321,13230652,13230653,c,ca,1
NC_037347.1,NC_032669.1,12504009,13231343,13231344,A,AT,1
NC_037347.1,NC_032669.1,12505635,13232969,13232970,A,AT,1
NC_037347.1,NC_032669.1,12506195,13233531,13233532,C,CA,1
NC_037347.1,NC_032669.1,12546629,13273961,13273962,T,TW,1
NC_037347.1,NC_032669.1,12547262,13274595,13274596,a,ag,1
NC_037347.1,NC_032669.1,12692474,13417054,13417056,a,aat,2
NC_037347.1,NC_032669.1,12706962,13431578,13431587,A,AAATACCGGT,9
NC_037347.1,NC_032669.1,12706962,13443434,13443443,A,AAATACCGGT,9
NC_037347.1,NC_032669.1,12709230,13445710,13445718,T,TAANNNNNN,8
NC_037347.1,NC_032669.1,12711078,13447566,13447567,G,GR,1
NC_037347.1,NC_032669.1,12740882,13477376,13477378,C,CAT,2
NC_037347.1,NC_032669.1,12743885,13480380,13480381,A,AC,1
NC_037347.1,NC_032669.1,12760708,13495950,13495952,C,CTG,2
NC_037347.1,NC_032669.1,12760788,13496032,13496033,T,TA,1
NC_037347.1,NC_032669.1,12827623,13562903,13562905,G,GGT,2
NC_037347.1,NC_032669.1,12844718,13580005,13580006,g,ga,1
NC_037347.1,NC_032669.1,12853916,13589205,13589206,G,GT,1
NC_037347.1,NC_032669.1,12905605,13641238,13641240,G,GGA,2
NC_037347.1,NC_032669.1,12926072,13661528,13661529,a,ac,1
NC_037347.1,NC_032669.1,12927359,13662816,13662817,g,ga,1
NC_037347.1,NC_032669.1,12927537,13662995,13662996,g,gc,1
NC_037347.1,NC_032669.1,12932516,13666970,13666971,g,ga,1
NC_037347.1,NC_032669.1,12946189,13680647,13680648,C,CA,1
NC_037347.1,NC_032669.1,12959941,13694400,13694401,A,AR,1
NC_037347.1,NC_032669.1,12963544,13698004,13698005,G,GT,1
NC_037347.1,NC_032669.1,13005048,13739517,13739518,T,TA,1
NC_037347.1,NC_032669.1,13038455,13772928,13772929,G,GC,1
NC_037347.1,NC_032669.1,13048457,13782935,13782938,a,agat,3
NC_037347.1,NC_032669.1,13077707,13824988,13824989,T,TC,1
NC_037347.1,NC_032669.1,13113220,13860408,13860412,a,aNNNN,4
NC_037347.1,NC_032669.1,13116402,13863594,13863595,T,TY,1
NC_037347.1,NC_032669.1,13178335,13927857,13927858,a,ac,1
NC_037347.1,NC_032669.1,13380604,14130769,14130770,A,AR,1
NC_037347.1,NC_032669.1,13384479,14134650,14134651,T,TC,1
NC_037347.1,NC_032669.1,13515890,14265084,14265085,G,GC,1
NC_037347.1,NC_032669.1,13656964,14405940,14405941,A,AT,1
NC_037347.1,NC_032669.1,13669464,14417345,14417346,A,AG,1
NC_037347.1,NC_032669.1,13669568,14417452,14417453,C,CT,1
NC_037347.1,NC_032669.1,13719540,14467199,14467213,g,gactCACCAGACACC,14
NC_037347.1,NC_032669.1,13728200,14475700,14475701,t,ta,1
NC_037347.1,NC_032669.1,13729950,14477443,14477444,c,ca,1
NC_037347.1,NC_032669.1,13769805,14517073,14517074,t,ta,1
NC_037347.1,NC_032669.1,13879970,14653150,14653151,g,gc,1
NC_037347.1,NC_032669.1,13888356,14661537,14661539,C,CCY,2
NC_037347.1,NC_032669.1,13908272,14681462,14681464,A,ACT,2
NC_037347.1,NC_032669.1,13913065,14686257,14686265,t,tNNNNNNNN,8
NC_037347.1,NC_032669.1,13925788,14773197,14773198,t,ta,1
NC_037347.1,NC_032669.1,13983071,14830492,14830494,C,CAT,2
NC_037347.1,NC_032669.1,13988601,14836024,14836025,T,TW,1
NC_037347.1,NC_032669.1,13993535,14840959,14840960,c,ca,1
NC_037347.1,NC_032669.1,13993719,14841144,14841169,A,ACGCCTNNNNNNNNNNNNNNNNNNNN,25
NC_037347.1,NC_032669.1,13996195,14843646,14843647,T,TW,1
NC_037347.1,NC_032669.1,14010041,14857049,14857051,T,TTG,2
NC_037347.1,NC_032669.1,14047650,14894671,14894672,c,ct,1
NC_037347.1,NC_032669.1,14085875,14932903,14932904,A,AR,1
NC_037347.1,NC_032669.1,14263692,15110169,15110171,a,agN,2
NC_037347.1,NC_032669.1,14378740,15260284,15260285,A,AG,1
NC_037347.1,NC_032669.1,14388754,15270289,15270290,T,TA,1
NC_037347.1,NC_032669.1,14403387,15284843,15284844,A,AG,1
NC_037347.1,NC_032669.1,14450537,15332264,15332265,G,GN,1
NC_037347.1,NC_032669.1,14485297,15367028,15367029,a,aN,1
NC_037347.1,NC_032669.1,14514325,15396061,15396062,A,AG,1
NC_037347.1,NC_032669.1,14554382,15436128,15436129,G,GA,1
NC_037347.1,NC_032669.1,14905769,16077875,16077876,T,TK,1
NC_037347.1,NC_032669.1,15002253,16174365,16174367,t,ttc,2
NC_037347.1,NC_032669.1,15004577,16176691,16176700,c,ctgtttccat,9
NC_037347.1,NC_032669.1,15070016,16279670,16279671,t,tN,1
NC_037347.1,NC_032669.1,15082552,16292223,16292224,g,gt,1
NC_037347.1,NC_032669.1,15082609,16292281,16292291,g,gcgGANNNNNN,10
NC_037347.1,NC_032669.1,15176001,16385676,16385677,a,at,1
NC_037347.1,NC_032669.1,15241834,16451514,16451515,c,ct,1
NC_037347.1,NC_032669.1,15245340,16455026,16455028,T,TTA,2
NC_037347.1,NC_032669.1,15245988,16455677,16455682,a,aaaaag,5
NC_037347.1,NC_032669.1,15287841,16497566,16497567,C,CA,1
NC_037347.1,NC_032669.1,15321003,16529617,16529618,C,CA,1
NC_037347.1,NC_032669.1,15331187,16539806,16539807,A,AC,1
NC_037347.1,NC_032669.1,15344553,16553300,16553301,C,CG,1
NC_037347.1,NC_032669.1,15400544,16609858,16609859,a,aW,1
NC_037347.1,NC_032669.1,15411123,16620456,16620457,g,ga,1
NC_037347.1,NC_032669.1,15443507,16652838,16652839,T,TM,1
NC_037347.1,NC_032669.1,15447433,16656766,16656767,t,tc,1
NC_037347.1,NC_032669.1,15459067,16670427,16670428,t,tW,1
NC_037347.1,NC_032669.1,15459180,16670541,16670542,A,AT,1
NC_037347.1,NC_032669.1,15459572,16670933,16670936,g,gttt,3
NC_037347.1,NC_032669.1,15479328,16690693,16690694,A,AK,1
NC_037347.1,NC_032669.1,15679289,16904452,16904453,G,GW,1
NC_037347.1,NC_032669.1,15680684,16905847,16905853,t,tttttta,6
NC_037347.1,NC_032669.1,15694949,16920165,16920167,a,aag,2
NC_037347.1,NC_032669.1,15694986,16920203,16920205,g,ggt,2
NC_037347.1,NC_032669.1,15696295,16921514,16921515,t,tc,1
NC_037347.1,NC_032669.1,15733776,16979533,16979534,g,gc,1
NC_037347.1,NC_032669.1,15750618,16999485,16999487,G,GAT,2
NC_037347.1,NC_032669.1,15753081,17001950,17001953,g,gttt,3
NC_037347.1,NC_032669.1,15771085,17020088,17020089,t,tg,1
NC_037347.1,NC_032669.1,15774850,17023845,17023846,A,AG,1
NC_037347.1,NC_032669.1,15774867,17023863,17023864,C,CM,1
NC_037347.1,NC_032669.1,15775494,17024495,17024505,a,aCATCTCTCTC,10
NC_037347.1,NC_032669.1,15780196,17029210,17029213,t,tttc,3
NC_037347.1,NC_032669.1,15782973,17031992,17031993,A,AW,1
NC_037347.1,NC_032669.1,15783944,17032965,17032966,g,ga,1
NC_037347.1,NC_032669.1,15789089,17038638,17038639,a,aN,1
NC_037347.1,NC_032669.1,15797514,17047070,17047074,T,TAGGA,4
NC_037347.1,NC_032669.1,15830039,17077771,17077772,C,CW,1
NC_037347.1,NC_032669.1,15830192,17077923,17077925,A,ANN,2
NC_037347.1,NC_032669.1,15856448,17104226,17104227,a,ag,1
NC_037347.1,NC_032669.1,15864398,17112182,17112183,A,AG,1
NC_037347.1,NC_032669.1,15866728,17114511,17114512,t,ta,1
NC_037347.1,NC_032669.1,15868862,17116638,17116639,t,tY,1
NC_037347.1,NC_032669.1,15870517,17118294,17118297,A,ATTW,3
NC_037347.1,NC_032669.1,15870998,17118778,17118780,C,CAY,2
NC_037347.1,NC_032669.1,15878727,17126510,17126511,c,cM,1
NC_037347.1,NC_032669.1,15878796,17126580,17126581,t,ta,1
NC_037347.1,NC_032669.1,15931053,17178914,17178919,A,AAATAW,5
NC_037347.1,NC_032669.1,15953149,17201006,17201012,t,tNNNNNN,6
NC_037347.1,NC_032669.1,15982120,17229988,17229989,T,TA,1
NC_037347.1,NC_032669.1,16011049,17258584,17258585,C,CY,1
NC_037347.1,NC_032669.1,16039282,17285911,17285912,G,GS,1
NC_037347.1,NC_032669.1,16047732,17294362,17294376,a,atatatatatatatg,14
NC_037347.1,NC_032669.1,16052867,17299716,17299717,T,TK,1
NC_037347.1,NC_032669.1,16065422,17312227,17312233,c,cgtgtgt,6
NC_037347.1,NC_032669.1,16127672,17376102,17376103,C,CY,1
NC_037347.1,NC_032669.1,16127810,17376241,17376243,A,ATC,2
NC_037347.1,NC_032669.1,16130695,17379127,17379129,T,TCA,2
NC_037347.1,NC_032669.1,16133349,17381783,17381784,A,AW,1
NC_037347.1,NC_032669.1,16241075,17489551,17489552,c,ca,1
NC_037347.1,NC_032669.1,16245623,17494096,17494097,G,GC,1
NC_037347.1,NC_032669.1,16249493,17497969,17497970,a,ag,1
NC_037347.1,NC_032669.1,16251237,17499804,17499805,C,CT,1
NC_037347.1,NC_032669.1,16251292,17499860,17499861,T,TK,1
NC_037347.1,NC_032669.1,16253145,17501715,17501716,A,AC,1
NC_037347.1,NC_032669.1,16253524,17502096,17502097,G,GA,1
NC_037347.1,NC_032669.1,16253944,17502517,17502518,G,GM,1
NC_037347.1,NC_032669.1,16253958,17502532,17502533,C,CA,1
NC_037347.1,NC_032669.1,16260196,17508776,17508779,g,ggaa,3
NC_037347.1,NC_032669.1,16275087,17523672,17523673,T,TG,1
NC_037347.1,NC_032669.1,16275156,17523742,17523746,t,tacac,4
NC_037347.1,NC_032669.1,16290239,17538836,17538838,g,gaa,2
NC_037347.1,NC_032669.1,16305848,17554451,17554452,c,ca,1
NC_037347.1,NC_032669.1,16309781,17558387,17558398,G,GAGACGTGATAT,11
NC_037347.1,NC_032669.1,16310094,17558711,17558738,C,CTACCTTGAGGAGATGTAGGTATGATCT,27
NC_037347.1,NC_032669.1,16310633,17559275,17559276,C,CA,1
NC_037347.1,NC_032669.1,16310753,17559396,17559397,A,AR,1
NC_037347.1,NC_032669.1,16334473,17583137,17583138,t,ta,1
NC_037347.1,NC_032669.1,16360504,17615114,17615115,a,at,1
NC_037347.1,NC_032669.1,16360799,17615419,17615420,a,ac,1
NC_037347.1,NC_032669.1,16361348,17615962,17615963,t,tc,1
NC_037347.1,NC_032669.1,16361387,17616002,17616005,c,cctt,3
NC_037347.1,NC_032669.1,16366502,17621117,17621118,t,ta,1
NC_037347.1,NC_032669.1,16383561,17638191,17638195,T,TAATC,4
NC_037347.1,NC_032669.1,16383698,17638335,17638336,t,ta,1
NC_037347.1,NC_032669.1,16386256,17640894,17640895,a,ac,1
NC_037347.1,NC_032669.1,16395929,17650560,17650561,c,ct,1
NC_037347.1,NC_032669.1,16406681,17661311,17661312,G,GR,1
NC_037347.1,NC_032669.1,16409239,17663870,17663871,a,at,1
NC_037347.1,NC_032669.1,16415817,17670451,17670453,t,ttg,2
NC_037347.1,NC_032669.1,16431584,17684972,17684973,c,ct,1
NC_037347.1,NC_032669.1,16436705,17690029,17690030,g,gt,1
NC_037347.1,NC_032669.1,16450918,17704759,17704761,T,TTC,2
NC_037347.1,NC_032669.1,16451060,17704903,17704906,g,gttt,3
NC_037347.1,NC_032669.1,16460155,17713515,17713518,T,TCTC,3
NC_037347.1,NC_032669.1,16460573,17713936,17713937,G,GR,1
NC_037347.1,NC_032669.1,16478916,17732280,17732291,g,ggggttttgttt,11
NC_037347.1,NC_032669.1,16495148,17748526,17748527,C,CA,1
NC_037347.1,NC_032669.1,16506775,17760161,17760163,a,att,2
NC_037347.1,NC_032669.1,16514459,17767836,17767837,a,ag,1
NC_037347.1,NC_032669.1,16519075,17772454,17772457,C,CCTT,3
NC_037347.1,NC_032669.1,16568085,17821484,17821485,G,GT,1
NC_037347.1,NC_032669.1,16571083,17824485,17824487,c,ctt,2
NC_037347.1,NC_032669.1,16578266,17831664,17831671,G,GAGTTCAA,7
NC_037347.1,NC_032669.1,16582799,17836206,17836208,G,GCA,2
NC_037347.1,NC_032669.1,16601125,17855105,17855106,c,ct,1
NC_037347.1,NC_032669.1,16609508,17863491,17863493,C,CAG,2
NC_037347.1,NC_032669.1,16615273,17869255,17869257,A,AAG,2
NC_037347.1,NC_032669.1,16619158,17873145,17873146,a,at,1
NC_037347.1,NC_032669.1,16631283,17885201,17885202,t,tg,1
NC_037347.1,NC_032669.1,16637223,17891142,17891143,g,ga,1
NC_037347.1,NC_032669.1,16684462,17954521,17954522,A,AG,1
NC_037347.1,NC_032669.1,16709835,17979673,17979682,A,ACCCTAACAC,9
NC_037347.1,NC_032669.1,16764817,18034786,18034787,C,CA,1
NC_037347.1,NC_032669.1,16785794,18055604,18055605,a,aN,1
NC_037347.1,NC_032669.1,16816912,18086728,18086729,C,CA,1
NC_037347.1,NC_032669.1,16927701,18198265,18198266,C,CA,1
NC_037347.1,NC_032669.1,16939491,18210059,18210060,A,AC,1
NC_037347.1,NC_032669.1,17056022,18326847,18326849,a,aaN,2
NC_037347.1,NC_032669.1,17060218,18331045,18331049,A,ATAWW,4
NC_037347.1,NC_032669.1,17116899,18387733,18387735,C,CTS,2
NC_037347.1,NC_032669.1,17117475,18388311,18388312,A,AT,1
NC_037347.1,NC_032669.1,17141164,18433157,18433158,a,at,1
NC_037347.1,NC_032669.1,17169712,18460990,18460992,T,TAA,2
NC_037347.1,NC_032669.1,17183451,18474542,18474546,t,ttgtc,4
NC_037347.1,NC_032669.1,17187802,18478898,18478899,t,ta,1
NC_037347.1,NC_032669.1,17191962,18483059,18483069,A,AGGTTGGAGCT,10
NC_037347.1,NC_032669.1,17283692,18574351,18574352,T,TC,1
NC_037347.1,NC_032669.1,17294383,18585044,18585045,c,ca,1
NC_037347.1,NC_032669.1,17310339,18600998,18600999,t,ta,1
NC_037347.1,NC_032669.1,17340109,18630774,18630780,a,aNNNNNN,6
NC_037347.1,NC_032669.1,17340415,18631087,18631088,a,ag,1
NC_037347.1,NC_032669.1,17467716,18791304,18791308,G,GTTTC,4
NC_037347.1,NC_032669.1,17478846,18802439,18802440,A,AC,1
NC_037347.1,NC_032669.1,17511920,18835524,18835525,g,ga,1
NC_037347.1,NC_032669.1,17584311,18907732,18907733,G,GR,1
NC_037347.1,NC_032669.1,17586457,18909879,18909880,C,CY,1
NC_037347.1,NC_032669.1,17608357,18931782,18931792,T,TGGTAAAATCC,10
NC_037347.1,NC_032669.1,17727724,19051607,19051608,G,GR,1
NC_037347.1,NC_032669.1,17765113,19088376,19088377,g,gc,1
NC_037347.1,NC_032669.1,17767184,19090156,19090157,g,gt,1
NC_037347.1,NC_032669.1,17767279,19090252,19090255,t,tctc,3
NC_037347.1,NC_032669.1,17767310,19090286,19090289,g,gtct,3
NC_037347.1,NC_032669.1,17767533,19090512,19090514,a,att,2
NC_037347.1,NC_032669.1,17767913,19090894,19091182,a,agtgttctggtgggtggagctgtatttcttctctctccttttgaagacttgggttgcttttctgggtgcctgatgtcctctgctggcattcagaagttgttttgtggaatttcctcggcgtttaaatgttcttttgatgaatttgtgggggagaaagtgttctccctgtcatactcctccgccatcttagctcctcctaccaccttgtttatttaacttatcttgTGGGGTGTCTAGANNNNNNNNNNNNNNNNNNNNNNNNNNNNNNNNNNNNNNNaagcttgtgtcg,288
NC_037347.1,NC_032669.1,17782987,19106413,19106414,C,CM,1
NC_037347.1,NC_032669.1,17859103,19182533,19182534,a,ac,1
NC_037347.1,NC_032669.1,17868805,19192239,19192243,c,cacat,4
NC_037347.1,NC_032669.1,17935599,19258969,19258970,A,AW,1
NC_037347.1,NC_032669.1,18089146,19411901,19411902,t,tg,1
NC_037347.1,NC_032669.1,18095592,19418349,19418350,T,TG,1
NC_037347.1,NC_032669.1,18114376,19437180,19437181,t,ta,1
NC_037347.1,NC_032669.1,18117734,19440540,19440541,c,ca,1
NC_037347.1,NC_032669.1,18148656,19471464,19471465,T,TG,1
NC_037347.1,NC_032669.1,18184144,19509057,19509058,T,TG,1
NC_037347.1,NC_032669.1,18186146,19511060,19511061,T,TG,1
NC_037347.1,NC_032669.1,18188587,19513504,19513505,C,CT,1
NC_037347.1,NC_032669.1,18233957,19520652,19520653,c,ct,1
NC_037347.1,NC_032669.1,18234214,19520909,19520910,g,ga,1
NC_037347.1,NC_032669.1,18235392,19522088,19522089,G,GT,1
NC_037347.1,NC_032669.1,18238354,19525052,19525053,a,ag,1
NC_037347.1,NC_032669.1,18272202,19558593,19558594,C,CA,1
NC_037347.1,NC_032669.1,18274818,19561199,19561200,T,TA,1
NC_037347.1,NC_032669.1,18480926,19839873,19839882,C,CTGCTTTGTT,9
NC_037347.1,NC_032669.1,18585861,19996335,19996336,c,ct,1
NC_037347.1,NC_032669.1,18607550,20022179,20022185,t,tatGCAa,6
NC_037347.1,NC_032669.1,18770680,20185385,20185386,g,gt,1
NC_037347.1,NC_032669.1,18873354,20288075,20288082,A,ACAAGTMC,7
NC_037347.1,NC_032669.1,18925534,20340270,20340271,t,tg,1
NC_037347.1,NC_032669.1,18937623,20352360,20352361,C,CG,1
NC_037347.1,NC_032669.1,18967996,20382734,20382735,G,GR,1
NC_037347.1,NC_032669.1,19034876,20449614,20449616,g,gtt,2
NC_037347.1,NC_032669.1,19035378,20450118,20450119,a,ac,1
NC_037347.1,NC_032669.1,19068082,20482801,20482802,C,CT,1
NC_037347.1,NC_032669.1,19070911,20485630,20485631,T,TA,1
NC_037347.1,NC_032669.1,19082624,20497358,20497360,t,taa,2
NC_037347.1,NC_032669.1,19100046,20514796,20514797,T,TY,1
NC_037347.1,NC_032669.1,19113753,20614239,20614240,C,CG,1
NC_037347.1,NC_032669.1,19115278,20615765,20615766,A,AG,1
NC_037347.1,NC_032669.1,19141939,20642465,20642466,t,tg,1
NC_037347.1,NC_032669.1,19168437,20668966,20668967,g,gW,1
NC_037347.1,NC_032669.1,19186183,20686703,20686704,a,ac,1
NC_037347.1,NC_032669.1,19193518,20694203,20694204,t,tc,1
NC_037347.1,NC_032669.1,19202101,20702780,20702783,a,aaac,3
NC_037347.1,NC_032669.1,19208253,20708941,20708948,T,TAGGAAAC,7
NC_037347.1,NC_032669.1,19227535,20728374,20728377,a,actg,3
NC_037347.1,NC_032669.1,19236569,20737411,20737412,T,TA,1
NC_037347.1,NC_032669.1,19289796,20790635,20790636,T,TK,1
NC_037347.1,NC_032669.1,19292979,20793818,20793819,T,TY,1
NC_037347.1,NC_032669.1,19294051,20794891,20794895,T,TGTAC,4
NC_037347.1,NC_032669.1,19330210,20828144,20828145,T,TC,1
NC_037347.1,NC_032669.1,19332372,20830307,20830308,c,ct,1
NC_037347.1,NC_032669.1,19456532,20958529,20958531,T,TTG,2
NC_037347.1,NC_032669.1,19507437,21009439,21009443,T,TTCTA,4
NC_037347.1,NC_032669.1,19512778,21014785,21014787,t,taa,2
NC_037347.1,NC_032669.1,19544575,21047011,21047012,c,ct,1
NC_037347.1,NC_032669.1,19646992,21149435,21149437,C,CAT,2
NC_037347.1,NC_032669.1,19721096,21228570,21228571,g,ga,1
NC_037347.1,NC_032669.1,19846369,21353851,21353852,C,CM,1
NC_037347.1,NC_032669.1,20508344,22020662,22020664,c,ctg,2
NC_037347.1,NC_032669.1,20835413,22398170,22398171,c,ca,1
NC_037347.1,NC_032669.1,21505175,23075476,23075477,G,GA,1
NC_037347.1,NC_032669.1,21636600,23239286,23239287,g,gt,1
NC_037347.1,NC_032669.1,21978167,23584883,23584887,a,atcac,4
NC_037347.1,NC_032669.1,22740982,24353085,24353086,t,tc,1
NC_037347.1,NC_032669.1,22770107,24359344,24359347,C,CAAA,3
NC_037347.1,NC_032669.1,22795043,24384283,24384284,A,AC,1
NC_037347.1,NC_032669.1,22805592,24394834,24394835,t,tg,1
NC_037347.1,NC_032669.1,22880268,24469611,24469612,C,CG,1
NC_037347.1,NC_032669.1,23107767,24709967,24709968,T,TY,1
NC_037347.1,NC_032669.1,23695953,25300042,25300043,C,CM,1
NC_037347.1,NC_032669.1,23942372,25599907,25599908,g,ga,1
NC_037347.1,NC_032669.1,24005612,25663038,25663039,a,at,1
NC_037347.1,NC_032669.1,24340568,26003029,26003030,C,CT,1
NC_037347.1,NC_032669.1,24365625,26028087,26028088,t,tc,1
NC_037347.1,NC_032669.1,24404589,26067052,26067053,A,AC,1
NC_037347.1,NC_032669.1,24454904,26122770,26122776,a,aaataat,6
NC_037347.1,NC_032669.1,24479111,26146993,26146994,C,CG,1
NC_037347.1,NC_032669.1,24538421,26205475,26205476,a,at,1
NC_037347.1,NC_032669.1,24596460,26265563,26265577,g,gtgcGATNNNNNNNN,14
NC_037347.1,NC_032669.1,24817557,26513538,26513549,t,tgttgacctctG,11
NC_037347.1,NC_032669.1,24821288,26517281,26517282,C,CA,1
NC_037347.1,NC_032669.1,24830104,26526097,26526098,t,tN,1
NC_037347.1,NC_032669.1,25030235,26757182,26757183,G,GA,1
NC_037347.1,NC_032669.1,25030250,26757198,26757199,G,GA,1
NC_037347.1,NC_032669.1,25030306,26757255,26757256,T,TA,1
NC_037347.1,NC_032669.1,25030315,26757265,26757266,T,TA,1
NC_037347.1,NC_032669.1,25099610,26826560,26826561,C,CG,1
NC_037347.1,NC_032669.1,25676593,27395903,27395905,t,tNN,2
NC_037347.1,NC_032669.1,26133277,27861822,27861823,g,ga,1
NC_037347.1,NC_032669.1,26264893,27991938,27991939,G,GA,1
NC_037347.1,NC_032669.1,26585950,28325524,28325526,a,aNN,2
NC_037347.1,NC_032669.1,26631696,28371175,28371177,a,aNN,2
NC_037347.1,NC_032669.1,27204064,28926357,28926358,T,TA,1
NC_037347.1,NC_032669.1,27314666,29039836,29039837,t,ta,1
NC_037347.1,NC_032669.1,27325310,29050483,29050484,a,ag,1
NC_037347.1,NC_032669.1,27357852,29082997,29082998,c,ct,1
NC_037347.1,NC_032669.1,27422056,29147109,29147110,T,TA,1
NC_037347.1,NC_032669.1,27449834,29174830,29174837,c,ccgatggg,7
NC_037347.1,NC_032669.1,27629926,29354642,29354643,g,gt,1
NC_037347.1,NC_032669.1,28081585,29860658,29860659,t,tc,1
NC_037347.1,NC_032669.1,28173055,29952307,29952308,g,gc,1
NC_037347.1,NC_032669.1,28208801,29988853,29988854,g,ga,1
NC_037347.1,NC_032669.1,28269049,30049100,30049101,A,AT,1
NC_037347.1,NC_032669.1,28272741,30052794,30052803,T,TGCCCAAAAG,9
NC_037347.1,NC_032669.1,28483529,30264168,30264169,T,TA,1
NC_037347.1,NC_032669.1,28483571,30264211,30264213,C,CCA,2
NC_037347.1,NC_032669.1,28614603,30395137,30395138,A,AT,1
NC_037347.1,NC_032669.1,28786595,30567345,30567346,c,ca,1
NC_037347.1,NC_032669.1,28794394,30575145,30575147,A,AAG,2
NC_037347.1,NC_032669.1,28811962,30592715,30592719,t,tNNNN,4
NC_037347.1,NC_032669.1,28820821,30601579,30601581,g,gtt,2
NC_037347.1,NC_032669.1,28833572,30614332,30614334,T,TTA,2
NC_037347.1,NC_032669.1,28910945,30754139,30754140,g,ga,1
NC_037347.1,NC_032669.1,28910974,30754169,30754170,t,ta,1
NC_037347.1,NC_032669.1,28911258,30754454,30754455,t,ta,1
NC_037347.1,NC_032669.1,28944280,30787506,30787507,T,TG,1
NC_037347.1,NC_032669.1,28968121,30811350,30811351,T,TA,1
NC_037347.1,NC_032669.1,28976990,30820215,30820217,t,tcc,2
NC_037347.1,NC_032669.1,29012569,30855799,30855800,c,ca,1
NC_037347.1,NC_032669.1,29085496,30929151,30929152,C,CY,1
NC_037347.1,NC_032669.1,29085888,30929544,30929545,a,at,1
NC_037347.1,NC_032669.1,29111872,30955537,30955538,G,GC,1
NC_037347.1,NC_032669.1,29175098,31018763,31018770,T,TTACTTTA,7
NC_037347.1,NC_032669.1,29176282,31019961,31019966,T,TGAATG,5
NC_037347.1,NC_032669.1,29191603,31035309,31035310,T,TC,1
NC_037347.1,NC_032669.1,29199928,31043649,31043651,t,ttN,2
NC_037347.1,NC_032669.1,29200213,31043936,31043937,C,CY,1
NC_037347.1,NC_032669.1,29227511,31071247,31071251,T,TACTC,4
NC_037347.1,NC_032669.1,29240501,31084244,31084247,C,CTCA,3
NC_037347.1,NC_032669.1,29265871,31109633,31109634,A,AC,1
NC_037347.1,NC_032669.1,29267154,31110917,31110923,T,TGTCTGA,6
NC_037347.1,NC_032669.1,29271422,31115198,31115199,A,AR,1
NC_037347.1,NC_032669.1,29272002,31115781,31115782,A,AT,1
NC_037347.1,NC_032669.1,29276796,31120568,31120570,T,TTA,2
NC_037347.1,NC_032669.1,29277066,31120840,31120842,c,caa,2
NC_037347.1,NC_032669.1,29277307,31121083,31121085,C,CTT,2
NC_037347.1,NC_032669.1,29293222,31137005,31137028,C,CTCTMTTTCATCGACTCTCTTTCM,23
NC_037347.1,NC_032669.1,29299569,31143385,31143386,T,TC,1
NC_037347.1,NC_032669.1,29327008,31170823,31170833,g,gacttcacttc,10
NC_037347.1,NC_032669.1,29368034,31211895,31211897,C,CTT,2
NC_037347.1,NC_032669.1,29381927,31225859,31225860,a,at,1
NC_037347.1,NC_032669.1,29387689,31231624,31231628,a,actcg,4
NC_037347.1,NC_032669.1,29423799,31267980,31267982,g,gta,2
NC_037347.1,NC_032669.1,29448486,31292668,31292670,A,ACT,2
NC_037347.1,NC_032669.1,29448488,31292672,31292674,C,CTT,2
NC_037347.1,NC_032669.1,29462761,31306942,31306943,t,tg,1
NC_037347.1,NC_032669.1,29467437,31311620,31311624,C,CAAGT,4
NC_037347.1,NC_032669.1,29566566,31410352,31410357,C,CCAGTT,5
NC_037347.1,NC_032669.1,29648627,31532320,31532324,T,TTGAC,4
NC_037347.1,NC_032669.1,29669886,31553584,31553585,A,AW,1
NC_037347.1,NC_032669.1,29790032,31745655,31745656,c,ct,1
NC_037347.1,NC_032669.1,29794341,31750056,31750057,a,ac,1
NC_037347.1,NC_032669.1,29812432,31677581,31677583,C,CAA,2
NC_037347.1,NC_032669.1,29817982,31683133,31683134,C,CG,1
NC_037347.1,NC_032669.1,29821350,31686501,31686502,G,GA,1
NC_037347.1,NC_032669.1,29827962,31693141,31693142,A,AC,1
NC_037347.1,NC_032669.1,29827965,31693145,31693146,G,GA,1
NC_037347.1,NC_032669.1,29835111,31701592,31701593,t,ta,1
NC_037347.1,NC_032669.1,29934140,31832714,31832715,t,ta,1
NC_037347.1,NC_032669.1,29952503,31851077,31851078,a,aN,1
NC_037347.1,NC_032669.1,29966517,31865086,31865087,t,ta,1
NC_037347.1,NC_032669.1,29988949,31887517,31887518,t,ta,1
NC_037347.1,NC_032669.1,29990911,31889479,31889480,T,TA,1
NC_037347.1,NC_032669.1,29995551,31894119,31894120,T,TA,1
NC_037347.1,NC_032669.1,29995555,31894124,31894127,G,GAAA,3
NC_037347.1,NC_032669.1,29996450,31895022,31895023,c,ca,1
NC_037347.1,NC_032669.1,29996951,31895524,31895525,T,TW,1
NC_037347.1,NC_032669.1,30043583,31942160,31942161,c,ca,1
NC_037347.1,NC_032669.1,30045297,31943880,31943881,T,TG,1
NC_037347.1,NC_032669.1,30164773,32063865,32063867,t,taa,2
NC_037347.1,NC_032669.1,30167938,32067032,32067033,g,gt,1
NC_037347.1,NC_032669.1,30207854,32106965,32106969,t,taaac,4
NC_037347.1,NC_032669.1,30225615,32124735,32124742,g,gtgcgtgt,7
NC_037347.1,NC_032669.1,30231076,32130204,32130206,A,ACT,2
NC_037347.1,NC_032669.1,30238157,32138539,32138541,a,act,2
NC_037347.1,NC_032669.1,30257778,32156554,32156555,T,TC,1
NC_037347.1,NC_032669.1,30312589,32211258,32211260,C,CAA,2
NC_037347.1,NC_032669.1,30460043,32362914,32362916,c,caa,2
NC_037347.1,NC_032669.1,30481583,32384461,32384468,t,tagaatgg,7
NC_037347.1,NC_032669.1,30766164,32716934,32716935,g,gt,1
NC_037347.1,NC_032669.1,30982759,32931245,32931246,t,tg,1
NC_037347.1,NC_032669.1,31046280,32994715,32994716,a,at,1
NC_037347.1,NC_032669.1,31058388,33006690,33006691,A,AT,1
NC_037347.1,NC_032669.1,31058398,33006701,33006702,C,CA,1
NC_037347.1,NC_032669.1,31060579,33008884,33008885,t,tc,1
NC_037347.1,NC_032669.1,31368412,33364578,33364579,t,tg,1
NC_037347.1,NC_032669.1,31419159,33415390,33415391,T,TA,1
NC_037347.1,NC_032669.1,31419168,33415400,33415401,G,GA,1
NC_037347.1,NC_032669.1,31419789,33416023,33416024,A,AC,1
NC_037347.1,NC_032669.1,31440427,33436692,33436693,g,gt,1
NC_037347.1,NC_032669.1,31641681,33671774,33671789,T,TCCTTGTATTGNNNNN,15
NC_037347.1,NC_032669.1,31671279,33701386,33701387,T,TC,1
NC_037347.1,NC_032669.1,31822973,33853368,33853369,g,gc,1
NC_037347.1,NC_032669.1,32378100,34410572,34410573,G,GC,1
NC_037347.1,NC_032669.1,32408015,34441402,34441403,t,ta,1
NC_037347.1,NC_032669.1,32446217,34479607,34479608,c,ct,1
NC_037347.1,NC_032669.1,32527921,34561424,34561426,g,gaa,2
NC_037347.1,NC_032669.1,32527921,34735509,34735511,g,gaa,2
NC_037347.1,NC_032669.1,32711208,34833492,34833494,t,tNN,2
NC_037347.1,NC_032669.1,32812445,34934753,34934754,g,gc,1
NC_037347.1,NC_032669.1,32916154,35038467,35038469,t,tNN,2
NC_037347.1,NC_032669.1,32990177,35112517,35112518,t,tc,1
NC_037347.1,NC_032669.1,32990476,35112817,35112818,a,ag,1
NC_037347.1,NC_032669.1,32991195,35113537,35113538,c,cg,1
NC_037347.1,NC_032669.1,33079505,35207779,35207781,t,tag,2
NC_037347.1,NC_032669.1,33109875,35240102,35240103,a,aN,1
NC_037347.1,NC_032669.1,33111584,35241812,35241813,t,tN,1
NC_037347.1,NC_032669.1,33113224,35243453,35243454,t,ta,1
NC_037347.1,NC_032669.1,33113268,35243498,35243500,t,tgg,2
NC_037347.1,NC_032669.1,33162867,35292698,35292699,t,tc,1
NC_037347.1,NC_032669.1,33222715,35359065,35359066,T,TA,1
NC_037347.1,NC_032669.1,33222753,35359104,35359105,T,TA,1
NC_037347.1,NC_032669.1,33250494,35386847,35386848,t,ta,1
NC_037347.1,NC_032669.1,33294622,35430935,35430937,A,AAT,2
NC_037347.1,NC_032669.1,33303464,35440343,35440351,T,TTGTATAGY,8
NC_037347.1,NC_032669.1,33341326,35478218,35478219,G,GC,1
NC_037347.1,NC_032669.1,33375014,35511393,35511394,G,GR,1
NC_037347.1,NC_032669.1,33380302,35516683,35516684,t,tg,1
NC_037347.1,NC_032669.1,33384104,35520513,35520514,C,CT,1
NC_037347.1,NC_032669.1,33410243,35546644,35546645,c,ct,1
NC_037347.1,NC_032669.1,33410858,35547266,35547268,g,gtc,2
NC_037347.1,NC_032669.1,33410937,35547347,35547349,t,tcg,2
NC_037347.1,NC_032669.1,33431628,35567944,35567945,C,CA,1
NC_037347.1,NC_032669.1,33493675,35630001,35630002,g,ga,1
NC_037347.1,NC_032669.1,33517481,35653803,35653826,t,tagccactagccttAGTGGCCNNN,23
NC_037347.1,NC_032669.1,33533459,35669821,35669822,t,tc,1
NC_037347.1,NC_032669.1,33675665,35823312,35823313,C,CT,1
NC_037347.1,NC_032669.1,33728116,35898779,35898780,A,AT,1
NC_037347.1,NC_032669.1,33749375,35919967,35919973,C,CTGTTAG,6
NC_037347.1,NC_032669.1,33749860,35920458,35920461,a,aaat,3
NC_037347.1,NC_032669.1,33750154,35920751,35920752,C,CT,1
NC_037347.1,NC_032669.1,33750170,35920768,35920769,A,AC,1
NC_037347.1,NC_032669.1,33750510,35921109,35921110,a,aC,1
NC_037347.1,NC_032669.1,33773574,35944244,35944245,a,ac,1
NC_037347.1,NC_032669.1,33899236,36070430,36070431,t,tW,1
NC_037347.1,NC_032669.1,33911362,36082272,36082276,a,aaaat,4
NC_037347.1,NC_032669.1,33959457,36130042,36130043,g,ga,1
NC_037347.1,NC_032669.1,34051296,36220426,36220427,T,TC,1
NC_037347.1,NC_032669.1,34056530,36225667,36225674,G,GCAGCTCA,7
NC_037347.1,NC_032669.1,34070706,36239841,36239843,T,TTC,2
NC_037347.1,NC_032669.1,34141087,36310239,36310240,T,TG,1
NC_037347.1,NC_032669.1,34184055,36353538,36353551,A,ANNNNNNNNNNNNN,13
NC_037347.1,NC_032669.1,34206451,36375731,36375732,c,ca,1
NC_037347.1,NC_032669.1,34239572,36408648,36408649,t,ta,1
NC_037347.1,NC_032669.1,34248206,36417285,36417286,g,gc,1
NC_037347.1,NC_032669.1,34328123,36497323,36497325,T,TTC,2
NC_037347.1,NC_032669.1,34328130,36497332,36497336,t,ttaaa,4
NC_037347.1,NC_032669.1,34330903,36500206,36500207,A,AW,1
NC_037347.1,NC_032669.1,34336084,36505373,36505374,G,GT,1
NC_037347.1,NC_032669.1,34336939,36506229,36506230,T,TK,1
NC_037347.1,NC_032669.1,34337680,36506968,36506969,C,CY,1
NC_037347.1,NC_032669.1,34339400,36508724,36508727,G,GACA,3
NC_037347.1,NC_032669.1,34358787,36599645,36599646,t,tg,1
NC_037347.1,NC_032669.1,34367671,36610014,36610015,c,ct,1
NC_037347.1,NC_032669.1,34375321,36617848,36617849,t,ta,1
NC_037347.1,NC_032669.1,34375331,36617859,36617860,a,at,1
NC_037347.1,NC_032669.1,34377509,36620006,36620009,c,caaa,3
NC_037347.1,NC_032669.1,34382676,36589130,36589136,a,aNNNNNN,6
NC_037347.1,NC_032669.1,34401006,36641200,36641201,a,at,1
NC_037347.1,NC_032669.1,34414459,36592225,36592227,c,caa,2
NC_037347.1,NC_032669.1,34422279,36655970,36655971,T,TW,1
NC_037347.1,NC_032669.1,34451246,36684898,36684899,c,ct,1
NC_037347.1,NC_032669.1,34483252,36716995,36716998,T,TATC,3
NC_037347.1,NC_032669.1,34488032,36721777,36721780,G,GTAA,3
NC_037347.1,NC_032669.1,34575531,36765984,36765985,t,ta,1
NC_037347.1,NC_032669.1,34694998,36885535,36885536,G,GA,1
NC_037347.1,NC_032669.1,34695190,36885728,36885729,a,ag,1
NC_037347.1,NC_032669.1,34757155,36916559,36916560,g,gc,1
NC_037347.1,NC_032669.1,34760520,36920000,36920001,T,TG,1
NC_037347.1,NC_032669.1,34767977,36927441,36927443,t,tta,2
NC_037347.1,NC_032669.1,34769086,36928551,36928552,A,AG,1
NC_037347.1,NC_032669.1,34776457,36935928,36935929,G,GT,1
NC_037347.1,NC_032669.1,34799865,36958780,36958783,A,ATTG,3
NC_037347.1,NC_032669.1,34805986,36964905,36964908,c,ccaa,3
NC_037347.1,NC_032669.1,34888079,37110518,37110521,A,AAAG,3
NC_037347.1,NC_032669.1,34906238,37128885,37128886,g,gc,1
NC_037347.1,NC_032669.1,34909644,37132294,37132295,a,at,1
NC_037347.1,NC_032669.1,34912550,37135202,37135203,G,GA,1
NC_037347.1,NC_032669.1,34929843,37152104,37152105,t,tg,1
NC_037347.1,NC_032669.1,34930282,37152454,37152455,g,gc,1
NC_037347.1,NC_032669.1,34930331,37152504,37152505,g,ga,1
NC_037347.1,NC_032669.1,34930600,37152721,37152722,a,ac,1
NC_037347.1,NC_032669.1,34982944,37205073,37205074,t,ta,1
NC_037347.1,NC_032669.1,34983662,37205792,37205796,t,taaaa,4
NC_037347.1,NC_032669.1,35104136,37352348,37352349,A,AG,1
NC_037347.1,NC_032669.1,35115085,37363301,37363302,g,gt,1
NC_037347.1,NC_032669.1,35116220,37364437,37364438,A,AC,1
NC_037347.1,NC_032669.1,35305366,37554008,37554012,c,catat,4
NC_037347.1,NC_032669.1,35339069,37587712,37587720,A,ACAAATTCC,8
NC_037347.1,NC_032669.1,35397131,37645559,37645560,T,TK,1
NC_037347.1,NC_032669.1,35438205,37686485,37686558,g,gtcggtgatgccatccagcctttaGCGAGGCGGAAACAACAAGNNNNNNNNNNNNNNNNGTGTGCAGTGCCata,73
NC_037347.1,NC_032669.1,35490512,37738865,37738866,A,AG,1
NC_037347.1,NC_032669.1,35506644,37754876,37754877,a,at,1
NC_037347.1,NC_032669.1,35521514,37769231,37769232,G,GC,1
NC_037347.1,NC_032669.1,35540297,37787445,37787446,A,AT,1
NC_037347.1,NC_032669.1,35559247,37806409,37806410,a,ac,1
NC_037347.1,NC_032669.1,35565249,37812414,37812415,t,tg,1
NC_037347.1,NC_032669.1,35582783,37830004,37830005,c,ct,1
NC_037347.1,NC_032669.1,35609119,37856377,37856385,A,AGCCATGAT,8
NC_037347.1,NC_032669.1,35690606,37937869,37937878,g,gtatgagtgt,9
NC_037347.1,NC_032669.1,35734918,37982199,37982201,A,AAG,2
NC_037347.1,NC_032669.1,35743378,37990662,37990664,A,AAG,2
NC_037347.1,NC_032669.1,35814975,38062256,38062257,T,TA,1
NC_037347.1,NC_032669.1,35828911,38076195,38076205,t,tgactttctgc,10
NC_037347.1,NC_032669.1,35831362,38078657,38078673,C,CTGGGTTATGCCTTTTA,16
NC_037347.1,NC_032669.1,35831948,38079259,38079263,A,AAATT,4
NC_037347.1,NC_032669.1,35846183,38093500,38093501,T,TY,1
NC_037347.1,NC_032669.1,35876604,38123943,38123944,C,CG,1
NC_037347.1,NC_032669.1,35909945,38158123,38158125,T,TCA,2
NC_037347.1,NC_032669.1,35948222,38196416,38196417,c,cg,1
NC_037347.1,NC_032669.1,35973686,38221847,38221848,T,TC,1
NC_037347.1,NC_032669.1,36054529,38303338,38303340,T,TTC,2
NC_037347.1,NC_032669.1,36079073,38327863,38327864,T,TA,1
NC_037347.1,NC_032669.1,36110942,38359151,38359152,C,CA,1
NC_037347.1,NC_032669.1,36121357,38369568,38369582,G,GTCTTATATCCTCWS,14
NC_037347.1,NC_032669.1,36122924,38371298,38371301,C,CTAM,3
NC_037347.1,NC_032669.1,36123850,38372227,38372232,c,cccaaa,5
NC_037347.1,NC_032669.1,36163064,38411448,38411449,T,TY,1
NC_037347.1,NC_032669.1,36172866,38421252,38421253,t,ta,1
NC_037347.1,NC_032669.1,36291440,38539836,38539837,G,GA,1
NC_037347.1,NC_032669.1,36293476,38541872,38541875,C,CTTG,3
NC_037347.1,NC_032669.1,36306765,38555198,38555199,G,GR,1
NC_037347.1,NC_032669.1,36311303,38559749,38559750,G,GR,1
NC_037347.1,NC_032669.1,36326219,38594580,38594581,g,ga,1
NC_037347.1,NC_032669.1,36373604,38620953,38620961,C,CTGAAACMT,8
NC_037347.1,NC_032669.1,36684859,38930319,38930321,t,tgg,2
NC_037347.1,NC_032669.1,36746391,38993539,38993540,C,CA,1
NC_037347.1,NC_032669.1,36861315,39108922,39108923,a,ac,1
NC_037347.1,NC_032669.1,36888073,39135683,39135692,g,gaaacagtgc,9
NC_037347.1,NC_032669.1,36889035,39136654,39136656,c,caY,2
NC_037347.1,NC_032669.1,36893372,39141021,39141023,G,GAA,2
NC_037347.1,NC_032669.1,36946231,39193880,39193881,T,TA,1
NC_037347.1,NC_032669.1,36949348,39197000,39197001,C,CA,1
NC_037347.1,NC_032669.1,36949379,39197033,39197034,C,CA,1
NC_037347.1,NC_032669.1,36949407,39197062,39197063,G,GT,1
NC_037347.1,NC_032669.1,36949432,39197088,39197089,C,CA,1
NC_037347.1,NC_032669.1,37017968,39265613,39265614,A,AC,1
NC_037347.1,NC_032669.1,37023395,39271041,39271042,C,CT,1
NC_037347.1,NC_032669.1,37041417,39288717,39288719,a,aag,2
NC_037347.1,NC_032669.1,37041592,39288894,39288897,c,cagg,3
NC_037347.1,NC_032669.1,37115692,39363014,39363016,c,cgg,2
NC_037347.1,NC_032669.1,37116407,39363731,39363761,t,tcctctttcaccttcatcaagaggcttttca,30
NC_037347.1,NC_032669.1,37121220,39368574,39368575,t,tc,1
NC_037347.1,NC_032669.1,37129677,39377222,39377223,T,TW,1
NC_037347.1,NC_032669.1,37134034,39381582,39381583,a,ag,1
NC_037347.1,NC_032669.1,37136678,39384227,39384228,c,cg,1
NC_037347.1,NC_032669.1,37136849,39384398,39384401,A,ATGG,3
NC_037347.1,NC_032669.1,37222113,39471130,39471131,a,ac,1
NC_037347.1,NC_032669.1,37246035,39494908,39494910,t,taa,2
NC_037347.1,NC_032669.1,37253650,39502480,39502483,G,GCTA,3
NC_037347.1,NC_032669.1,37274948,39523781,39523782,C,CT,1
NC_037347.1,NC_032669.1,37313748,39564277,39564278,T,TW,1
NC_037347.1,NC_032669.1,37352574,39606164,39606170,C,CAAACTT,6
NC_037347.1,NC_032669.1,37362161,39616128,39616129,A,AG,1
NC_037347.1,NC_032669.1,37393511,39647461,39647462,T,TA,1
NC_037347.1,NC_032669.1,37400674,39654644,39654645,g,ga,1
NC_037347.1,NC_032669.1,37407114,39660529,39660533,T,TCTTC,4
NC_037347.1,NC_032669.1,37407192,39660611,39660619,a,accaggctc,8
NC_037347.1,NC_032669.1,37430077,39687929,39687930,T,TC,1
NC_037347.1,NC_032669.1,37430746,39688601,39688602,c,ct,1
NC_037347.1,NC_032669.1,37433348,39691206,39691207,C,CA,1
NC_037347.1,NC_032669.1,37554150,39812028,39812029,a,at,1
NC_037347.1,NC_032669.1,37763346,40022020,40022021,a,ag,1
NC_037347.1,NC_032669.1,37815073,40074113,40074114,t,ta,1
NC_037347.1,NC_032669.1,37836746,40095784,40095785,T,TW,1
NC_037347.1,NC_032669.1,37867114,40126155,40126156,A,AR,1
NC_037347.1,NC_032669.1,37882070,40141119,40141120,c,ct,1
NC_037347.1,NC_032669.1,37903687,40162836,40162838,c,ctg,2
NC_037347.1,NC_032669.1,37905128,40164279,40164280,T,TY,1
NC_037347.1,NC_032669.1,37906843,40165994,40165995,C,CT,1
NC_037347.1,NC_032669.1,37913368,40172522,40172523,T,TA,1
NC_037347.1,NC_032669.1,37921053,40180026,40180029,T,TACA,3
NC_037347.1,NC_032669.1,37925997,40184967,40184968,G,GK,1
NC_037347.1,NC_032669.1,37927747,40186717,40186718,A,AY,1
NC_037347.1,NC_032669.1,37968463,40229855,40229856,T,TK,1
NC_037347.1,NC_032669.1,38079397,40340013,40340015,T,TGC,2
NC_037347.1,NC_032669.1,38079399,40340017,40340018,T,TC,1
NC_037347.1,NC_032669.1,38095251,40355873,40355875,C,CTG,2
NC_037347.1,NC_032669.1,38109391,40370026,40370027,A,AM,1
NC_037347.1,NC_032669.1,38161709,40422349,40422350,G,GS,1
NC_037347.1,NC_032669.1,38244824,40509828,40509830,c,cca,2
NC_037347.1,NC_032669.1,38250793,40515792,40515805,T,TCTTTTCAAATTTC,13
NC_037347.1,NC_032669.1,38251657,40516669,40516677,g,gTCAGCAGA,8
NC_037347.1,NC_032669.1,38252178,40517212,40517213,T,TC,1
NC_037347.1,NC_032669.1,38253078,40518113,40518114,a,ag,1
NC_037347.1,NC_032669.1,38253080,40518116,40518117,t,ta,1
NC_037347.1,NC_032669.1,38261353,40526383,40526389,a,aNNNNNN,6
NC_037347.1,NC_032669.1,38283145,40554963,40554964,g,ga,1
NC_037347.1,NC_032669.1,38283181,40555000,40555001,t,tc,1
NC_037347.1,NC_032669.1,38285889,40557712,40557713,c,ca,1
NC_037347.1,NC_032669.1,38289570,40561394,40561396,t,tNN,2
NC_037347.1,NC_032669.1,38329452,40603415,40603417,a,aat,2
NC_037347.1,NC_032669.1,38385074,40660382,40660383,T,TK,1
NC_037347.1,NC_032669.1,38464231,40738397,40738398,g,gt,1
NC_037347.1,NC_032669.1,38473256,40747426,40747431,g,ggtttt,5
NC_037347.1,NC_032669.1,38529311,40815407,40815410,C,CAAT,3
NC_037347.1,NC_032669.1,38548994,40835092,40835113,T,TNNNNNNNNNNNNNNNNNNNNN,21
NC_037347.1,NC_032669.1,38633961,40920830,40920831,c,ct,1
NC_037347.1,NC_032669.1,38655965,40942843,40942844,t,ta,1
NC_037347.1,NC_032669.1,38660329,40947198,40947199,t,ta,1
NC_037347.1,NC_032669.1,38669701,40956573,40956574,c,ct,1
NC_037347.1,NC_032669.1,38699035,40985892,40985893,g,gc,1
NC_037347.1,NC_032669.1,38699352,40986210,40986218,a,agtttcttt,8
NC_037347.1,NC_032669.1,38699365,40986231,40986232,c,ct,1
NC_037347.1,NC_032669.1,38703536,40990404,40990405,C,CA,1
NC_037347.1,NC_032669.1,38738330,41025227,41025228,t,ta,1
NC_037347.1,NC_032669.1,38783639,41070546,41070549,T,TCTC,3
NC_037347.1,NC_032669.1,38801902,41088818,41088819,A,AG,1
NC_037347.1,NC_032669.1,38813164,41148571,41148575,t,tatag,4
NC_037347.1,NC_032669.1,38819588,41106512,41106513,G,GC,1
NC_037347.1,NC_032669.1,38819588,41155001,41155002,G,GC,1
NC_037347.1,NC_032669.1,38832064,41167497,41167499,t,ttc,2
NC_037347.1,NC_032669.1,38840581,41176010,41176027,A,ACCTCTTGTAGGTATAGG,17
NC_037347.1,NC_032669.1,38862859,41198294,41198295,T,TG,1
NC_037347.1,NC_032669.1,38864758,41200195,41200198,A,AAGT,3
NC_037347.1,NC_032669.1,38960644,41357828,41357829,a,ag,1
NC_037347.1,NC_032669.1,38960660,41357845,41357846,a,ag,1
NC_037347.1,NC_032669.1,39058012,41455250,41455252,t,tgg,2
NC_037347.1,NC_032669.1,39210024,41607276,41607277,A,AT,1
NC_037347.1,NC_032669.1,39210074,41607327,41607333,A,AAGCTCT,6
NC_037347.1,NC_032669.1,39211489,41608748,41608749,G,GY,1
NC_037347.1,NC_032669.1,39229219,41626563,41626564,T,TC,1
NC_037347.1,NC_032669.1,39230161,41627506,41627509,C,CATT,3
NC_037347.1,NC_032669.1,39233701,41631048,41631051,C,CTTG,3
NC_037347.1,NC_032669.1,39236718,41634069,41634070,t,tg,1
NC_037347.1,NC_032669.1,39577887,42052376,42052377,c,ct,1
NC_037347.1,NC_032669.1,39583811,42058299,42058311,a,acagtAGGTCCTG,12
NC_037347.1,NC_032669.1,39611588,42086068,42086072,G,GTAGA,4
NC_037347.1,NC_032669.1,39613650,42088134,42088135,T,TC,1
NC_037347.1,NC_032669.1,39616125,42090610,42090611,a,ac,1
NC_037347.1,NC_032669.1,39622603,42097120,42097122,G,GGA,2
NC_037347.1,NC_032669.1,39623854,42098388,42098390,t,tta,2
NC_037347.1,NC_032669.1,39625395,42099465,42099473,G,GGGAAAAAA,8
NC_037347.1,NC_032669.1,39627073,42101155,42101156,C,CM,1
NC_037347.1,NC_032669.1,39628387,42102471,42102473,C,CCA,2
NC_037347.1,NC_032669.1,39678317,42156510,42156511,t,tg,1
NC_037347.1,NC_032669.1,39693191,42171398,42171410,t,tagcagcagcagc,12
NC_037347.1,NC_032669.1,39698723,42176942,42176943,t,tY,1
NC_037347.1,NC_032669.1,39713289,42191519,42191521,c,cat,2
NC_037347.1,NC_032669.1,39795268,42273521,42273524,c,cagg,3
NC_037347.1,NC_032669.1,39808765,42287622,42287623,t,tc,1
NC_037347.1,NC_032669.1,39810377,42289235,42289236,T,TC,1
NC_037347.1,NC_032669.1,39835555,42314442,42314443,C,CY,1
NC_037347.1,NC_032669.1,39840090,42318976,42318977,A,AY,1
NC_037347.1,NC_032669.1,39842509,42321403,42321404,C,CY,1
NC_037347.1,NC_032669.1,39843377,42322272,42322278,c,cttcact,6
NC_037347.1,NC_032669.1,39849717,42328642,42328643,G,GT,1
NC_037347.1,NC_032669.1,39854438,42333111,42333112,g,ga,1
NC_037347.1,NC_032669.1,39863363,42342177,42342178,A,AT,1
NC_037347.1,NC_032669.1,39966813,42447286,42447287,G,GT,1
NC_037347.1,NC_032669.1,39993930,42474406,42474407,A,AC,1
NC_037347.1,NC_032669.1,40110700,42591178,42591179,C,CG,1
NC_037347.1,NC_032669.1,40115926,42596405,42596406,G,GK,1
NC_037347.1,NC_032669.1,40136871,42617351,42617353,a,aaN,2
NC_037347.1,NC_032669.1,40172773,42653494,42653495,G,GT,1
NC_037347.1,NC_032669.1,40283358,42764962,42764963,c,cg,1
NC_037347.1,NC_032669.1,40283387,42764992,42764993,g,ga,1
NC_037347.1,NC_032669.1,40283440,42765046,42765047,t,tc,1
NC_037347.1,NC_032669.1,40414067,42895689,42895694,G,GCTTGT,5
NC_037347.1,NC_032669.1,40421535,42903162,42903163,A,AG,1
NC_037347.1,NC_032669.1,40426108,42907741,42907742,g,gN,1
NC_037347.1,NC_032669.1,40428930,42911213,42911214,A,AC,1
NC_037347.1,NC_032669.1,40429550,42911834,42911836,t,tta,2
NC_037347.1,NC_032669.1,40431932,42914219,42914221,A,AAM,2
NC_037347.1,NC_032669.1,40513814,42995985,42995987,g,gga,2
NC_037347.1,NC_032669.1,40628919,43111120,43111122,t,tcg,2
NC_037347.1,NC_032669.1,40661851,43143973,43143983,a,atgtgtgtgtg,10
NC_037347.1,NC_032669.1,40665514,43147647,43147648,a,ac,1
NC_037347.1,NC_032669.1,40665619,43147753,43147754,c,cg,1
NC_037347.1,NC_032669.1,40674687,43156822,43156824,G,GGT,2
NC_037347.1,NC_032669.1,40692728,43174874,43174875,g,ga,1
NC_037347.1,NC_032669.1,40760663,43242831,43242833,A,AAC,2
NC_037347.1,NC_032669.1,40765152,43247322,43247326,C,CCTGA,4
NC_037347.1,NC_032669.1,40797970,43280367,43280368,T,TA,1
NC_037347.1,NC_032669.1,41034273,43512905,43512907,T,TTA,2
NC_037347.1,NC_032669.1,41059909,43543804,43543807,C,CAAT,3
NC_037347.1,NC_032669.1,41060148,43544122,43544125,C,CAAT,3
NC_037347.1,NC_032669.1,41060313,43544289,43544292,C,CAAT,3
NC_037347.1,NC_032669.1,41060703,43544922,43544948,C,CAGTGTTCCTCACCATGTATCAATAGT,26
NC_037347.1,NC_032669.1,41070854,43555100,43555101,C,CG,1
NC_037347.1,NC_032669.1,41106078,43590324,43590325,C,CT,1
NC_037347.1,NC_032669.1,41108610,43592857,43592860,a,aagg,3
NC_037347.1,NC_032669.1,41208397,43692425,43692427,A,ATC,2
NC_037347.1,NC_032669.1,41624607,44141724,44141725,g,ga,1
NC_037347.1,NC_032669.1,41624641,44141759,44141760,g,ga,1
NC_037347.1,NC_032669.1,41638916,44156035,44156037,g,gca,2
NC_037347.1,NC_032669.1,41842470,44360373,44360374,A,AG,1
NC_037347.1,NC_032669.1,41974751,44493031,44493032,a,ac,1
NC_037347.1,NC_032669.1,42024757,44565910,44565911,a,ag,1
NC_037347.1,NC_032669.1,42139688,44680850,44680852,C,CCM,2
NC_037347.1,NC_032669.1,42143179,44684115,44684124,g,gggaaacagt,9
NC_037347.1,NC_032669.1,42158554,44699500,44699501,g,ga,1
NC_037347.1,NC_032669.1,42303435,44844411,44844414,A,ATTG,3
NC_037347.1,NC_032669.1,42307431,44848444,44848445,G,GA,1
NC_037347.1,NC_032669.1,42330831,44871889,44871890,T,TG,1
NC_037347.1,NC_032669.1,42331307,44872365,44872369,a,aaaNN,4
NC_037347.1,NC_032669.1,42339207,44880269,44880280,T,TGGAATTTCCTA,11
NC_037347.1,NC_032669.1,42401205,44948522,44948525,g,gtta,3
NC_037347.1,NC_032669.1,42415078,44962398,44962399,t,ta,1
NC_037347.1,NC_032669.1,42642223,45214487,45214489,c,cca,2
NC_037347.1,NC_032669.1,42720963,45294239,45294240,a,ag,1
NC_037347.1,NC_032669.1,42730068,45303345,45303346,T,TY,1
NC_037347.1,NC_032669.1,42754293,45327575,45327581,A,AAACAGT,6
NC_037347.1,NC_032669.1,42802593,45375881,45375882,t,ta,1
NC_037347.1,NC_032669.1,42804348,45377637,45377645,T,TANNNNNNN,8
NC_037347.1,NC_032669.1,42809766,45383063,45383064,g,gc,1
NC_037347.1,NC_032669.1,42819640,45393116,45393117,g,gc,1
NC_037347.1,NC_032669.1,42822427,45397927,45397928,g,ga,1
NC_037347.1,NC_032669.1,42917345,45558354,45558355,t,tc,1
NC_037347.1,NC_032669.1,42918423,45559433,45559436,C,CAGM,3
NC_037347.1,NC_032669.1,42921303,45562316,45562323,A,ACTTTGAG,7
NC_037347.1,NC_032669.1,42924351,45565373,45565374,t,tg,1
NC_037347.1,NC_032669.1,42943386,45585744,45585745,a,ag,1
NC_037347.1,NC_032669.1,43052740,45810697,45810727,A,ANNNNNNNNNNNNNNNNNNNNNNNNNNNNNN,30
NC_037347.1,NC_032669.1,43059094,45679691,45679692,t,tc,1
NC_037347.1,NC_032669.1,43083160,45722610,45722611,a,aN,1
NC_037347.1,NC_032669.1,43094066,45847838,45847856,T,TAAANNNNNNNNNNNNNNN,18
NC_037347.1,NC_032669.1,43094067,45733513,45733531,T,TACNNNNNNNNNNNNNNNN,18
NC_037347.1,NC_032669.1,43097450,45737560,45737565,g,gaaaaa,5
NC_037347.1,NC_032669.1,43107420,45747537,45747549,G,GTTGAATAAAGAA,12
NC_037347.1,NC_032669.1,43107850,45747916,45747917,C,CT,1
NC_037347.1,NC_032669.1,43179019,45933468,45933469,t,ta,1
NC_037347.1,NC_032669.1,43192248,45946612,45946613,g,ga,1
NC_037347.1,NC_032669.1,43201636,45956133,45956134,a,at,1
NC_037347.1,NC_032669.1,43219549,45974045,45974047,g,gtt,2
NC_037347.1,NC_032669.1,43219566,45974064,45974066,g,gtc,2
NC_037347.1,NC_032669.1,43222066,45976567,45976582,C,CTCAGCTCTCTTTATT,15
NC_037347.1,NC_032669.1,43235285,45989797,45989798,T,TA,1
NC_037347.1,NC_032669.1,43255628,46009682,46009683,G,GA,1
NC_037347.1,NC_032669.1,43457602,46147334,46147335,A,Ag,1
NC_037347.1,NC_032669.1,43478254,46167512,46167513,A,AG,1
NC_037347.1,NC_032669.1,43479565,46168819,46168820,a,at,1
NC_037347.1,NC_032669.1,43490179,46179446,46179447,A,AR,1
NC_037347.1,NC_032669.1,43492993,46182263,46182266,C,CAGT,3
NC_037347.1,NC_032669.1,43506834,46196117,46196118,A,AC,1
NC_037347.1,NC_032669.1,43510127,46199407,46199410,t,ttta,3
NC_037347.1,NC_032669.1,43553454,46248247,46248248,t,ta,1
NC_037347.1,NC_032669.1,43553490,46248284,46248285,a,at,1
NC_037347.1,NC_032669.1,43565096,46259893,46259895,a,att,2
NC_037347.1,NC_032669.1,43574763,46269567,46269570,G,GAGA,3
NC_037347.1,NC_032669.1,43592877,46287655,46287656,G,GK,1
NC_037347.1,NC_032669.1,43607202,46302020,46302024,g,gtata,4
NC_037347.1,NC_032669.1,43611103,46305925,46305926,g,gt,1
NC_037347.1,NC_032669.1,43629916,46324723,46324724,c,cg,1
NC_037347.1,NC_032669.1,43685834,46380819,46380822,c,cagg,3
NC_037347.1,NC_032669.1,43693661,46388648,46388649,A,AM,1
NC_037347.1,NC_032669.1,43820724,46556163,46556166,c,ccca,3
NC_037347.1,NC_032669.1,43891913,46627363,46627364,t,tc,1
NC_037347.1,NC_032669.1,44008399,46713663,46713665,c,cct,2
NC_037347.1,NC_032669.1,44013567,46718833,46718834,a,ag,1
NC_037347.1,NC_032669.1,44043621,46752160,46752162,c,caY,2
NC_037347.1,NC_032669.1,44152749,46827919,46827922,t,tttc,3
NC_037347.1,NC_032669.1,44165073,46840647,46840648,A,AW,1
NC_037347.1,NC_032669.1,44207767,46883423,46883427,T,TTGAC,4
NC_037347.1,NC_032669.1,44214175,46890020,46890021,c,ca,1
NC_037347.1,NC_032669.1,44252328,46925949,46925951,g,ggc,2
NC_037347.1,NC_032669.1,44262218,46935841,46935842,G,GC,1
NC_037347.1,NC_032669.1,44262261,46935885,46935886,A,AR,1
NC_037347.1,NC_032669.1,44262869,46936478,46936479,a,ag,1
NC_037347.1,NC_032669.1,44263564,46937174,46937176,t,taa,2
NC_037347.1,NC_032669.1,44264415,46938025,46938026,c,ct,1
NC_037347.1,NC_032669.1,44265701,46939311,46939312,G,GK,1
NC_037347.1,NC_032669.1,44266667,46940266,46940267,g,ga,1
NC_037347.1,NC_032669.1,44268426,46942022,46942023,c,ct,1
NC_037347.1,NC_032669.1,44269253,46942851,46942853,c,caa,2
NC_037347.1,NC_032669.1,44270671,46944271,46944272,a,at,1
NC_037347.1,NC_032669.1,44300797,46974590,46974591,t,ta,1
NC_037347.1,NC_032669.1,44411736,47085760,47085762,t,tca,2
NC_037347.1,NC_032669.1,44419376,47093414,47093415,a,at,1
NC_037347.1,NC_032669.1,44425023,47147137,47147138,g,ga,1
NC_037347.1,NC_032669.1,44447464,47114529,47114530,g,ga,1
NC_037347.1,NC_032669.1,44447766,47114832,47114833,A,AC,1
NC_037347.1,NC_032669.1,44469220,47140001,47140002,t,tW,1
NC_037347.1,NC_032669.1,44481513,47159933,47159938,T,TTAAAA,5
NC_037347.1,NC_032669.1,44533250,47212182,47212183,a,at,1
NC_037347.1,NC_032669.1,44549790,47229036,47229051,t,tgcgaccccatagacg,15
NC_037347.1,NC_032669.1,44569262,47248494,47248495,T,TA,1
NC_037347.1,NC_032669.1,44569435,47248668,47248670,a,atg,2
NC_037347.1,NC_032669.1,44575695,47255772,47255776,g,ggttt,4
NC_037347.1,NC_032669.1,44595433,47275510,47275515,a,actgat,5
NC_037347.1,NC_032669.1,44608431,47288523,47288524,c,ct,1
NC_037347.1,NC_032669.1,44611530,47291624,47291626,a,aNN,2
NC_037347.1,NC_032669.1,44615657,47295753,47295755,t,tNN,2
NC_037347.1,NC_032669.1,44639787,47319892,47319899,C,CNNNNNNN,7
NC_037347.1,NC_032669.1,44641796,47325927,47325928,G,GC,1
NC_037347.1,NC_032669.1,44642308,47322419,47322420,C,CA,1
NC_037347.1,NC_032669.1,44645487,47329623,47329627,g,gtttt,4
NC_037347.1,NC_032669.1,44647634,47331781,47331782,A,AT,1
NC_037347.1,NC_032669.1,44647647,47331795,47331797,C,CTA,2
NC_037347.1,NC_032669.1,44660563,47344706,47344707,g,gR,1
NC_037347.1,NC_032669.1,44670405,47354546,47354547,t,tg,1
NC_037347.1,NC_032669.1,44670451,47354593,47354602,a,aaaaaaaaac,9
NC_037347.1,NC_032669.1,44676054,47360204,47360205,A,AG,1
NC_037347.1,NC_032669.1,44678918,47363070,47363071,A,AG,1
NC_037347.1,NC_032669.1,44816428,47500784,47500789,A,ATTGTC,5
NC_037347.1,NC_032669.1,44825512,47509875,47509876,a,at,1
NC_037347.1,NC_032669.1,44833366,47517728,47517730,a,agg,2
NC_037347.1,NC_032669.1,44845754,47530115,47530117,t,tta,2
NC_037347.1,NC_032669.1,44942582,47639311,47639312,a,at,1
NC_037347.1,NC_032669.1,44944014,47640744,47640745,A,AG,1
NC_037347.1,NC_032669.1,44993316,47690045,47690049,a,aNNNN,4
NC_037347.1,NC_032669.1,44999096,47695830,47695831,a,ac,1
NC_037347.1,NC_032669.1,44999373,47696108,47696110,c,cag,2
NC_037347.1,NC_032669.1,44999390,47696127,47696128,t,tc,1
NC_037347.1,NC_032669.1,44999434,47696172,47696173,t,ta,1
NC_037347.1,NC_032669.1,45063914,47760684,47760705,A,ANNNNNNNNNNNNNNNNNNNNN,21
NC_037347.1,NC_032669.1,45085345,47782146,47782151,c,cttttt,5
NC_037347.1,NC_032669.1,45085560,47782366,47782367,T,TA,1
NC_037347.1,NC_032669.1,45086877,47783684,47783685,a,at,1
NC_037347.1,NC_032669.1,45089474,47786255,47786259,c,ctgtt,4
NC_037347.1,NC_032669.1,45126147,47789659,47789664,G,GTAACT,5
NC_037347.1,NC_032669.1,45142493,47806009,47806010,T,TG,1
NC_037347.1,NC_032669.1,45147913,47811430,47811431,c,ca,1
NC_037347.1,NC_032669.1,45187927,47851496,47851497,C,CY,1
NC_037347.1,NC_032669.1,45521647,48263723,48263724,t,tg,1
NC_037347.1,NC_032669.1,45522423,48264500,48264501,c,ct,1
NC_037347.1,NC_032669.1,45522431,48264509,48264513,c,ccatg,4
NC_037347.1,NC_032669.1,45605861,48299614,48299615,t,ta,1
NC_037347.1,NC_032669.1,45608620,48302373,48302376,c,cttt,3
NC_037347.1,NC_032669.1,45608747,48302503,48302517,C,CAGCACaaaatgaat,14
NC_037347.1,NC_032669.1,45615063,48308676,48308679,A,AAAC,3
NC_037347.1,NC_032669.1,45615422,48309057,48309058,T,TA,1
NC_037347.1,NC_032669.1,45619146,48312783,48312784,t,ta,1
NC_037347.1,NC_032669.1,45634017,48327656,48327657,t,ta,1
NC_037347.1,NC_032669.1,45639255,48332896,48332897,c,ct,1
NC_037347.1,NC_032669.1,45648053,48341697,48341698,a,at,1
NC_037347.1,NC_032669.1,45653195,48346852,48346853,A,AR,1
NC_037347.1,NC_032669.1,45664679,48358333,48358335,g,gga,2
NC_037347.1,NC_032669.1,45674938,48368603,48368604,t,tg,1
NC_037347.1,NC_032669.1,45681661,48375333,48375334,g,ga,1
NC_037347.1,NC_032669.1,45681680,48375353,48375354,a,at,1
NC_037347.1,NC_032669.1,45690625,48384299,48384300,T,TA,1
NC_037347.1,NC_032669.1,45701764,48393699,48393700,t,tc,1
NC_037347.1,NC_032669.1,45701790,48393726,48393727,a,ag,1
NC_037347.1,NC_032669.1,45703624,48395558,48395559,T,TA,1
NC_037347.1,NC_032669.1,45705935,48397869,48397870,c,ct,1
NC_037347.1,NC_032669.1,45705935,48405901,48405902,c,ct,1
NC_037347.1,NC_032669.1,45707338,48399273,48399274,g,gt,1
NC_037347.1,NC_032669.1,45707338,48407305,48407306,g,gt,1
NC_037347.1,NC_032669.1,45708460,48408428,48408429,a,ac,1
NC_037347.1,NC_032669.1,45733587,48433464,48433492,t,tgccacctgggaagcccatgccacAGAGA,28
NC_037347.1,NC_032669.1,45734628,48434522,48434525,c,cagt,3
NC_037347.1,NC_032669.1,45738185,48438080,48438082,t,ttg,2
NC_037347.1,NC_032669.1,45743484,48443394,48443396,A,AGC,2
NC_037347.1,NC_032669.1,45793515,48493861,48493862,T,TA,1
NC_037347.1,NC_032669.1,45806599,48506892,48506893,T,TC,1
NC_037347.1,NC_032669.1,45807419,48507713,48507714,G,GR,1
NC_037347.1,NC_032669.1,45819916,48519283,48519284,a,at,1
NC_037347.1,NC_032669.1,45905343,48597288,48597289,T,TA,1
NC_037347.1,NC_032669.1,45951371,48643621,48643623,t,ttg,2
NC_037347.1,NC_032669.1,45961014,48653200,48653201,c,ct,1
NC_037347.1,NC_032669.1,45968580,48662949,48662950,c,ca,1
NC_037347.1,NC_032669.1,45968725,48663095,48663097,c,cct,2
NC_037347.1,NC_032669.1,45969114,48663486,48663487,c,ct,1
NC_037347.1,NC_032669.1,45969408,48663781,48663783,t,tca,2
NC_037347.1,NC_032669.1,45969554,48663929,48663930,t,ta,1
NC_037347.1,NC_032669.1,45971564,48665942,48665954,c,cacacacacacaa,12
NC_037347.1,NC_032669.1,45971784,48666174,48666176,C,CTA,2
NC_037347.1,NC_032669.1,45972088,48666480,48666481,t,ta,1
NC_037347.1,NC_032669.1,45973826,48668217,48668218,C,CA,1
NC_037347.1,NC_032669.1,45999804,48693254,48693255,t,tc,1
NC_037347.1,NC_032669.1,45999816,48693267,48693277,t,tccccaaaccc,10
NC_037347.1,NC_032669.1,46015547,48709007,48709008,a,aM,1
NC_037347.1,NC_032669.1,46030858,48725934,48725935,t,tW,1
NC_037347.1,NC_032669.1,46032554,48727629,48727630,t,tg,1
NC_037347.1,NC_032669.1,46038678,48733753,48733755,A,ACW,2
NC_037347.1,NC_032669.1,46098304,48793284,48793286,a,aag,2
NC_037347.1,NC_032669.1,46116595,48820218,48820219,t,tN,1
NC_037347.1,NC_032669.1,46116623,48820247,48820249,t,tta,2
NC_037347.1,NC_032669.1,46191273,48894999,48895003,a,agcct,4
NC_037347.1,NC_032669.1,46217866,48921711,48921712,c,ct,1
NC_037347.1,NC_032669.1,46218105,48921951,48921955,g,gttgc,4
NC_037347.1,NC_032669.1,46246528,48951219,48951220,a,at,1
NC_037347.1,NC_032669.1,46272295,49023919,49023931,c,cactcacctagag,12
NC_037347.1,NC_032669.1,46324456,49080649,49080650,c,ct,1
NC_037347.1,NC_032669.1,46327410,49084358,49084368,C,CAGAATTTACA,10
NC_037347.1,NC_032669.1,46328053,49085013,49085014,G,GA,1
NC_037347.1,NC_032669.1,46330952,49087900,49087903,A,AAGC,3
NC_037347.1,NC_032669.1,46331304,49088255,49088259,T,TAAAG,4
NC_037347.1,NC_032669.1,46331730,49088685,49088698,A,AAGAATGTACTCTT,13
NC_037347.1,NC_032669.1,46339232,49095852,49095863,T,TGCTAAATCACA,11
NC_037347.1,NC_032669.1,46352305,49109040,49109041,T,TA,1
NC_037347.1,NC_032669.1,46382724,49139401,49139403,T,TAA,2
NC_037347.1,NC_032669.1,46413194,49169883,49169891,G,GCTTACTAA,8
NC_037347.1,NC_032669.1,46452268,49208541,49208542,C,CG,1
NC_037347.1,NC_032669.1,46457501,49213798,49213799,c,ct,1
NC_037347.1,NC_032669.1,46475076,49231381,49231382,T,TG,1
NC_037347.1,NC_032669.1,46479287,49235593,49235594,C,CT,1
NC_037347.1,NC_032669.1,46660299,49416327,49416333,A,ATACTTT,6
NC_037347.1,NC_032669.1,46676437,49432471,49432473,a,aat,2
NC_037347.1,NC_032669.1,46698065,49454098,49454100,t,tNN,2
NC_037347.1,NC_032669.1,46706344,49462371,49462373,g,gaa,2
NC_037347.1,NC_032669.1,46731426,49487330,49487331,C,CY,1
NC_037347.1,NC_032669.1,46733327,49489237,49489238,T,TC,1
NC_037347.1,NC_032669.1,46735932,49491834,49491835,C,CT,1
NC_037347.1,NC_032669.1,46739374,49495265,49495266,A,AG,1
NC_037347.1,NC_032669.1,46745009,49500905,49500925,c,cctgccaggctcctctatcca,20
NC_037347.1,NC_032669.1,46748113,49504029,49504030,t,tc,1
NC_037347.1,NC_032669.1,46750429,49506344,49506348,a,aNNNN,4
NC_037347.1,NC_032669.1,46751771,49507690,49507694,a,aaNNN,4
NC_037347.1,NC_032669.1,46794970,49550396,49550400,c,ctttt,4
NC_037347.1,NC_032669.1,46796690,49552120,49552124,a,aaNNN,4
NC_037347.1,NC_032669.1,46810409,49565849,49565850,t,tg,1
NC_037347.1,NC_032669.1,46827147,49583088,49583090,A,AAT,2
NC_037347.1,NC_032669.1,46948365,49703584,49703585,a,at,1
NC_037347.1,NC_032669.1,47047103,49802286,49802292,c,cattttt,6
NC_037347.1,NC_032669.1,47056377,49811567,49811568,g,gt,1
NC_037347.1,NC_032669.1,47062502,49817694,49817695,g,ga,1
NC_037347.1,NC_032669.1,47065115,49820306,49820311,t,tTCTTA,5
NC_037347.1,NC_032669.1,47068974,49824170,49824171,A,AM,1
NC_037347.1,NC_032669.1,47073933,49829124,49829125,t,tc,1
NC_037347.1,NC_032669.1,47075129,49830321,49830324,g,gtga,3
NC_037347.1,NC_032669.1,47134758,49889985,49889986,C,CM,1
NC_037347.1,NC_032669.1,47137232,49892453,49892454,T,TA,1
NC_037347.1,NC_032669.1,47138582,49893806,49893808,T,TGA,2
NC_037347.1,NC_032669.1,47147870,49903094,49903126,c,ctatatatatatatatatatatatatatatata,32
NC_037347.1,NC_032669.1,47148174,49903430,49903444,t,tatatatatagagag,14
NC_037347.1,NC_032669.1,47159457,49914739,49914740,t,ta,1
NC_037347.1,NC_032669.1,47330810,50085883,50085884,g,ga,1
NC_037347.1,NC_032669.1,47347034,50102270,50102272,t,taa,2
NC_037347.1,NC_032669.1,47378263,50134284,50134286,t,tag,2
NC_037347.1,NC_032669.1,47395681,50151720,50151726,t,tNNNNNN,6
NC_037347.1,NC_032669.1,47402991,50159037,50159051,c,catatatatatatat,14
NC_037347.1,NC_032669.1,47430642,50186708,50186712,C,CTAAG,4
NC_037347.1,NC_032669.1,47434770,50190849,50190850,t,tc,1
NC_037347.1,NC_032669.1,47434782,50190862,50190864,t,tta,2
NC_037347.1,NC_032669.1,47434802,50190884,50190885,a,at,1
NC_037347.1,NC_032669.1,47436396,50192479,50192484,c,ctttct,5
NC_037347.1,NC_032669.1,47436511,50192599,50192602,A,ACTT,3
NC_037347.1,NC_032669.1,47437161,50193252,50193265,c,cagggggtctggAG,13
NC_037347.1,NC_032669.1,47472373,50227334,50227335,c,ct,1
NC_037347.1,NC_032669.1,47550551,50305194,50305195,G,GT,1
NC_037347.1,NC_032669.1,47551459,50306112,50306123,g,gtctgagtgaac,11
NC_037347.1,NC_032669.1,47558011,50312997,50312999,a,aNN,2
NC_037347.1,NC_032669.1,47558191,50313179,50313180,T,TA,1
NC_037347.1,NC_032669.1,47580414,50335301,50335302,a,ac,1
NC_037347.1,NC_032669.1,47588645,50343538,50343541,t,taaa,3
NC_037347.1,NC_032669.1,47851521,50613572,50613578,a,atNNNNN,6
NC_037347.1,NC_032669.1,47861395,50623448,50623459,G,GAGGGAAGAAGA,11
NC_037347.1,NC_032669.1,47903034,50684867,50684869,a,aat,2
NC_037347.1,NC_032669.1,47914698,50696533,50696537,T,TTTGK,4
NC_037347.1,NC_032669.1,47918319,50700189,50700190,T,TC,1
NC_037347.1,NC_032669.1,47918484,50700353,50700355,c,cta,2
NC_037347.1,NC_032669.1,47919442,50701450,50701453,G,GAGA,3
NC_037347.1,NC_032669.1,47929874,50712489,50712492,C,CTCG,3
NC_037347.1,NC_032669.1,47944671,50727649,50727652,g,gttt,3
NC_037347.1,NC_032669.1,47948550,50731546,50731550,C,CAAAA,4
NC_037347.1,NC_032669.1,47950481,50733477,50733478,a,at,1
NC_037347.1,NC_032669.1,47963396,50746400,50746401,t,tN,1
NC_037347.1,NC_032669.1,47968683,50752047,50752048,a,at,1
NC_037347.1,NC_032669.1,47969419,50752802,50752803,t,ta,1
NC_037347.1,NC_032669.1,47970611,50754003,50754005,c,caa,2
NC_037347.1,NC_032669.1,47972673,50756067,50756068,t,tg,1
NC_037347.1,NC_032669.1,47984943,50768342,50768345,t,tagc,3
NC_037347.1,NC_032669.1,47986714,50770116,50770117,a,aY,1
NC_037347.1,NC_032669.1,47986742,50770145,50770147,t,ttc,2
NC_037347.1,NC_032669.1,47988465,50771871,50771874,c,ctag,3
NC_037347.1,NC_032669.1,47990820,50774229,50774231,a,act,2
NC_037347.1,NC_032669.1,48000695,50784506,50784507,G,GC,1
NC_037347.1,NC_032669.1,48024232,50808084,50808086,g,gta,2
NC_037347.1,NC_032669.1,48045921,50829773,50829774,a,ag,1
NC_037347.1,NC_032669.1,48081384,50861167,50861169,t,ttc,2
NC_037347.1,NC_032669.1,48084353,50864141,50864142,t,tc,1
NC_037347.1,NC_032669.1,48125604,50906502,50906503,t,ta,1
NC_037347.1,NC_032669.1,48127466,50908369,50908370,t,ta,1
NC_037347.1,NC_032669.1,48127481,50908385,50908386,t,tW,1
NC_037347.1,NC_032669.1,48132340,50913779,50913787,G,GAGCCCGGA,8
NC_037347.1,NC_032669.1,48136865,50918328,50918329,T,TY,1
NC_037347.1,NC_032669.1,48146272,50927736,50927737,A,AR,1
NC_037347.1,NC_032669.1,48179226,50960449,50960450,T,TW,1
NC_037347.1,NC_032669.1,48202869,50983625,50983626,t,tN,1
NC_037347.1,NC_032669.1,48285693,51065349,51065353,a,aNNNN,4
NC_037347.1,NC_032669.1,48297778,51077434,51077435,T,TC,1
NC_037347.1,NC_032669.1,48305680,51085337,51085339,t,tca,2
NC_037347.1,NC_032669.1,48305970,51085629,51085669,a,atatatatatatatatatatatatatatatatataaacatt,40
NC_037347.1,NC_032669.1,48310289,51089989,51089990,T,TC,1
NC_037347.1,NC_032669.1,48310362,51090063,51090064,t,ta,1
NC_037347.1,NC_032669.1,48362082,51115383,51115384,G,GA,1
NC_037347.1,NC_032669.1,48401907,51155102,51155105,g,gttt,3
NC_037347.1,NC_032669.1,48444159,51197391,51197392,A,AT,1
NC_037347.1,NC_032669.1,48575187,51328245,51328246,c,ct,1
NC_037347.1,NC_032669.1,48684752,51437657,51437659,t,tNN,2
NC_037347.1,NC_032669.1,48831998,51584916,51584918,a,aNN,2
NC_037347.1,NC_032669.1,48865265,51618187,51618188,a,at,1
NC_037347.1,NC_032669.1,49083520,51840357,51840358,a,at,1
NC_037347.1,NC_032669.1,49099824,51856648,51856651,t,tNNN,3
NC_037347.1,NC_032669.1,49177760,51934750,51934751,g,gc,1
NC_037347.1,NC_032669.1,49178066,51935057,51935058,g,ga,1
NC_037347.1,NC_032669.1,49184917,51941908,51941912,a,aNNNN,4
NC_037347.1,NC_032669.1,49233924,51990812,51990813,A,AG,1
NC_037347.1,NC_032669.1,49247639,52004547,52004548,t,tc,1
NC_037347.1,NC_032669.1,49258021,52014934,52014935,c,ct,1
NC_037347.1,NC_032669.1,49273927,52030841,52030842,a,ac,1
NC_037347.1,NC_032669.1,49323957,52080781,52080783,t,tNN,2
NC_037347.1,NC_032669.1,49351644,52108426,52108427,t,tc,1
NC_037347.1,NC_032669.1,49352235,52109018,52109019,T,TG,1
NC_037347.1,NC_032669.1,49353478,52110260,52110262,T,TTY,2
NC_037347.1,NC_032669.1,49353747,52110531,52110546,t,tcctccctccccgtac,15
NC_037347.1,NC_032669.1,49355420,52112225,52112226,a,aR,1
NC_037347.1,NC_032669.1,49356391,52113196,52113198,A,ACT,2
NC_037347.1,NC_032669.1,49359316,52116118,52116120,t,tta,2
NC_037347.1,NC_032669.1,49361057,52117860,52117861,C,CA,1
NC_037347.1,NC_032669.1,49363564,52120445,52120455,a,aagatgcttac,10
NC_037347.1,NC_032669.1,49364483,52121373,52121377,c,cctct,4
NC_037347.1,NC_032669.1,49368803,52125697,52125700,g,gagt,3
NC_037347.1,NC_032669.1,49370364,52127261,52127262,G,GA,1
NC_037347.1,NC_032669.1,49371921,52128819,52128881,C,CGCNNNNNNNNNNNNNNNNNNNNNNNNNNNNNNNNNNNNNNNNNNNNNNNNNNNNNNNNNNNN,62
NC_037347.1,NC_032669.1,49372277,52129237,52129238,T,TY,1
NC_037347.1,NC_032669.1,49376583,52133543,52133544,A,AC,1
NC_037347.1,NC_032669.1,49380595,52137774,52137775,T,TG,1
NC_037347.1,NC_032669.1,49380602,52137782,52137783,T,TA,1
NC_037347.1,NC_032669.1,49381090,52138271,52138272,c,cM,1
NC_037347.1,NC_032669.1,49382792,52139968,52139969,A,AC,1
NC_037347.1,NC_032669.1,49382829,52140006,52140007,t,ta,1
NC_037347.1,NC_032669.1,49382835,52140013,52140014,t,ta,1
NC_037347.1,NC_032669.1,49392028,52148813,52148814,a,at,1
NC_037347.1,NC_032669.1,49431696,52169200,52169202,c,cag,2
NC_037347.1,NC_032669.1,49438631,52246575,52246576,t,tg,1
NC_037347.1,NC_032669.1,49452732,52260729,52260730,t,tc,1
NC_037347.1,NC_032669.1,49455386,52263384,52263385,T,TA,1
NC_037347.1,NC_032669.1,49455426,52263425,52263435,C,CCAAAATCATA,10
NC_037347.1,NC_032669.1,49481038,52289016,52289020,t,tNNNN,4
NC_037347.1,NC_032669.1,49520959,52328953,52328955,a,aNN,2
NC_037347.1,NC_032669.1,49527365,52335360,52335361,T,TC,1
NC_037347.1,NC_032669.1,49535620,52343616,52343630,t,tcttcattggaagtc,14
NC_037347.1,NC_032669.1,49535639,52343649,52343655,t,tgctgag,6
NC_037347.1,NC_032669.1,49548938,52356949,52356953,a,aaaag,4
NC_037347.1,NC_032669.1,49552915,52360930,52360931,A,AK,1
NC_037347.1,NC_032669.1,49560295,52369151,52369155,A,AATCN,4
NC_037347.1,NC_032669.1,49561137,52369997,52369998,G,GK,1
NC_037347.1,NC_032669.1,49676616,52484308,52484311,t,taca,3
NC_037347.1,NC_032669.1,49676675,52484370,52484371,a,ac,1
NC_037347.1,NC_032669.1,49676754,52484450,52484451,c,ca,1
NC_037347.1,NC_032669.1,49680588,52488282,52488283,t,tg,1
NC_037347.1,NC_032669.1,49680660,52488355,52488356,c,ct,1
NC_037347.1,NC_032669.1,49695820,52503857,52503858,t,tc,1
NC_037347.1,NC_032669.1,49719035,52528401,52528402,a,ag,1
NC_037347.1,NC_032669.1,49741721,52550844,52550845,A,AG,1
NC_037347.1,NC_032669.1,49741721,52572903,52572904,A,AG,1
NC_037347.1,NC_032669.1,49743264,52552388,52552389,a,at,1
NC_037347.1,NC_032669.1,49743264,52574447,52574448,a,at,1
NC_037347.1,NC_032669.1,49743363,52552488,52552489,a,ag,1
NC_037347.1,NC_032669.1,49758195,52588821,52588835,a,atacacatatatatg,14
NC_037347.1,NC_032669.1,49761397,52592036,52592064,c,cctgacctgcctcttgagaaacctatatg,28
NC_037347.1,NC_032669.1,49763497,52594160,52594168,t,tgtatatta,8
NC_037347.1,NC_032669.1,49763502,52594173,52594174,t,ta,1
NC_037347.1,NC_032669.1,49764302,52594974,52594975,A,AG,1
NC_037347.1,NC_032669.1,49790291,52620970,52620972,a,aNN,2
NC_037347.1,NC_032669.1,49812727,52644838,52644839,t,tg,1
NC_037347.1,NC_032669.1,49847865,52679651,52679655,t,tacac,4
NC_037347.1,NC_032669.1,49880321,52711801,52711802,g,gt,1
NC_037347.1,NC_032669.1,49883848,52715339,52715340,c,ca,1
NC_037347.1,NC_032669.1,49955140,52786636,52786637,t,ta,1
NC_037347.1,NC_032669.1,49996854,52828364,52828365,c,ct,1
NC_037347.1,NC_032669.1,50067867,53135888,53135913,G,GTYgtgttcgactctttgcaaccccR,25
NC_037347.1,NC_032669.1,50071895,53139941,53139942,T,TC,1
NC_037347.1,NC_032669.1,50074179,53142227,53142229,t,taa,2
NC_037347.1,NC_032669.1,50077880,53145930,53145931,t,tc,1
NC_037347.1,NC_032669.1,50083203,53151263,53151265,G,GAA,2
NC_037347.1,NC_032669.1,50112936,53180986,53180998,t,tcatagagaGGGA,12
NC_037347.1,NC_032669.1,50114670,53182732,53182733,C,CM,1
NC_037347.1,NC_032669.1,50116764,53184840,53184841,c,ct,1
NC_037347.1,NC_032669.1,50125788,53193859,53193861,t,taa,2
NC_037347.1,NC_032669.1,50143079,53228128,53228129,G,GK,1
NC_037347.1,NC_032669.1,50222066,53257237,53257238,a,ac,1
NC_037347.1,NC_032669.1,50224721,53259895,53259896,t,tc,1
NC_037347.1,NC_032669.1,50233161,53268599,53268600,a,ag,1
NC_037347.1,NC_032669.1,50234569,53270008,53270009,t,ta,1
NC_037347.1,NC_032669.1,50236728,53272168,53272169,t,ta,1
NC_037347.1,NC_032669.1,50239818,53275258,53275260,a,aag,2
NC_037347.1,NC_032669.1,50241652,53278469,53278470,a,aN,1
NC_037347.1,NC_032669.1,50269400,53305753,53305754,T,TK,1
NC_037347.1,NC_032669.1,50282493,53318852,53318854,t,ttc,2
NC_037347.1,NC_032669.1,50282837,53319198,53319203,c,ctttgt,5
NC_037347.1,NC_032669.1,50290432,53326796,53326798,c,cgt,2
NC_037347.1,NC_032669.1,50325596,53361966,53361967,a,at,1
NC_037347.1,NC_032669.1,50331771,53368144,53368145,G,GS,1
NC_037347.1,NC_032669.1,50393239,53429620,53429624,T,TATTA,4
NC_037347.1,NC_032669.1,50520931,53558668,53558669,C,CA,1
NC_037347.1,NC_032669.1,50530423,53568162,53568168,c,cacacat,6
NC_037347.1,NC_032669.1,50531079,53568824,53568827,t,tagc,3
NC_037347.1,NC_032669.1,50546645,53584394,53584403,t,ttttttgttg,9
NC_037347.1,NC_032669.1,50551823,53589582,53589583,t,tc,1
NC_037347.1,NC_032669.1,50667614,53737334,53737335,t,tg,1
NC_037347.1,NC_032669.1,50679333,53749057,53749058,t,ta,1
NC_037347.1,NC_032669.1,50725461,53795190,53795192,a,aNN,2
NC_037347.1,NC_032669.1,50775528,53845839,53845840,T,TG,1
NC_037347.1,NC_032669.1,50827430,53898148,53898149,t,tc,1
NC_037347.1,NC_032669.1,50894356,53965084,53965085,c,ct,1
NC_037347.1,NC_032669.1,50894777,53965506,53965507,a,ac,1
NC_037347.1,NC_032669.1,50897145,53967873,53967877,t,tNNNN,4
NC_037347.1,NC_032669.1,50905639,53976382,53976383,T,TC,1
NC_037347.1,NC_032669.1,50911131,53981899,53981900,t,tg,1
NC_037347.1,NC_032669.1,50918502,53989271,53989272,A,AC,1
NC_037347.1,NC_032669.1,50947341,54018121,54018122,T,TA,1
NC_037347.1,NC_032669.1,50999799,54070986,54070988,t,ttc,2
NC_037347.1,NC_032669.1,50999802,54070991,54070992,c,ct,1
NC_037347.1,NC_032669.1,51057240,54129107,54129132,A,AATTTTTGACTTTAGCACTACCCAGG,25
NC_037347.1,NC_032669.1,51113973,54185738,54185739,G,GA,1
NC_037347.1,NC_032669.1,51113989,54185755,54185756,T,TA,1
NC_037347.1,NC_032669.1,51121313,54193081,54193082,g,ga,1
NC_037347.1,NC_032669.1,51189538,54261075,54261076,A,AT,1
NC_037347.1,NC_032669.1,51194729,54266267,54266268,t,ta,1
NC_037347.1,NC_032669.1,51202684,54274205,54274226,a,agcgactgaactgaactgaact,21
NC_037347.1,NC_032669.1,51212047,54283586,54283587,c,ct,1
NC_037347.1,NC_032669.1,51273052,54320816,54320817,t,ta,1
NC_037347.1,NC_032669.1,51319826,54367609,54367612,a,atag,3
NC_037347.1,NC_032669.1,51355901,54403693,54403694,t,tc,1
NC_037347.1,NC_032669.1,51365896,54413690,54413691,G,GC,1
NC_037347.1,NC_032669.1,51375867,54423666,54423668,T,TTC,2
NC_037347.1,NC_032669.1,51376104,54423904,54423905,G,GY,1
NC_037347.1,NC_032669.1,51399883,54447679,54447683,A,ATNNN,4
NC_037347.1,NC_032669.1,51419972,54502636,54502637,C,CA,1
NC_037347.1,NC_032669.1,51433232,54515901,54515902,t,tg,1
NC_037347.1,NC_032669.1,51454042,54536769,54536771,G,GAC,2
NC_037347.1,NC_032669.1,51458150,54540876,54540877,T,TA,1
NC_037347.1,NC_032669.1,51478241,54560971,54560976,T,TATATC,5
NC_037347.1,NC_032669.1,51482436,54565173,54565174,T,TG,1
NC_037347.1,NC_032669.1,51484954,54567692,54567693,a,ag,1
NC_037347.1,NC_032669.1,51486286,54569026,54569027,c,ct,1
NC_037347.1,NC_032669.1,51495949,54578582,54578583,c,ca,1
NC_037347.1,NC_032669.1,51513040,54595672,54595673,g,ga,1
NC_037347.1,NC_032669.1,51573729,54656393,54656399,a,aNNNNNN,6
NC_037347.1,NC_032669.1,51583854,54666524,54666527,t,tcca,3
NC_037347.1,NC_032669.1,51619377,54700674,54700675,C,CA,1
NC_037347.1,NC_032669.1,51619418,54700716,54700717,t,ta,1
NC_037347.1,NC_032669.1,51713590,54794558,54794559,A,AC,1
NC_037347.1,NC_032669.1,51765664,54846449,54846454,T,TGCTNN,5
NC_037347.1,NC_032669.1,51812913,54893683,54893687,t,tNNNN,4
NC_037347.1,NC_032669.1,51828955,54909681,54909687,a,aNNNNNN,6
NC_037347.1,NC_032669.1,51849471,54930217,54930218,g,ga,1
NC_037347.1,NC_032669.1,51927463,55007635,55007636,c,ct,1
NC_037347.1,NC_032669.1,52000570,55080755,55080757,t,tac,2
NC_037347.1,NC_032669.1,52053002,55133033,55133037,T,TTAAC,4
NC_037347.1,NC_032669.1,52085911,55165953,55165959,a,aNNNNNN,6
NC_037347.1,NC_032669.1,52086639,55166687,55166688,T,TA,1
NC_037347.1,NC_032669.1,52094578,55174626,55174627,G,GA,1
NC_037347.1,NC_032669.1,52118815,55198862,55198864,g,gta,2
NC_037347.1,NC_032669.1,52123727,55203777,55203778,T,TY,1
NC_037347.1,NC_032669.1,52132408,55212460,55212461,a,ag,1
NC_037347.1,NC_032669.1,52141046,55221096,55221098,g,gtt,2
NC_037347.1,NC_032669.1,52143078,55223135,55223136,T,TC,1
NC_037347.1,NC_032669.1,52164477,55244460,55244461,t,tg,1
NC_037347.1,NC_032669.1,52218826,55355616,55355617,a,at,1
NC_037347.1,NC_032669.1,52235203,55371498,55371500,A,AAG,2
NC_037347.1,NC_032669.1,52245001,55381328,55381329,A,AT,1
NC_037347.1,NC_032669.1,52256407,55392739,55392740,g,ga,1
NC_037347.1,NC_032669.1,52280472,55321084,55321085,T,TG,1
NC_037347.1,NC_032669.1,52457450,55590644,55590645,a,ac,1
NC_037347.1,NC_032669.1,52524005,55658025,55658027,T,TCC,2
NC_037347.1,NC_032669.1,52563087,55697582,55697587,a,aaggag,5
NC_037347.1,NC_032669.1,52586402,55736755,55736756,T,TC,1
NC_037347.1,NC_032669.1,52587188,55735964,55735965,t,tg,1
NC_037347.1,NC_032669.1,52587269,55735875,55735883,t,ttaaattaa,8
NC_037347.1,NC_032669.1,52587961,55735184,55735185,a,ag,1
NC_037347.1,NC_032669.1,52600192,55722938,55722942,t,tacac,4
NC_037347.1,NC_032669.1,52609332,55776810,55776811,t,tc,1
NC_037347.1,NC_032669.1,52616146,55783625,55783626,A,AG,1
NC_037347.1,NC_032669.1,52617990,55785470,55785471,A,AR,1
NC_037347.1,NC_032669.1,52645461,55812763,55812764,t,tg,1
NC_037347.1,NC_032669.1,52698496,55865897,55865921,T,TANNNNNNNNNNNNNNNNNNNNNNN,24
NC_037347.1,NC_032669.1,52699540,55866965,55866966,C,CA,1
NC_037347.1,NC_032669.1,52703544,55871179,55871182,c,cact,3
NC_037347.1,NC_032669.1,52708407,55946854,55946855,c,ct,1
NC_037347.1,NC_032669.1,52711218,55949667,55949669,t,tta,2
NC_037347.1,NC_032669.1,52716033,55954482,55954485,t,tttg,3
NC_037347.1,NC_032669.1,52745773,55984253,55984254,A,AW,1
NC_037347.1,NC_032669.1,52746197,55984678,55984680,T,TAA,2
NC_037347.1,NC_032669.1,52746835,55985325,55985326,t,ta,1
NC_037347.1,NC_032669.1,52748476,55986969,55986970,A,AG,1
NC_037347.1,NC_032669.1,52750766,55989196,55989197,a,at,1
NC_037347.1,NC_032669.1,52753454,55991885,55991886,t,ta,1
NC_037347.1,NC_032669.1,52832868,56067521,56067522,c,ca,1
NC_037347.1,NC_032669.1,52867901,56102510,56102512,t,taa,2
NC_037347.1,NC_032669.1,52913727,56148338,56148344,a,aNNNNNN,6
NC_037347.1,NC_032669.1,52938413,56173027,56173028,T,TY,1
NC_037347.1,NC_032669.1,52951606,56186225,56186226,C,CY,1
NC_037347.1,NC_032669.1,52957595,56192199,56192201,a,att,2
NC_037347.1,NC_032669.1,52963416,56198019,56198027,c,cagacacag,8
NC_037347.1,NC_032669.1,52964584,56199194,56199196,A,ATR,2
NC_037347.1,NC_032669.1,52965400,56200012,56200013,G,GR,1
NC_037347.1,NC_032669.1,52966962,56201575,56201579,T,TAGAC,4
NC_037347.1,NC_032669.1,52967114,56201731,56201732,T,TK,1
NC_037347.1,NC_032669.1,52968533,56203153,56203154,a,ag,1
NC_037347.1,NC_032669.1,52970379,56205020,56205049,g,ggacagaggaacctgatgggctgcagtcca,29
NC_037347.1,NC_032669.1,52971053,56205719,56205721,t,tcg,2
NC_037347.1,NC_032669.1,52980708,56221792,56221793,a,at,1
NC_037347.1,NC_032669.1,52983490,56224576,56224595,C,CATAATATTTAGATACTAAT,19
NC_037347.1,NC_032669.1,52986480,56227602,56227606,c,cNNNN,4
NC_037347.1,NC_032669.1,52997079,56238206,56238207,t,tY,1
NC_037347.1,NC_032669.1,53004910,56246039,56246041,T,TTG,2
NC_037347.1,NC_032669.1,53012009,56253139,56253140,T,TA,1
NC_037347.1,NC_032669.1,53014728,56255856,56255857,t,tg,1
NC_037347.1,NC_032669.1,53029724,56270852,56270853,g,gt,1
NC_037347.1,NC_032669.1,53031563,56272677,56272687,a,aaggggactac,10
NC_037347.1,NC_032669.1,53036235,56277352,56277353,A,AW,1
NC_037347.1,NC_032669.1,53078258,56319364,56319366,c,ctt,2
NC_037347.1,NC_032669.1,53079433,56320542,56320563,T,TACTGGGAGAGGCATGAATWGG,21
NC_037347.1,NC_032669.1,53085251,56326410,56326412,c,cat,2
NC_037347.1,NC_032669.1,53113135,56354304,56354305,C,CY,1
NC_037347.1,NC_032669.1,53114192,56355362,56355363,A,AK,1
NC_037347.1,NC_032669.1,53126466,56367637,56367639,G,GGT,2
NC_037347.1,NC_032669.1,53127533,56368706,56368707,a,ac,1
NC_037347.1,NC_032669.1,53141195,56382372,56382375,a,aagt,3
NC_037347.1,NC_032669.1,53141204,56382384,56382385,t,tg,1
NC_037347.1,NC_032669.1,53176654,56417838,56417856,t,tgtgcgtgcacacagaTGY,18
NC_037347.1,NC_032669.1,53187792,56428995,56428996,C,CR,1
NC_037347.1,NC_032669.1,53192481,56433685,56433688,g,gaaa,3
NC_037347.1,NC_032669.1,53212952,56453760,56453761,t,tW,1
NC_037347.1,NC_032669.1,53220838,56461650,56461651,c,ct,1
NC_037347.1,NC_032669.1,53221417,56462230,56462231,A,AN,1
NC_037347.1,NC_032669.1,53222994,56463807,56463808,A,AW,1
NC_037347.1,NC_032669.1,53234936,56475755,56475757,t,tac,2
NC_037347.1,NC_032669.1,53257455,56498292,56498294,t,tgc,2
NC_037347.1,NC_032669.1,53266210,56507049,56507050,t,ta,1
NC_037347.1,NC_032669.1,53271107,56511930,56511934,a,aacac,4
NC_037347.1,NC_032669.1,53274674,56515506,56515507,T,TC,1
NC_037347.1,NC_032669.1,53295230,56535148,56535149,A,AW,1
NC_037347.1,NC_032669.1,53311487,56551314,56551315,C,CN,1
NC_037347.1,NC_032669.1,53317120,56557437,56557439,a,atc,2
NC_037347.1,NC_032669.1,53317120,56685758,56685760,a,atc,2
NC_037347.1,NC_032669.1,53329342,56698028,56698029,T,TC,1
NC_037347.1,NC_032669.1,53333055,56701742,56701743,t,tg,1
NC_037347.1,NC_032669.1,53334663,56703353,56703358,a,aaaNNN,5
NC_037347.1,NC_032669.1,53365132,56733830,56733833,a,agct,3
NC_037347.1,NC_032669.1,53394480,56637806,56637807,T,TA,1
NC_037347.1,NC_032669.1,53399170,56770541,56770545,t,ttttc,4
NC_037347.1,NC_032669.1,53399170,56642524,56642528,t,ttttc,4
NC_037347.1,NC_032669.1,53402022,56773394,56773398,t,tNNNN,4
NC_037347.1,NC_032669.1,53406384,56649747,56649749,c,cct,2
NC_037347.1,NC_032669.1,53406384,56777759,56777761,c,cct,2
NC_037347.1,NC_032669.1,53418632,56790011,56790013,t,taa,2
NC_037347.1,NC_032669.1,53445822,56817229,56817231,c,cat,2
NC_037347.1,NC_032669.1,53452608,56824016,56824017,A,AR,1
NC_037347.1,NC_032669.1,53479380,56850799,56850800,t,tc,1
NC_037347.1,NC_032669.1,53485574,56856995,56856998,g,gaga,3
NC_037347.1,NC_032669.1,53485899,56857317,56857329,t,tttttNNNNNtta,12
NC_037347.1,NC_032669.1,53485955,56857385,56857386,g,gt,1
NC_037347.1,NC_032669.1,53513795,56885229,56885230,t,tg,1
NC_037347.1,NC_032669.1,53522698,56894134,56894139,T,TAAATA,5
NC_037347.1,NC_032669.1,53526612,56898047,56898050,a,aagg,3
NC_037347.1,NC_032669.1,53526661,56898099,56898100,C,CA,1
NC_037347.1,NC_032669.1,53549742,56921188,56921191,g,gaaa,3
NC_037347.1,NC_032669.1,53564132,56935584,56935586,t,ttc,2
NC_037347.1,NC_032669.1,53593903,56965341,56965349,A,AGGACTTAT,8
NC_037347.1,NC_032669.1,53634970,57008607,57008609,C,CCA,2
NC_037347.1,NC_032669.1,53634980,57008619,57008620,A,AC,1
NC_037347.1,NC_032669.1,53644810,57018060,57018061,g,gt,1
NC_037347.1,NC_032669.1,53644817,57018068,57018069,a,at,1
NC_037347.1,NC_032669.1,53645667,57018919,57018920,a,ac,1
NC_037347.1,NC_032669.1,53654161,57027414,57027415,c,ct,1
NC_037347.1,NC_032669.1,53662519,57035772,57035782,T,TNNNNNNNNNN,10
NC_037347.1,NC_032669.1,53665136,57038397,57038398,C,CY,1
NC_037347.1,NC_032669.1,53667486,57040748,57040749,t,tN,1
NC_037347.1,NC_032669.1,53691272,57064541,57064542,g,ga,1
NC_037347.1,NC_032669.1,53707112,57080109,57080110,c,ca,1
NC_037347.1,NC_032669.1,53764103,57137220,57137222,a,aNN,2
NC_037347.1,NC_032669.1,53831090,57204206,57204207,a,ag,1
NC_037347.1,NC_032669.1,53832262,57205379,57205382,G,GTCC,3
NC_037347.1,NC_032669.1,53882600,57255886,57255890,C,CAGAG,4
NC_037347.1,NC_032669.1,53917678,57291049,57291050,t,ta,1
NC_037347.1,NC_032669.1,53947455,57320390,57320391,a,ac,1
NC_037347.1,NC_032669.1,54004841,57384442,57384443,t,ta,1
NC_037347.1,NC_032669.1,54005397,57384999,57385000,a,at,1
NC_037347.1,NC_032669.1,54005641,57385244,57385245,t,ta,1
NC_037347.1,NC_032669.1,54007141,57386745,57386748,a,actc,3
NC_037347.1,NC_032669.1,54013060,57392625,57392626,g,ga,1
NC_037347.1,NC_032669.1,54025031,57404004,57404018,G,GACGAAGCGCTGTTC,14
NC_037347.1,NC_032669.1,54029651,57408637,57408639,C,CTA,2
NC_037347.1,NC_032669.1,54120878,57500128,57500129,a,ac,1
NC_037347.1,NC_032669.1,54137879,57517161,57517162,t,ta,1
NC_037347.1,NC_032669.1,54146329,57525756,57525757,G,GT,1
NC_037347.1,NC_032669.1,54178363,57558488,57558508,t,tgaaACCTCACCTNNNNNNNN,20
NC_037347.1,NC_032669.1,54194444,57574663,57574664,G,GA,1
NC_037347.1,NC_032669.1,54195556,57575776,57575780,a,aNNNN,4
NC_037347.1,NC_032669.1,54266598,57700368,57700369,T,TY,1
NC_037347.1,NC_032669.1,54266628,57700399,57700400,G,GA,1
NC_037347.1,NC_032669.1,54290403,57724179,57724180,T,TA,1
NC_037347.1,NC_032669.1,54306549,57740333,57740334,t,tc,1
NC_037347.1,NC_032669.1,54316114,57749900,57749901,t,tg,1
NC_037347.1,NC_032669.1,54351237,57785033,57785034,t,tg,1
NC_037347.1,NC_032669.1,54382823,57816633,57816634,g,gc,1
NC_037347.1,NC_032669.1,54388291,57822106,57822108,C,CTT,2
NC_037347.1,NC_032669.1,54404623,57838427,57838428,A,AG,1
NC_037347.1,NC_032669.1,54405699,57839504,57839505,C,CT,1
NC_037347.1,NC_032669.1,54424067,57857863,57857866,A,ATAG,3
NC_037347.1,NC_032669.1,54424790,57858589,57858590,c,ct,1
NC_037347.1,NC_032669.1,54429484,57863284,57863289,a,aNNNNN,5
NC_037347.1,NC_032669.1,54433348,57867154,57867157,c,ccat,3
NC_037347.1,NC_032669.1,54450538,57884345,57884350,C,CTGCTA,5
NC_037347.1,NC_032669.1,54450822,57884634,57884635,T,TW,1
NC_037347.1,NC_032669.1,54453912,57887717,57887718,t,tc,1
NC_037347.1,NC_032669.1,54454005,57887811,57887815,a,agaat,4
NC_037347.1,NC_032669.1,54462128,57896087,57896091,t,ttttg,4
NC_037347.1,NC_032669.1,54463971,57897935,57897936,T,TC,1
NC_037347.1,NC_032669.1,54500077,57934469,57934470,a,ag,1
NC_037347.1,NC_032669.1,54537629,57972039,57972040,t,tK,1
NC_037347.1,NC_032669.1,54581555,58016572,58016574,t,tNN,2
NC_037347.1,NC_032669.1,54679643,58114680,58114681,T,TC,1
NC_037347.1,NC_032669.1,54679738,58114776,58114777,A,AT,1
NC_037347.1,NC_032669.1,54679746,58114785,58114786,T,TC,1
NC_037347.1,NC_032669.1,54679754,58114794,58114795,T,TA,1
NC_037347.1,NC_032669.1,54679770,58114811,58114812,A,AC,1
NC_037347.1,NC_032669.1,54679779,58114821,58114822,T,TC,1
NC_037347.1,NC_032669.1,54679825,58114869,58114870,T,TC,1
NC_037347.1,NC_032669.1,54679873,58114918,58114919,T,TA,1
NC_037347.1,NC_032669.1,54679884,58114930,58114931,T,TA,1
NC_037347.1,NC_032669.1,54691477,58126524,58126526,t,tNN,2
NC_037347.1,NC_032669.1,54800011,58235084,58235085,a,at,1
NC_037347.1,NC_032669.1,54802638,58237712,58237713,c,ca,1
NC_037347.1,NC_032669.1,54826932,58262036,58262037,T,TA,1
NC_037347.1,NC_032669.1,54836011,58271117,58271118,T,TS,1
NC_037347.1,NC_032669.1,54953525,58388520,58388525,t,tgaaaa,5
NC_037347.1,NC_032669.1,54980681,58415682,58415686,a,aNNNN,4
NC_037347.1,NC_032669.1,54982572,58417588,58417589,c,cg,1
NC_037347.1,NC_032669.1,54982603,58417620,58417621,A,AM,1
NC_037347.1,NC_032669.1,55073002,58506651,58506654,t,ttta,3
NC_037347.1,NC_032669.1,55116237,58549327,58549328,c,ct,1
NC_037347.1,NC_032669.1,55116237,58604872,58604873,c,ct,1
NC_037347.1,NC_032669.1,55146805,58636273,58636277,a,atcac,4
NC_037347.1,NC_032669.1,55161138,58650607,58650608,c,ct,1
NC_037347.1,NC_032669.1,55167083,58656556,58656560,a,atNNN,4
NC_037347.1,NC_032669.1,55176414,58665890,58665891,G,GC,1
NC_037347.1,NC_032669.1,55302347,58805164,58805169,T,TACCTA,5
NC_037347.1,NC_032669.1,55383260,58886067,58886068,g,ga,1
NC_037347.1,NC_032669.1,55396991,58900105,58900106,c,ca,1
NC_037347.1,NC_032669.1,55412279,58915541,58915542,T,TG,1
NC_037347.1,NC_032669.1,55428085,58992788,58992813,a,aatcatatatatatatatatatatat,25
NC_037347.1,NC_032669.1,55430062,58994782,58994783,g,ga,1
NC_037347.1,NC_032669.1,55439838,59004931,59004932,t,ta,1
NC_037347.1,NC_032669.1,55448751,59013850,59013851,c,ca,1
NC_037347.1,NC_032669.1,55539214,59144431,59144436,t,tctatC,5
NC_037347.1,NC_032669.1,55549946,59155176,59155178,c,ctg,2
NC_037347.1,NC_032669.1,55555674,59160909,59160911,c,cat,2
NC_037347.1,NC_032669.1,55556199,59161436,59161437,T,TA,1
NC_037347.1,NC_032669.1,55633442,59176803,59176804,t,ta,1
NC_037347.1,NC_032669.1,55650313,59193685,59193687,c,cca,2
NC_037347.1,NC_032669.1,55739649,59332145,59332146,a,ag,1
NC_037347.1,NC_032669.1,55920582,59370510,59370511,t,ta,1
NC_037347.1,NC_032669.1,55920635,59370564,59370565,T,TW,1
NC_037347.1,NC_032669.1,55920687,59370617,59370619,t,ttc,2
NC_037347.1,NC_032669.1,55960635,59410414,59410416,t,tgc,2
NC_037347.1,NC_032669.1,55979625,59429743,59429744,A,AC,1
NC_037347.1,NC_032669.1,55985359,59434979,59434981,a,aNN,2
NC_037347.1,NC_032669.1,55989041,59438529,59438530,a,ac,1
NC_037347.1,NC_032669.1,55991763,59441242,59441284,C,CTCTTTTTCATGGTTCATGTCTCCTGACACAACAGTGGGCCCT,42
NC_037347.1,NC_032669.1,56029960,59479396,59479397,G,GR,1
NC_037347.1,NC_032669.1,56149557,59598940,59598941,T,TG,1
NC_037347.1,NC_032669.1,56174864,59626041,59626042,t,tg,1
NC_037347.1,NC_032669.1,56174964,59626142,59626156,g,gatctaggcccttaa,14
NC_037347.1,NC_032669.1,56228743,59679983,59679984,T,TY,1
NC_037347.1,NC_032669.1,56288231,59739474,59739475,t,tc,1
NC_037347.1,NC_032669.1,56291395,59742639,59742640,t,ta,1
NC_037347.1,NC_032669.1,56305829,59757092,59757100,g,gcactcact,8
NC_037347.1,NC_032669.1,56331297,59800880,59800881,t,ta,1
NC_037347.1,NC_032669.1,56362497,59832973,59832974,T,TG,1
NC_037347.1,NC_032669.1,56362506,59832983,59832984,A,AC,1
NC_037347.1,NC_032669.1,56368713,59839038,59839039,T,TG,1
NC_037347.1,NC_032669.1,56368718,59839044,59839045,G,GT,1
NC_037347.1,NC_032669.1,56457954,59933038,59933039,T,TR,1
NC_037347.1,NC_032669.1,56468358,59943273,59943274,T,TC,1
NC_037347.1,NC_032669.1,56490764,59965309,59965310,a,at,1
NC_037347.1,NC_032669.1,56490766,59965312,59965313,t,tg,1
NC_037347.1,NC_032669.1,56503515,59978061,59978062,t,tg,1
NC_037347.1,NC_032669.1,56505517,59980062,59980064,C,CNN,2
NC_037347.1,NC_032669.1,56511171,59985622,59985626,c,ctcct,4
NC_037347.1,NC_032669.1,56716868,60260548,60260549,a,ac,1
NC_037347.1,NC_032669.1,56716870,60260551,60260554,t,tgag,3
NC_037347.1,NC_032669.1,56718189,60261867,60261871,a,accat,4
NC_037347.1,NC_032669.1,56779795,60323760,60323765,a,aaatat,5
NC_037347.1,NC_032669.1,56782765,60326739,60326740,t,tc,1
NC_037347.1,NC_032669.1,56820836,60364812,60364813,g,gc,1
NC_037347.1,NC_032669.1,56827453,60371436,60371442,a,aNNNNNN,6
NC_037347.1,NC_032669.1,56839804,60383789,60383801,T,TGCCAACTCTCTC,12
NC_037347.1,NC_032669.1,56846649,60390639,60390656,T,TTGACTTTTGTACTTACY,17
NC_037347.1,NC_032669.1,56847983,60391989,60391990,A,AC,1
NC_037347.1,NC_032669.1,56901331,60445232,60445233,A,AG,1
NC_037347.1,NC_032669.1,56934904,60478819,60478820,C,CT,1
NC_037347.1,NC_032669.1,56948038,60491969,60491972,t,tagc,3
NC_037347.1,NC_032669.1,56953209,60496959,60496960,G,GN,1
NC_037347.1,NC_032669.1,56953938,60497689,60497690,T,TN,1
NC_037347.1,NC_032669.1,56966463,60510219,60510220,G,GS,1
NC_037347.1,NC_032669.1,56993493,60537507,60537511,a,aNNNN,4
NC_037347.1,NC_032669.1,57008553,60552572,60552573,G,GA,1
NC_037347.1,NC_032669.1,57023978,60568155,60568157,a,aat,2
NC_037347.1,NC_032669.1,57029874,60574053,60574054,g,ga,1
NC_037347.1,NC_032669.1,57047501,60591672,60591673,T,TG,1
NC_037347.1,NC_032669.1,57071957,60616134,60616135,t,ta,1
NC_037347.1,NC_032669.1,57192695,60737334,60737335,C,CM,1
NC_037347.1,NC_032669.1,57276029,60820669,60820670,C,CT,1
NC_037347.1,NC_032669.1,57385289,60930299,60930302,A,AATC,3
NC_037347.1,NC_032669.1,57398423,60943560,60943561,a,at,1
NC_037347.1,NC_032669.1,57457968,61001723,61001727,a,atatt,4
NC_037347.1,NC_032669.1,57484279,61028168,61028171,c,cttt,3
NC_037347.1,NC_032669.1,57492549,61036440,61036442,C,CTG,2
NC_037347.1,NC_032669.1,57493720,61037979,61037980,C,CT,1
NC_037347.1,NC_032669.1,57496618,61040872,61040873,C,CA,1
NC_037347.1,NC_032669.1,57496650,61040905,61040906,G,GT,1
NC_037347.1,NC_032669.1,57525180,61069144,61069145,A,AC,1
NC_037347.1,NC_032669.1,57557951,61101925,61101926,t,ta,1
NC_037347.1,NC_032669.1,57557955,61101930,61101935,t,tttttc,5
NC_037347.1,NC_032669.1,57587823,61131815,61131847,C,CCAGGTACTTTATGCCTTCAATAACTAAATATT,32
NC_037347.1,NC_032669.1,57661211,61215339,61215353,a,atagatttaagggcc,14
NC_037347.1,NC_032669.1,57689013,61242785,61242786,a,ag,1
NC_037347.1,NC_032669.1,57797452,61351647,61351652,A,AATGAC,5
NC_037347.1,NC_032669.1,57807816,61366574,61366575,t,tg,1
NC_037347.1,NC_032669.1,57808206,61366964,61366969,g,gactga,5
NC_037347.1,NC_032669.1,57942396,61503228,61503232,G,GAGAT,4
NC_037347.1,NC_032669.1,57955353,61516183,61516184,A,AC,1
NC_037347.1,NC_032669.1,57963542,61524352,61524358,t,tNNNNNN,6
NC_037347.1,NC_032669.1,57980216,61541021,61541039,t,tatatgtatatatatatac,18
NC_037347.1,NC_032669.1,57988160,61548992,61548993,T,TS,1
NC_037347.1,NC_032669.1,57989219,61550052,61550058,g,gaaaaaa,6
NC_037347.1,NC_032669.1,57994302,61555142,61555143,a,at,1
NC_037347.1,NC_032669.1,58015568,61576438,61576442,g,gctga,4
NC_037347.1,NC_032669.1,58015568,61583750,61583754,g,gctga,4
NC_037347.1,NC_032669.1,58026638,61594864,61594865,T,TG,1
NC_037347.1,NC_032669.1,58028411,61596638,61596640,t,ttc,2
NC_037347.1,NC_032669.1,58049531,61617762,61617764,A,ACT,2
NC_037347.1,NC_032669.1,58073558,61641791,61641792,C,CG,1
NC_037347.1,NC_032669.1,58086706,61654956,61654964,T,TCCAGGCAG,8
NC_037347.1,NC_032669.1,58139114,61707090,61707094,c,cWttt,4
NC_037347.1,NC_032669.1,58172053,61740036,61740037,T,TC,1
NC_037347.1,NC_032669.1,58186580,61754566,61754567,a,at,1
NC_037347.1,NC_032669.1,58257917,61827024,61827033,C,CTTCAGGAAM,9
NC_037347.1,NC_032669.1,58258348,61827464,61827465,T,TG,1
NC_037347.1,NC_032669.1,58269408,61838534,61838540,G,GTCCGAA,6
NC_037347.1,NC_032669.1,58290015,61859155,61859159,t,tgaaa,4
NC_037347.1,NC_032669.1,58335823,61905880,61905881,T,TC,1
NC_037347.1,NC_032669.1,58356105,61924370,61924372,C,CTG,2
NC_037347.1,NC_032669.1,58356562,61924829,61924838,t,tagcagcagc,9
NC_037347.1,NC_032669.1,58370119,61938393,61938394,G,GA,1
NC_037347.1,NC_032669.1,58466096,62035496,62035497,T,TG,1
NC_037347.1,NC_032669.1,58480086,62049490,62049491,G,GT,1
NC_037347.1,NC_032669.1,58481814,62051218,62051220,T,TTG,2
NC_037347.1,NC_032669.1,58489428,62058836,62058837,c,ca,1
NC_037347.1,NC_032669.1,58507184,62076598,62076601,T,TCTA,3
NC_037347.1,NC_032669.1,58538213,62107636,62107637,A,AG,1
NC_037347.1,NC_032669.1,58547337,62116763,62116783,t,ttaGGAGGAAATACCAGAgga,20
NC_037347.1,NC_032669.1,58550389,62119835,62119837,t,tga,2
NC_037347.1,NC_032669.1,58552667,62122118,62122119,g,ga,1
NC_037347.1,NC_032669.1,58583782,62153239,62153240,C,CT,1
NC_037347.1,NC_032669.1,58616083,62185542,62185543,A,AM,1
NC_037347.1,NC_032669.1,58627260,62196732,62196734,T,TTC,2
NC_037347.1,NC_032669.1,58907817,62476106,62476107,G,GA,1
NC_037347.1,NC_032669.1,59056384,62626907,62626909,A,AAC,2
NC_037347.1,NC_032669.1,59059952,62630477,62630488,t,tcttgagagtcc,11
NC_037347.1,NC_032669.1,59067603,62638144,62638146,a,aat,2
NC_037347.1,NC_032669.1,59067620,62638163,62638164,t,ta,1
NC_037347.1,NC_032669.1,59077088,62647646,62647647,G,GS,1
NC_037347.1,NC_032669.1,59093593,62666677,62666678,t,tg,1
NC_037347.1,NC_032669.1,59108306,62681383,62681384,a,ag,1
NC_037347.1,NC_032669.1,59131320,62703978,62703979,C,CT,1
NC_037347.1,NC_032669.1,59159436,62732096,62732097,G,GA,1
NC_037347.1,NC_032669.1,59200537,62772005,62772007,t,tNN,2
NC_037347.1,NC_032669.1,59266301,62837616,62837617,c,ct,1
NC_037347.1,NC_032669.1,59304138,62875464,62875465,c,ct,1
NC_037347.1,NC_032669.1,59350965,62922337,62922338,g,gt,1
NC_037347.1,NC_032669.1,59359114,62930495,62930496,G,GT,1
NC_037347.1,NC_032669.1,59362724,62934106,62934107,g,ga,1
NC_037347.1,NC_032669.1,59384678,62958064,62958078,t,taaaataaaaaaaaa,14
NC_037347.1,NC_032669.1,59385146,62958545,62958570,T,TCTCCTTTGGAAGCACAGCTAGTNAA,25
NC_037347.1,NC_032669.1,59385277,62958702,62958703,c,ct,1
NC_037347.1,NC_032669.1,59388809,62962240,62962241,C,CT,1
NC_037347.1,NC_032669.1,59391606,62965038,62965040,c,caa,2
NC_037347.1,NC_032669.1,59395609,62969044,62969045,C,CA,1
NC_037347.1,NC_032669.1,59401419,62974857,62974860,A,AATG,3
NC_037347.1,NC_032669.1,59401424,62974865,62974873,T,TACTGTATG,8
NC_037347.1,NC_032669.1,59418690,62992205,62992206,A,AW,1
NC_037347.1,NC_032669.1,59419102,62992618,62992619,A,AR,1
NC_037347.1,NC_032669.1,59774360,63372132,63372133,t,ta,1
NC_037347.1,NC_032669.1,59774402,63372175,63372176,g,ga,1
NC_037347.1,NC_032669.1,59786928,63384696,63384697,G,GT,1
NC_037347.1,NC_032669.1,59802761,63400534,63400535,C,CA,1
NC_037347.1,NC_032669.1,59819370,63417149,63417150,t,tg,1
NC_037347.1,NC_032669.1,59819396,63417176,63417177,t,tg,1
NC_037347.1,NC_032669.1,59825077,63422864,63422865,T,TC,1
NC_037347.1,NC_032669.1,59849594,63447383,63447394,t,tatatatatata,11
NC_037347.1,NC_032669.1,59849610,63447410,63447411,t,ta,1
NC_037347.1,NC_032669.1,59880678,63480860,63480861,T,TA,1
NC_037347.1,NC_032669.1,59886037,63486221,63486223,a,aNN,2
NC_037347.1,NC_032669.1,59891976,63492164,63492165,C,CG,1
NC_037347.1,NC_032669.1,59903176,63503364,63503366,C,CTG,2
NC_037347.1,NC_032669.1,59910505,63510441,63510442,A,AG,1
NC_037347.1,NC_032669.1,59914958,63516374,63516375,a,at,1
NC_037347.1,NC_032669.1,59915615,63517027,63517028,a,at,1
NC_037347.1,NC_032669.1,59916260,63517665,63517666,A,AM,1
NC_037347.1,NC_032669.1,59917393,63518784,63518785,A,AW,1
NC_037347.1,NC_032669.1,59918094,63519484,63519485,G,GA,1
NC_037347.1,NC_032669.1,59925138,63526508,63526509,A,AM,1
NC_037347.1,NC_032669.1,59931982,63533356,63533357,a,at,1
NC_037347.1,NC_032669.1,59953221,63554596,63554597,a,aM,1
NC_037347.1,NC_032669.1,59967492,63568867,63568869,g,gtt,2
NC_037347.1,NC_032669.1,60092097,63695376,63695377,T,TK,1
NC_037347.1,NC_032669.1,60148838,63752551,63752552,t,tc,1
NC_037347.1,NC_032669.1,60246468,63848535,63848536,c,ca,1
NC_037347.1,NC_032669.1,60246468,63949642,63949643,c,ca,1
NC_037347.1,NC_032669.1,60247930,63951106,63951107,t,tg,1
NC_037347.1,NC_032669.1,60265425,63968609,63968610,a,at,1
NC_037347.1,NC_032669.1,60335691,64038893,64038894,a,at,1
NC_037347.1,NC_032669.1,60344062,64047264,64047266,a,aat,2
NC_037347.1,NC_032669.1,60351463,64054666,64054671,c,caaaaa,5
NC_037347.1,NC_032669.1,60364836,64068570,64068571,c,ct,1
NC_037347.1,NC_032669.1,60380161,64083902,64083903,T,TA,1
NC_037347.1,NC_032669.1,60386096,64089843,64089844,c,ct,1
NC_037347.1,NC_032669.1,60477461,64156264,64156265,a,ag,1
NC_037347.1,NC_032669.1,60536559,64215388,64215389,A,AC,1
NC_037347.1,NC_032669.1,60541497,64220379,64220380,c,ct,1
NC_037347.1,NC_032669.1,60541713,64220596,64220599,t,tctc,3
NC_037347.1,NC_032669.1,60542244,64221130,64221131,c,ct,1
NC_037347.1,NC_032669.1,60553099,64231868,64231869,T,TA,1
NC_037347.1,NC_032669.1,60553777,64232545,64232546,t,ta,1
NC_037347.1,NC_032669.1,60722911,64390109,64390110,c,ct,1
NC_037347.1,NC_032669.1,60724821,64392015,64392020,c,cttaag,5
NC_037347.1,NC_032669.1,60725009,64392203,64392205,a,att,2
NC_037347.1,NC_032669.1,60726841,64394032,64394033,g,gc,1
NC_037347.1,NC_032669.1,60727987,64395177,64395181,t,ttcaY,4
NC_037347.1,NC_032669.1,60732196,64400210,64400216,A,ATCAGGT,6
NC_037347.1,NC_032669.1,60735696,64403714,64403715,T,TA,1
NC_037347.1,NC_032669.1,60739704,64407722,64407724,c,cca,2
NC_037347.1,NC_032669.1,60743350,64411370,64411371,g,gt,1
NC_037347.1,NC_032669.1,60745458,64413479,64413480,c,ct,1
NC_037347.1,NC_032669.1,60746436,64414458,64414459,t,tY,1
NC_037347.1,NC_032669.1,60751383,64419406,64419407,T,TG,1
NC_037347.1,NC_032669.1,60848636,64520895,64520896,c,ct,1
NC_037347.1,NC_032669.1,60849365,64521625,64521626,g,gc,1
NC_037347.1,NC_032669.1,60851204,64523466,64523470,c,caaaa,4
NC_037347.1,NC_032669.1,60856814,64529081,64529083,a,aag,2
NC_037347.1,NC_032669.1,60866396,64538834,64538835,A,AN,1
NC_037347.1,NC_032669.1,60921929,64594154,64594156,g,gta,2
NC_037347.1,NC_032669.1,61071424,64743925,64743926,t,ta,1
NC_037347.1,NC_032669.1,61099599,64772102,64772103,g,gR,1
NC_037347.1,NC_032669.1,61258070,64930638,64930639,G,GR,1
NC_037347.1,NC_032669.1,61261695,64934266,64934267,t,ta,1
NC_037347.1,NC_032669.1,61314662,64987918,64987919,T,TA,1
NC_037347.1,NC_032669.1,61362463,65035678,65035679,t,tg,1
NC_037347.1,NC_032669.1,61403450,65076500,65076501,a,ag,1
NC_037347.1,NC_032669.1,61441533,65114353,65114356,t,taaa,3
NC_037347.1,NC_032669.1,61450424,65123251,65123252,T,TC,1
NC_037347.1,NC_032669.1,61450842,65123670,65123671,T,TG,1
NC_037347.1,NC_032669.1,61470919,65143784,65143790,A,AGAAATT,6
NC_037347.1,NC_032669.1,61470924,65143795,65143799,C,CGGTG,4
NC_037347.1,NC_032669.1,61503405,65176155,65176156,T,TC,1
NC_037347.1,NC_032669.1,61504579,65177330,65177331,a,aN,1
NC_037347.1,NC_032669.1,61510422,65183175,65183177,c,ctt,2
NC_037347.1,NC_032669.1,61524336,65197236,65197259,T,TNNNNNNNNNNNNNNNNNNNNNNN,23
NC_037347.1,NC_032669.1,61556309,65229239,65229247,t,tNNNNNNNN,8
NC_037347.1,NC_032669.1,61569893,65242831,65242841,C,CGTATGTAGGG,10
NC_037347.1,NC_032669.1,61589479,65262361,65262362,c,ct,1
NC_037347.1,NC_032669.1,61615644,65288737,65288739,t,ttg,2
NC_037347.1,NC_032669.1,61703903,65377178,65377180,g,gtt,2
NC_037347.1,NC_032669.1,61705902,65379179,65379184,G,GCTGCT,5
NC_037347.1,NC_032669.1,61730005,65403286,65403287,A,AR,1
NC_037347.1,NC_032669.1,61757860,65431256,65431257,t,ta,1
NC_037347.1,NC_032669.1,61790195,65463249,65463250,T,TG,1
NC_037347.1,NC_032669.1,61801046,65474057,65474058,A,AC,1
NC_037347.1,NC_032669.1,61801054,65474066,65474067,G,GA,1
NC_037347.1,NC_032669.1,61802891,65475904,65475905,t,ta,1
NC_037347.1,NC_032669.1,61805085,65478099,65478100,A,AR,1
NC_037347.1,NC_032669.1,61808609,65481615,65481616,T,TC,1
NC_037347.1,NC_032669.1,61819029,65492027,65492029,c,cat,2
NC_037347.1,NC_032669.1,61822631,65504743,65504747,t,taatg,4
NC_037347.1,NC_032669.1,61856161,65538270,65538280,c,cccccacccca,10
NC_037347.1,NC_032669.1,61856308,65538427,65538428,g,ga,1
NC_037347.1,NC_032669.1,61863785,65545943,65545944,G,GS,1
NC_037347.1,NC_032669.1,61870355,65552508,65552509,t,tc,1
NC_037347.1,NC_032669.1,61872390,65554544,65554545,A,AG,1
NC_037347.1,NC_032669.1,61873510,65555665,65555666,C,CY,1
NC_037347.1,NC_032669.1,61890762,65572916,65572920,C,CTTTA,4
NC_037347.1,NC_032669.1,61895281,65577437,65577438,t,tc,1
NC_037347.1,NC_032669.1,61895361,65577518,65577519,t,tc,1
NC_037347.1,NC_032669.1,61907096,65589245,65589246,G,GA,1
NC_037347.1,NC_032669.1,61940620,65620001,65620003,a,agt,2
NC_037347.1,NC_032669.1,61940656,65620039,65620041,c,cat,2
NC_037347.1,NC_032669.1,61967557,65644977,65644981,G,GTGTT,4
NC_037347.1,NC_032669.1,61975920,65653341,65653342,t,ta,1
NC_037347.1,NC_032669.1,62006522,65684024,65684025,T,TY,1
NC_037347.1,NC_032669.1,62006733,65684236,65684237,T,TY,1
NC_037347.1,NC_032669.1,62009928,65687435,65687436,t,ta,1
NC_037347.1,NC_032669.1,62023670,65701181,65701182,T,TG,1
NC_037347.1,NC_032669.1,62029027,65706527,65706528,g,ga,1
NC_037347.1,NC_032669.1,62048926,65726766,65726768,A,ATG,2
NC_037347.1,NC_032669.1,62051580,65729420,65729421,G,GC,1
NC_037347.1,NC_032669.1,62052640,65730481,65730493,A,AATAGTTATAATW,12
NC_037347.1,NC_032669.1,62064576,65742366,65742369,T,TTTG,3
NC_037347.1,NC_032669.1,62071759,65749553,65749555,g,gga,2
NC_037347.1,NC_032669.1,62079164,65756955,65756956,T,TG,1
NC_037347.1,NC_032669.1,62140364,65815670,65815673,c,ccca,3
NC_037347.1,NC_032669.1,62149585,65824894,65824902,G,GAGCAACAA,8
NC_037347.1,NC_032669.1,62173233,65849615,65849618,c,ctct,3
NC_037347.1,NC_032669.1,62191521,65868061,65868071,A,ACAAGGATGAT,10
NC_037347.1,NC_032669.1,62208566,65903527,65903528,T,TW,1
NC_037347.1,NC_032669.1,62213729,65908692,65908694,t,taa,2
NC_037347.1,NC_032669.1,62240003,65934928,65934929,T,TY,1
NC_037347.1,NC_032669.1,62252356,65947218,65947219,A,AT,1
NC_037347.1,NC_032669.1,62255513,65950374,65950375,A,AG,1
NC_037347.1,NC_032669.1,62270398,65965278,65965279,A,AG,1
NC_037347.1,NC_032669.1,62275361,65970244,65970245,T,TA,1
NC_037347.1,NC_032669.1,62342131,66037065,66037066,A,AG,1
NC_037347.1,NC_032669.1,62344637,66039573,66039587,a,agaaggctgagcacc,14
NC_037347.1,NC_032669.1,62359766,66061545,66061546,a,at,1
NC_037347.1,NC_032669.1,62360666,66062446,66062447,a,ag,1
NC_037347.1,NC_032669.1,62408844,66110625,66110626,T,TC,1
NC_037347.1,NC_032669.1,62409247,66111029,66111033,G,GGGGT,4
NC_037347.1,NC_032669.1,62467730,66169524,66169525,T,TG,1
NC_037347.1,NC_032669.1,62488439,66190845,66190846,T,TC,1
NC_037347.1,NC_032669.1,62492152,66194561,66194562,a,at,1
NC_037347.1,NC_032669.1,62591946,66294567,66294575,a,acgtcaatg,8
NC_037347.1,NC_032669.1,62595571,66298200,66298201,a,at,1
NC_037347.1,NC_032669.1,62601714,66304344,66304345,G,GT,1
NC_037347.1,NC_032669.1,62633572,66366067,66366068,C,CS,1
NC_037347.1,NC_032669.1,62669951,66402456,66402457,T,TA,1
NC_037347.1,NC_032669.1,62688028,66420544,66420545,C,CT,1
NC_037347.1,NC_032669.1,62688244,66420761,66420762,C,CA,1
NC_037347.1,NC_032669.1,62725942,66458466,66458482,C,CCACCGAGATAGTATCT,16
NC_037347.1,NC_032669.1,62730406,66462946,66462947,c,cg,1
NC_037347.1,NC_032669.1,62730751,66463292,66463293,C,CT,1
NC_037347.1,NC_032669.1,62731891,66464471,66464472,C,CR,1
NC_037347.1,NC_032669.1,62737644,66470250,66470251,G,GA,1
NC_037347.1,NC_032669.1,62738145,66470751,66470752,t,ta,1
NC_037347.1,NC_032669.1,62748600,66481200,66481201,T,TC,1
NC_037347.1,NC_032669.1,62749738,66491974,66491975,T,TN,1
NC_037347.1,NC_032669.1,62753535,66495772,66495773,A,AC,1
NC_037347.1,NC_032669.1,62756208,66498448,66498450,t,taa,2
NC_037347.1,NC_032669.1,62757777,66500019,66500020,A,AG,1
NC_037347.1,NC_032669.1,62759305,66501554,66501555,c,ct,1
NC_037347.1,NC_032669.1,62812826,66554915,66554921,t,tagcaca,6
NC_037347.1,NC_032669.1,62814737,66556833,66556834,G,GT,1
NC_037347.1,NC_032669.1,62880337,66622439,66622441,t,tca,2
NC_037347.1,NC_032669.1,62899986,66642093,66642094,G,GA,1
NC_037347.1,NC_032669.1,62900004,66642111,66642112,T,TA,1
NC_037347.1,NC_032669.1,62931609,66673729,66673731,A,AGT,2
NC_037347.1,NC_032669.1,62931661,66673783,66673787,T,TAACC,4
NC_037347.1,NC_032669.1,62944001,66686127,66686128,C,CY,1
NC_037347.1,NC_032669.1,62966693,66708593,66708595,C,CAG,2
NC_037347.1,NC_032669.1,62978502,66720407,66720408,T,TY,1
NC_037347.1,NC_032669.1,63003086,66745229,66745235,c,cctgctg,6
NC_037347.1,NC_032669.1,63013174,66755146,66755150,T,TGCTC,4
NC_037347.1,NC_032669.1,63040410,66782414,66782415,c,cg,1
NC_037347.1,NC_032669.1,63048994,66791004,66791005,C,CA,1
NC_037347.1,NC_032669.1,63052660,66794671,66794674,t,tctc,3
NC_037347.1,NC_032669.1,63063126,66805149,66805150,G,GK,1
NC_037347.1,NC_032669.1,63074714,66816739,66816741,G,GAA,2
NC_037347.1,NC_032669.1,63114073,66856090,66856098,g,ggaaacagt,8
NC_037347.1,NC_032669.1,63159028,66901088,66901098,a,aNNNNNNNNNN,10
NC_037347.1,NC_032669.1,63214604,66956675,66956676,A,AC,1
NC_037347.1,NC_032669.1,63214731,66956803,66956804,C,CA,1
NC_037347.1,NC_032669.1,63219478,66961555,66961556,t,tg,1
NC_037347.1,NC_032669.1,63273980,67016130,67016131,G,GA,1
NC_037347.1,NC_032669.1,63377117,67196158,67196159,t,tW,1
NC_037347.1,NC_032669.1,63382871,67201916,67201917,A,AT,1
NC_037347.1,NC_032669.1,63388165,67207211,67207215,T,TGAAG,4
NC_037347.1,NC_032669.1,63389804,67208711,67208721,T,TTTGAAAACTC,10
NC_037347.1,NC_032669.1,63395338,67214257,67214259,a,atg,2
NC_037347.1,NC_032669.1,63498212,67157607,67157611,a,aNNNN,4
NC_037347.1,NC_032669.1,63745859,67644217,67644218,G,GA,1
NC_037347.1,NC_032669.1,63787406,67673126,67673127,a,ag,1
NC_037347.1,NC_032669.1,63821600,67707426,67707427,C,CA,1
NC_037347.1,NC_032669.1,63829195,67715023,67715024,A,AT,1
NC_037347.1,NC_032669.1,63855948,67741764,67741766,t,tNN,2
NC_037347.1,NC_032669.1,63865063,67750864,67750865,A,AG,1
NC_037347.1,NC_032669.1,63865210,67751010,67751011,G,GC,1
NC_037347.1,NC_032669.1,63896197,67782186,67782187,G,GA,1
NC_037347.1,NC_032669.1,63949229,67835722,67835723,G,GR,1
NC_037347.1,NC_032669.1,63950954,67837448,67837449,A,AY,1
NC_037347.1,NC_032669.1,63951437,67837933,67837934,A,AY,1
NC_037347.1,NC_032669.1,63954922,67841578,67841584,c,cctccct,6
NC_037347.1,NC_032669.1,63954935,67841597,67841598,c,ct,1
NC_037347.1,NC_032669.1,63956581,67843246,67843247,T,TK,1
NC_037347.1,NC_032669.1,63970206,67856891,67856893,t,tga,2
NC_037347.1,NC_032669.1,63977770,67864410,67864411,a,ag,1
NC_037347.1,NC_032669.1,63980792,67867435,67867436,T,TY,1
NC_037347.1,NC_032669.1,64021399,67908036,67908037,c,ct,1
NC_037347.1,NC_032669.1,64024548,67911186,67911187,a,ac,1
NC_037347.1,NC_032669.1,64101830,68005919,68005920,A,AC,1
NC_037347.1,NC_032669.1,64101839,68005929,68005930,C,CG,1
NC_037347.1,NC_032669.1,64171243,68076516,68076517,C,CY,1
NC_037347.1,NC_032669.1,64180369,68085524,68085527,g,gttc,3
NC_037347.1,NC_032669.1,64180459,68085617,68085625,t,tccTAAAGG,8
NC_037347.1,NC_032669.1,64213046,68118460,68118461,t,tg,1
NC_037347.1,NC_032669.1,64224125,68129546,68129547,T,TY,1
NC_037347.1,NC_032669.1,64224882,68130312,68130329,t,tatatatatatatatata,17
NC_037347.1,NC_032669.1,64254305,68152206,68152207,g,gc,1
NC_037347.1,NC_032669.1,64263216,68161114,68161115,g,ga,1
NC_037347.1,NC_032669.1,64285287,68183175,68183176,g,gc,1
NC_037347.1,NC_032669.1,64316602,68214491,68214493,C,CTG,2
NC_037347.1,NC_032669.1,64350871,68248763,68248764,T,TG,1
NC_037347.1,NC_032669.1,64364222,68262159,68262160,c,ca,1
NC_037347.1,NC_032669.1,64381877,68279820,68279826,g,ggaaaaa,6
NC_037347.1,NC_032669.1,64387429,68285378,68285379,C,CY,1
NC_037347.1,NC_032669.1,64426808,68324325,68324326,T,TC,1
NC_037347.1,NC_032669.1,64439117,68336627,68336628,t,tN,1
NC_037347.1,NC_032669.1,64578758,68433931,68433946,t,tctcccattctgaagg,15
NC_037347.1,NC_032669.1,64581134,68436317,68436325,t,ttttttttc,8
NC_037347.1,NC_032669.1,64585001,68440188,68440189,t,tg,1
NC_037347.1,NC_032669.1,64615746,68470941,68470942,a,ag,1
NC_037347.1,NC_032669.1,64616896,68472092,68472095,C,CAGA,3
NC_037347.1,NC_032669.1,64617741,68472940,68472941,C,CG,1
NC_037347.1,NC_032669.1,64632455,68487671,68487672,c,ct,1
NC_037347.1,NC_032669.1,64667765,68523101,68523102,t,ta,1
NC_037347.1,NC_032669.1,64786585,68641868,68641869,G,GT,1
NC_037347.1,NC_032669.1,64856814,68712087,68712088,A,AC,1
NC_037347.1,NC_032669.1,64885759,68741036,68741038,c,ctt,2
NC_037347.1,NC_032669.1,64892064,68747343,68747344,t,tW,1
NC_037347.1,NC_032669.1,64943590,68802875,68802876,G,GT,1
NC_037347.1,NC_032669.1,64946551,68805835,68805843,T,TCATCTTCA,8
NC_037347.1,NC_032669.1,64947126,68806420,68806421,A,AW,1
NC_037347.1,NC_032669.1,65100956,68962802,68962803,A,AG,1
NC_037347.1,NC_032669.1,65108506,68970351,68970355,T,TCTAA,4
NC_037347.1,NC_032669.1,65112411,68974264,68974267,A,ATMW,3
NC_037347.1,NC_032669.1,65115988,68977847,68977848,t,ta,1
NC_037347.1,NC_032669.1,65118065,68979925,68979926,c,ct,1
NC_037347.1,NC_032669.1,65131422,68993276,68993277,A,AC,1
NC_037347.1,NC_032669.1,65137637,69000981,69000982,T,TA,1
NC_037347.1,NC_032669.1,65138177,69001522,69001523,g,ga,1
NC_037347.1,NC_032669.1,65142860,69006205,69006209,C,CTCTG,4
NC_037347.1,NC_032669.1,65149705,69013407,69013409,c,ctt,2
NC_037347.1,NC_032669.1,65161090,69024809,69024810,c,ct,1
NC_037347.1,NC_032669.1,65161987,69025699,69025700,a,ac,1
NC_037347.1,NC_032669.1,65167075,69030796,69030802,g,gctgcca,6
NC_037347.1,NC_032669.1,65168078,69031805,69031806,C,CA,1
NC_037347.1,NC_032669.1,65170636,69032583,69032584,t,tc,1
NC_037347.1,NC_032669.1,65170650,69032598,69032599,a,ag,1
NC_037347.1,NC_032669.1,65179440,69041341,69041343,c,cat,2
NC_037347.1,NC_032669.1,65179781,69041684,69041685,C,CT,1
NC_037347.1,NC_032669.1,65183688,69045421,69045422,t,ta,1
NC_037347.1,NC_032669.1,65193358,69055093,69055094,t,ta,1
NC_037347.1,NC_032669.1,65218230,69198450,69198460,a,aNNNNNNNNNN,10
NC_037347.1,NC_032669.1,65219710,69199939,69199940,A,AM,1
NC_037347.1,NC_032669.1,65247148,69227375,69227376,a,at,1
NC_037347.1,NC_032669.1,65247150,69227378,69227379,t,ta,1
NC_037347.1,NC_032669.1,65254077,69234305,69234306,T,TK,1
NC_037347.1,NC_032669.1,65257701,69237934,69237935,C,CG,1
NC_037347.1,NC_032669.1,65260100,69240336,69240337,t,ta,1
NC_037347.1,NC_032669.1,65269890,69250132,69250133,G,GC,1
NC_037347.1,NC_032669.1,65272947,69082976,69082977,A,AG,1
NC_037347.1,NC_032669.1,65311677,69122440,69122441,A,AG,1
NC_037347.1,NC_032669.1,65591485,69478214,69478220,a,aGAACAT,6
NC_037347.1,NC_032669.1,65663994,69550636,69550637,g,ga,1
NC_037347.1,NC_032669.1,65742504,69629151,69629219,C,CCTAAGAGNNNNNNNNNNNNNNNNNNNNNNNNNNNNNNNNNNNNNNNTATCTACAGCCAAAATAAGCAG,68
NC_037347.1,NC_032669.1,65801852,69688143,69688192,a,aataatgtatTANNNNNNNNNNNNNNNNNNNNNNNNNNNNNNNNNNNNNN,49
NC_037347.1,NC_032669.1,66006761,69893368,69893369,T,TG,1
NC_037347.1,NC_032669.1,66100768,69987764,69987765,g,gt,1
NC_037347.1,NC_032669.1,66101031,69988029,69988030,c,ct,1
NC_037347.1,NC_032669.1,66312592,70207719,70207721,c,ctg,2
NC_037347.1,NC_032669.1,66313744,70208871,70208872,A,AG,1
NC_037347.1,NC_032669.1,66314578,70209706,70209707,T,TG,1
NC_037347.1,NC_032669.1,66316213,70211342,70211343,T,TG,1
NC_037347.1,NC_032669.1,66330195,70225329,70225330,C,CT,1
NC_037347.1,NC_032669.1,66335568,70230703,70230704,G,GC,1
NC_037347.1,NC_032669.1,66335572,70230708,70230709,A,AN,1
NC_037347.1,NC_032669.1,66337779,70232914,70232916,A,AAC,2
NC_037347.1,NC_032669.1,66348289,70243431,70243432,C,CA,1
NC_037347.1,NC_032669.1,66350664,70245807,70245808,g,ga,1
NC_037347.1,NC_032669.1,66414380,70310623,70310625,a,aNN,2
NC_037347.1,NC_032669.1,66442273,70338818,70338819,T,TN,1
NC_037347.1,NC_032669.1,66462560,70359168,70359174,A,ACTGTGG,6
NC_037347.1,NC_032669.1,66481448,70378062,70378075,T,TGTCCAGCTGCMCC,13
NC_037347.1,NC_032669.1,66721232,70608105,70608106,G,GT,1
NC_037347.1,NC_032669.1,66721739,70608614,70608615,t,tc,1
NC_037347.1,NC_032669.1,66749486,70637135,70637136,A,AG,1
NC_037347.1,NC_032669.1,66801764,70687901,70687902,C,CM,1
NC_037347.1,NC_032669.1,66918280,70768905,70768906,c,cM,1
NC_037347.1,NC_032669.1,66929173,70779798,70779799,T,TY,1
NC_037347.1,NC_032669.1,66935510,70786134,70786135,T,TG,1
NC_037347.1,NC_032669.1,66949221,70799866,70799870,T,TCCTA,4
NC_037347.1,NC_032669.1,67015588,70866613,70866614,G,GK,1
NC_037347.1,NC_032669.1,67018593,70870402,70870403,a,ag,1
NC_037347.1,NC_032669.1,67036656,70888493,70888494,A,AT,1
NC_037347.1,NC_032669.1,67038183,70890021,70890023,G,GAC,2
NC_037347.1,NC_032669.1,67043447,70895298,70895299,a,aW,1
NC_037347.1,NC_032669.1,67126962,70975349,70975350,g,ga,1
NC_037347.1,NC_032669.1,67156745,71005309,71005310,g,ga,1
NC_037347.1,NC_032669.1,67175854,71024449,71024454,c,cttcat,5
NC_037347.1,NC_032669.1,67295303,71120781,71120785,a,aaatg,4
NC_037347.1,NC_032669.1,67310966,71136453,71136454,T,TC,1
NC_037347.1,NC_032669.1,67349792,71175201,71175202,A,AT,1
NC_037347.1,NC_032669.1,67352723,71178133,71178134,G,GR,1
NC_037347.1,NC_032669.1,67381907,71207773,71207779,A,AATTGTT,6
NC_037347.1,NC_032669.1,67525918,71435121,71435122,G,GC,1
NC_037347.1,NC_032669.1,67530071,71439799,71439801,g,gaa,2
NC_037347.1,NC_032669.1,67532909,71442639,71442640,a,ag,1
NC_037347.1,NC_032669.1,67555897,71465818,71465819,G,GS,1
NC_037347.1,NC_032669.1,67565812,71476189,71476194,c,ctgggg,5
NC_037347.1,NC_032669.1,67572344,71482734,71482735,a,aR,1
NC_037347.1,NC_032669.1,67572572,71482963,71482965,t,tNN,2
NC_037347.1,NC_032669.1,67622213,71535418,71535419,A,AC,1
NC_037347.1,NC_032669.1,67625758,71538964,71538989,G,GGTNNNNNNNNNNNNNNNNNNNNNNN,25
NC_037347.1,NC_032669.1,67630062,71543294,71543295,A,AR,1
NC_037347.1,NC_032669.1,67646844,71560077,71560079,g,gga,2
NC_037347.1,NC_032669.1,67718470,71632416,71632419,g,ggtt,3
NC_037347.1,NC_032669.1,67729492,71643450,71643454,G,GAGTT,4
NC_037347.1,NC_032669.1,67823892,71758370,71758371,t,tg,1
NC_037347.1,NC_032669.1,67902375,71836489,71836490,c,cg,1
NC_037347.1,NC_032669.1,67913876,71847993,71847994,T,TC,1
NC_037347.1,NC_032669.1,67978668,71912772,71912773,A,AR,1
NC_037347.1,NC_032669.1,68001275,71935381,71935382,c,cg,1
NC_037347.1,NC_032669.1,68010938,71945046,71945048,C,CCA,2
NC_037347.1,NC_032669.1,68032333,71966598,71966602,T,TCTAA,4
NC_037347.1,NC_032669.1,68035655,71969922,71969923,G,GA,1
NC_037347.1,NC_032669.1,68232937,72173864,72173865,C,CS,1
NC_037347.1,NC_032669.1,68253827,72194710,72194711,t,tc,1
NC_037347.1,NC_032669.1,68269312,72209937,72209938,t,tg,1
NC_037347.1,NC_032669.1,68271407,72212033,72212102,T,TACTGTCTTATGAAATTGTTAACAGGGTCCTTACAAGAACTGTTACAGTACATGCTACAGAAGAGTGTAC,69
NC_037347.1,NC_032669.1,68279849,72220542,72220543,G,GR,1
NC_037347.1,NC_032669.1,68332273,72272912,72272913,T,TK,1
NC_037347.1,NC_032669.1,68335402,72276289,72276301,A,AGGCCAGATAGTT,12
NC_037347.1,NC_032669.1,68365592,72307312,72307313,t,tc,1
NC_037347.1,NC_032669.1,68365629,72307350,72307353,g,gttc,3
NC_037347.1,NC_032669.1,68543273,72484667,72484668,G,GY,1
NC_037347.1,NC_032669.1,68543298,72484693,72484695,t,tga,2
NC_037347.1,NC_032669.1,68548035,72489432,72489433,T,TY,1
NC_037347.1,NC_032669.1,68567532,72508464,72508468,t,tgata,4
NC_037347.1,NC_032669.1,68567678,72508614,72508615,c,ca,1
NC_037347.1,NC_032669.1,68584244,72527297,72527300,t,tagc,3
NC_037347.1,NC_032669.1,68722208,72706484,72706487,G,GTGT,3
NC_037347.1,NC_032669.1,68722220,72706499,72706500,c,ca,1
NC_037347.1,NC_032669.1,68749193,72733545,72733549,T,TCTGA,4
NC_037347.1,NC_032669.1,68818138,72802489,72802490,A,AG,1
NC_037347.1,NC_032669.1,68825156,72809493,72809494,T,TG,1
NC_037347.1,NC_032669.1,68825930,72810268,72810269,A,AR,1
NC_037347.1,NC_032669.1,68828632,72812971,72812972,C,CT,1
NC_037347.1,NC_032669.1,68837167,72821359,72821360,C,CT,1
NC_037347.1,NC_032669.1,68838522,72822718,72822719,g,ga,1
NC_037347.1,NC_032669.1,68864011,72847110,72847111,A,AC,1
NC_037347.1,NC_032669.1,68885235,72868215,72868216,c,ct,1
NC_037347.1,NC_032669.1,68889562,72872543,72872544,C,CA,1
NC_037347.1,NC_032669.1,68893268,72876250,72876254,A,ATAGT,4
NC_037347.1,NC_032669.1,68911864,72894849,72894850,C,CA,1
NC_037347.1,NC_032669.1,68935969,72918774,72918775,G,GT,1
NC_037347.1,NC_032669.1,68948130,72930959,72930960,C,CG,1
NC_037347.1,NC_032669.1,68967244,72950875,72950876,T,TA,1
NC_037347.1,NC_032669.1,68980947,72965888,72965889,G,GC,1
NC_037347.1,NC_032669.1,68981193,72966136,72966137,A,AC,1
NC_037347.1,NC_032669.1,69026489,73017945,73017946,C,CT,1
NC_037347.1,NC_032669.1,69040920,73032381,73032382,A,AW,1
NC_037347.1,NC_032669.1,69046660,73038303,73038304,T,TG,1
NC_037347.1,NC_032669.1,69106122,73112667,73112672,g,gtgcgt,5
NC_037347.1,NC_032669.1,69122571,73129121,73129122,C,CT,1
NC_037347.1,NC_032669.1,69160979,73167592,73167605,a,aaccagtaatgctg,13
NC_037347.1,NC_032669.1,69161618,73168246,73168247,g,ga,1
NC_037347.1,NC_032669.1,69161746,73168375,73168376,a,ac,1
NC_037347.1,NC_032669.1,69507061,73486939,73486940,T,TR,1
NC_037347.1,NC_032669.1,69512364,73492244,73492245,A,AT,1
NC_037347.1,NC_032669.1,69513365,73493246,73493247,t,ta,1
NC_037347.1,NC_032669.1,69514389,73494275,73494280,g,ggggtc,5
NC_037347.1,NC_032669.1,69570749,73550084,73550085,T,TC,1
NC_037347.1,NC_032669.1,69573143,73552479,73552480,T,TC,1
NC_037347.1,NC_032669.1,69584400,73563737,73563738,A,AC,1
NC_037347.1,NC_032669.1,69617981,73597353,73597354,G,GT,1
NC_037347.1,NC_032669.1,69630061,73609443,73609449,c,caaaaaa,6
NC_037347.1,NC_032669.1,69632192,73611328,73611330,c,cat,2
NC_037347.1,NC_032669.1,69691760,73679748,73679749,t,tW,1
NC_037347.1,NC_032669.1,69695153,73683144,73683146,A,AAT,2
NC_037347.1,NC_032669.1,69750576,73738035,73738036,C,CG,1
NC_037347.1,NC_032669.1,69751517,73738978,73738979,T,TC,1
NC_037347.1,NC_032669.1,69772548,73759989,73759990,g,ga,1
NC_037347.1,NC_032669.1,69774655,73762167,73762175,T,TCTGGGGGA,8
NC_037347.1,NC_032669.1,69776690,73764208,73764209,C,CT,1
NC_037347.1,NC_032669.1,69804784,73791561,73791562,c,ct,1
NC_037347.1,NC_032669.1,69812411,73799189,73799190,T,TC,1
NC_037347.1,NC_032669.1,69818898,73805677,73805679,G,GGA,2
NC_037347.1,NC_032669.1,69868507,73855749,73855750,a,ag,1
NC_037347.1,NC_032669.1,69869715,73856962,73856966,a,agtgt,4
NC_037347.1,NC_032669.1,69870834,73858085,73858087,T,TTC,2
NC_037347.1,NC_032669.1,69870841,73858094,73858095,t,tg,1
NC_037347.1,NC_032669.1,69871647,73858901,73859125,C,CTCAGTGCTCATCCTGGAAGAGAAGTGTCGCAAGGGTAAAGTGTCACCAATTTTTGCTCAGTGCTCATCCTGGAAGAGAAGTGTCGCAAGGGTAAAGTGTNNNNNNNNNNNNNNNNNNNNNNNNNNNNNNNNNNNNNNNNNNNNNNNNNNNNNNNNNNNNNNNNNNNNNNNNNNNNNNNNNNNNNNNNNNNNNNNNNNNNNNNNNNNNNNNNNNNNNNNNNNNNN,224
NC_037347.1,NC_032669.1,69891052,73877678,73877679,C,CT,1
NC_037347.1,NC_032669.1,69898478,73885104,73885105,A,AR,1
NC_037347.1,NC_032669.1,69918286,73905125,73905126,C,CM,1
NC_037347.1,NC_032669.1,69926736,73913968,73913970,A,AGT,2
NC_037347.1,NC_032669.1,69938270,73925505,73925506,g,ga,1
NC_037347.1,NC_032669.1,69947819,73934631,73934632,g,gt,1
NC_037347.1,NC_032669.1,69999848,73986662,73986663,G,GC,1
NC_037347.1,NC_032669.1,70002491,73989308,73989309,G,GR,1
NC_037347.1,NC_032669.1,70046639,74083015,74083016,g,gc,1
NC_037347.1,NC_032669.1,70067520,74103821,74103822,T,TC,1
NC_037347.1,NC_032669.1,70076019,74112126,74112128,A,ATT,2
NC_037347.1,NC_032669.1,70076641,74112746,74112749,T,TGTC,3
NC_037347.1,NC_032669.1,70078984,74115095,74115111,T,TAGAAGCAAGAGTCTGG,16
NC_037347.1,NC_032669.1,70081306,74117905,74117909,c,ctgag,4
NC_037347.1,NC_032669.1,70106737,74143345,74143348,C,CCCA,3
NC_037347.1,NC_032669.1,70171167,74207491,74207493,C,CAA,2
NC_037347.1,NC_032669.1,70235428,74273960,74273972,C,CNNNNNNNNNNNN,12
NC_037347.1,NC_032669.1,70247132,74285687,74285695,g,gtgcgcgca,8
NC_037347.1,NC_032669.1,70247170,74285733,74285755,g,gtgcgtgtgtgtgtgtgcgcgca,22
NC_037347.1,NC_032669.1,70256705,74295473,74295474,G,GT,1
NC_037347.1,NC_032669.1,70268036,74306804,74306846,G,GNNNNNNNNNNNNNNNNNNNNNNNNNNNNNNNNNNNNNNNNNN,42
NC_037347.1,NC_032669.1,70305174,74343972,74343976,a,aNNNN,4
NC_037347.1,NC_032669.1,70342195,74380882,74380883,g,gt,1
NC_037347.1,NC_032669.1,70342419,74381107,74381115,G,GGACACCCA,8
NC_037347.1,NC_032669.1,70361686,74400899,74400900,A,AT,1
NC_037347.1,NC_032669.1,70367496,74406808,74406809,g,ga,1
NC_037347.1,NC_032669.1,70382813,74422523,74422537,c,catgcgtgtgtgtgt,14
NC_037347.1,NC_032669.1,70398215,74437487,74437489,C,CAG,2
NC_037347.1,NC_032669.1,70415101,74454285,74454286,G,GR,1
NC_037347.1,NC_032669.1,70437774,74476841,74476845,a,aaaag,4
NC_037347.1,NC_032669.1,70458935,74499256,74499257,C,CA,1
NC_037347.1,NC_032669.1,70470667,74510988,74510989,G,GT,1
NC_037347.1,NC_032669.1,70612526,74672961,74672962,G,GR,1
NC_037347.1,NC_032669.1,70612742,74673178,74673179,G,GR,1
NC_037347.1,NC_032669.1,70620342,74680791,74680802,t,taataaaaatta,11
NC_037347.1,NC_032669.1,70622613,74683073,74683074,a,at,1
NC_037347.1,NC_032669.1,70623732,74684193,74684194,A,AW,1
NC_037347.1,NC_032669.1,70750753,74811288,74811289,A,AC,1
NC_037347.1,NC_032669.1,70953238,74990111,74990112,C,CG,1
NC_037347.1,NC_032669.1,70955684,74992515,74992521,c,ctccccT,6
NC_037347.1,NC_032669.1,70959096,74995933,74995934,G,GT,1
NC_037347.1,NC_032669.1,70963021,74999817,74999818,G,GC,1
NC_037347.1,NC_032669.1,71029398,75065899,75065934,T,TAAGAGATNNNNNNNNNNNNNNNNNNNNNNNNNNNN,35
NC_037347.1,NC_032669.1,71048761,75085298,75085300,a,acg,2
NC_037347.1,NC_032669.1,71076305,75113019,75113020,G,GC,1
NC_037347.1,NC_032669.1,71127469,75163294,75163295,C,CA,1
NC_037347.1,NC_032669.1,71141064,75176889,75176890,T,TA,1
NC_037347.1,NC_032669.1,71144682,75180484,75180485,G,GC,1
NC_037347.1,NC_032669.1,71149415,75185219,75185220,G,GC,1
NC_037347.1,NC_032669.1,71176618,75212762,75212763,g,gc,1
NC_037347.1,NC_032669.1,71190421,75226565,75226566,G,GS,1
NC_037347.1,NC_032669.1,71196629,75232837,75232838,C,CN,1
NC_037347.1,NC_032669.1,71271632,75368473,75368474,C,CA,1
NC_037347.1,NC_032669.1,71288624,75386389,75386435,C,CNNNNNNNNNNNNNNNNNNNNNNNNNNNNNNNNNNNNNNNNNNNNNN,46
NC_037347.1,NC_032669.1,71288935,75386746,75386747,G,GC,1
NC_037347.1,NC_032669.1,71318125,75417892,75417893,T,TC,1
NC_037347.1,NC_032669.1,71407132,75506667,75506668,t,tg,1
NC_037347.1,NC_032669.1,71416874,75512205,75512206,A,AG,1
NC_037347.1,NC_032669.1,71474392,75568849,75568850,G,GS,1
NC_037347.1,NC_032669.1,71725148,75819258,75819259,C,CT,1
