Reference ID,Query ID,Reference POS,Query POS,Query END,REF,ALT,SVLEN
NC_037355.1,NC_032677.1,995986,15027,15032,C,CGAATG,5
NC_037355.1,NC_032677.1,996569,15613,15614,A,AT,1
NC_037355.1,NC_032677.1,1130060,148762,148763,T,TC,1
NC_037355.1,NC_032677.1,1130236,148939,148941,G,GCT,2
NC_037355.1,NC_032677.1,1183994,202569,202570,T,TC,1
NC_037355.1,NC_032677.1,1207833,233061,233062,A,AT,1
NC_037355.1,NC_032677.1,1247474,275142,275143,G,GT,1
NC_037355.1,NC_032677.1,1251094,278771,278772,t,tc,1
NC_037355.1,NC_032677.1,1251103,278781,278794,c,caacacttctcatg,13
NC_037355.1,NC_032677.1,1252218,279909,279911,a,atc,2
NC_037355.1,NC_032677.1,1252295,279988,279996,a,atggtggag,8
NC_037355.1,NC_032677.1,1252494,280195,280196,a,ag,1
NC_037355.1,NC_032677.1,1253580,281281,281282,G,GT,1
NC_037355.1,NC_032677.1,1255176,282903,282948,g,gacagtAAANNNNNNNNNNNNNNNNNNNNNNNNNNNNNNNNNNNNN,45
NC_037355.1,NC_032677.1,1255227,282999,283000,a,at,1
NC_037355.1,NC_032677.1,1268550,296177,296178,G,GS,1
NC_037355.1,NC_032677.1,1298533,586267,586268,C,CM,1
NC_037355.1,NC_032677.1,1349157,375715,375719,t,ttttg,4
NC_037355.1,NC_032677.1,1528836,555300,555301,G,GA,1
NC_037355.1,NC_032677.1,1731230,1884352,1884354,c,ctt,2
NC_037355.1,NC_032677.1,1768631,1921726,1921727,a,ag,1
NC_037355.1,NC_032677.1,1775129,1928225,1928261,A,AACTCGTCTACAGCATCAAGCCCACTGGGCTGTGCTT,36
NC_037355.1,NC_032677.1,1790083,1943216,1943217,t,ta,1
NC_037355.1,NC_032677.1,1790091,1943225,1943226,g,ga,1
NC_037355.1,NC_032677.1,1790106,1943241,1943251,t,tgagagagaga,10
NC_037355.1,NC_032677.1,1942697,2072566,2072567,A,AG,1
NC_037355.1,NC_032677.1,1969508,2099512,2099514,T,TMK,2
NC_037355.1,NC_032677.1,2044842,2187101,2187105,T,TTGAC,4
NC_037355.1,NC_032677.1,2095658,2237949,2237950,c,ca,1
NC_037355.1,NC_032677.1,2105976,2248223,2248224,A,AG,1
NC_037355.1,NC_032677.1,2106518,2248767,2248768,C,CA,1
NC_037355.1,NC_032677.1,2109233,2251483,2251484,C,CT,1
NC_037355.1,NC_032677.1,2128830,2272927,2272928,g,gc,1
NC_037355.1,NC_032677.1,2150011,2294106,2294109,g,gctc,3
NC_037355.1,NC_032677.1,2154040,2298269,2298270,T,TC,1
NC_037355.1,NC_032677.1,2154341,2298571,2298573,A,ATT,2
NC_037355.1,NC_032677.1,2157772,2302021,2302022,T,TC,1
NC_037355.1,NC_032677.1,2160066,2304248,2304249,A,AC,1
NC_037355.1,NC_032677.1,2184345,2328556,2328557,G,GC,1
NC_037355.1,NC_032677.1,2184970,2329183,2329187,T,TGTGA,4
NC_037355.1,NC_032677.1,2187932,2332147,2332150,a,aaat,3
NC_037355.1,NC_032677.1,2188842,2333060,2333061,T,TY,1
NC_037355.1,NC_032677.1,2200242,2344463,2344464,C,CT,1
NC_037355.1,NC_032677.1,2280392,2424708,2424709,G,GA,1
NC_037355.1,NC_032677.1,2281209,2425526,2425527,T,TA,1
NC_037355.1,NC_032677.1,2290422,2434719,2434720,g,ga,1
NC_037355.1,NC_032677.1,2292069,2436366,2436367,g,ga,1
NC_037355.1,NC_032677.1,2302734,2447008,2447009,g,ga,1
NC_037355.1,NC_032677.1,2309814,2454044,2454045,C,CY,1
NC_037355.1,NC_032677.1,2320375,2465796,2465798,A,AAC,2
NC_037355.1,NC_032677.1,2322312,2467734,2467735,a,ag,1
NC_037355.1,NC_032677.1,2333740,2479162,2479163,g,ga,1
NC_037355.1,NC_032677.1,2349284,2516962,2516974,A,AGCCTGGACATTT,12
NC_037355.1,NC_032677.1,2362077,2529148,2529152,g,gagNN,4
NC_037355.1,NC_032677.1,2378133,2545209,2545211,a,aat,2
NC_037355.1,NC_032677.1,2378170,2545248,2545259,a,atcatttatttt,11
NC_037355.1,NC_032677.1,4563285,2564671,2564674,A,ACGT,3
NC_037355.1,NC_032677.1,4565434,2566825,2566826,A,AR,1
NC_037355.1,NC_032677.1,4571070,2572463,2572464,a,ag,1
NC_037355.1,NC_032677.1,4577889,2579289,2579293,T,TAGAC,4
NC_037355.1,NC_032677.1,4592862,2594280,2594288,g,gcgcgcgca,8
NC_037355.1,NC_032677.1,4601614,2603039,2603040,a,ag,1
NC_037355.1,NC_032677.1,4609213,2610641,2610660,T,TGATGCACACATTGATGTGG,19
NC_037355.1,NC_032677.1,4612249,2613695,2613696,a,at,1
NC_037355.1,NC_032677.1,4615834,2617283,2617284,a,at,1
NC_037355.1,NC_032677.1,4616789,2618237,2618238,t,tc,1
NC_037355.1,NC_032677.1,4616805,2618254,2618269,a,actgtggcctgccagg,15
NC_037355.1,NC_032677.1,4617027,2618491,2618492,A,AG,1
NC_037355.1,NC_032677.1,4622314,2623795,2623796,G,GC,1
NC_037355.1,NC_032677.1,4641504,2642970,2642973,g,gata,3
NC_037355.1,NC_032677.1,4653258,2654747,2654758,g,gctctctccctc,11
NC_037355.1,NC_032677.1,4675221,2676729,2676730,A,AC,1
NC_037355.1,NC_032677.1,4713847,2715355,2715356,A,AT,1
NC_037355.1,NC_032677.1,4731309,2732817,2732836,A,AGGAGAATCAGTGAGATTCT,19
NC_037355.1,NC_032677.1,4734858,2736386,2736387,G,GC,1
NC_037355.1,NC_032677.1,4738113,2739627,2739639,t,tNNNNNNNNNNNN,12
NC_037355.1,NC_032677.1,4802970,2799611,2799612,t,tc,1
NC_037355.1,NC_032677.1,4808876,2805557,2805558,c,ca,1
NC_037355.1,NC_032677.1,4858245,2855099,2855100,A,AG,1
NC_037355.1,NC_032677.1,4878942,2875803,2875804,a,ag,1
NC_037355.1,NC_032677.1,5105088,3120846,3120847,a,at,1
NC_037355.1,NC_032677.1,5139926,3155689,3155693,t,tatac,4
NC_037355.1,NC_032677.1,5159886,3175372,3175379,A,AACACTTC,7
NC_037355.1,NC_032677.1,5159930,3175423,3175424,A,AC,1
NC_037355.1,NC_032677.1,5227063,3242647,3242649,t,taa,2
NC_037355.1,NC_032677.1,5229465,3245000,3245001,G,GA,1
NC_037355.1,NC_032677.1,5239204,3254740,3254741,T,TM,1
NC_037355.1,NC_032677.1,5245046,3260581,3260585,T,TAGAG,4
NC_037355.1,NC_032677.1,5250974,3266515,3266522,a,aaaaaaRG,7
NC_037355.1,NC_032677.1,5260640,3276194,3276195,T,TG,1
NC_037355.1,NC_032677.1,5295607,3311151,3311155,T,TCAGA,4
NC_037355.1,NC_032677.1,5304745,3320293,3320295,T,TAC,2
NC_037355.1,NC_032677.1,5337918,3353462,3353463,T,TY,1
NC_037355.1,NC_032677.1,5363186,3378997,3378998,T,TC,1
NC_037355.1,NC_032677.1,5367884,3383696,3383697,A,AG,1
NC_037355.1,NC_032677.1,5396812,3412628,3412629,c,ca,1
NC_037355.1,NC_032677.1,5413553,3429369,3429370,a,at,1
NC_037355.1,NC_032677.1,5434976,3451754,3451755,G,GA,1
NC_037355.1,NC_032677.1,5437188,3453692,3453694,a,aaN,2
NC_037355.1,NC_032677.1,5449066,3465572,3465577,a,aacacc,5
NC_037355.1,NC_032677.1,5449904,3466413,3466414,A,AG,1
NC_037355.1,NC_032677.1,5457539,3474078,3474079,T,TC,1
NC_037355.1,NC_032677.1,5561658,3687690,3687691,a,at,1
NC_037355.1,NC_032677.1,5561731,3687764,3687766,a,aac,2
NC_037355.1,NC_032677.1,5566850,3692895,3692896,a,at,1
NC_037355.1,NC_032677.1,5604141,3732575,3732576,t,tc,1
NC_037355.1,NC_032677.1,5610459,3738898,3738899,A,AR,1
NC_037355.1,NC_032677.1,5626544,3756906,3756908,a,aNN,2
NC_037355.1,NC_032677.1,5642140,3772410,3772411,c,cY,1
NC_037355.1,NC_032677.1,5642144,3772415,3772416,g,gt,1
NC_037355.1,NC_032677.1,5688314,3819896,3819897,C,CA,1
NC_037355.1,NC_032677.1,5688318,3819901,3819902,C,CA,1
NC_037355.1,NC_032677.1,5907234,4183188,4183190,t,tca,2
NC_037355.1,NC_032677.1,5914806,4190762,4190763,G,GT,1
NC_037355.1,NC_032677.1,5990488,4266510,4266511,g,ga,1
NC_037355.1,NC_032677.1,5997966,4273977,4273978,A,AC,1
NC_037355.1,NC_032677.1,6027034,4302894,4302895,T,TG,1
NC_037355.1,NC_032677.1,6027899,4303754,4303755,c,ca,1
NC_037355.1,NC_032677.1,6284338,4625607,4625611,c,cgctt,4
NC_037355.1,NC_032677.1,6465542,4806818,4806819,a,ag,1
NC_037355.1,NC_032677.1,6467146,4808423,4808424,t,tg,1
NC_037355.1,NC_032677.1,6472918,4814194,4814220,T,TAACATCAAAGTTAGATGATGTTAACC,26
NC_037355.1,NC_032677.1,6473792,4815094,4815095,a,at,1
NC_037355.1,NC_032677.1,6481543,4822844,4822845,C,CA,1
NC_037355.1,NC_032677.1,6547643,4888925,4888927,t,taa,2
NC_037355.1,NC_032677.1,6551424,4892709,4892710,T,TY,1
NC_037355.1,NC_032677.1,6619696,4959935,4959937,g,gga,2
NC_037355.1,NC_032677.1,6919418,5222159,5222163,G,GAGTC,4
NC_037355.1,NC_032677.1,6921338,5224083,5224084,t,ta,1
NC_037355.1,NC_032677.1,6940678,5243424,5243427,T,TGTC,3
NC_037355.1,NC_032677.1,6977689,5308598,5308599,c,ct,1
NC_037355.1,NC_032677.1,7002382,5333293,5333294,A,AT,1
NC_037355.1,NC_032677.1,7004588,5335451,5335452,t,tg,1
NC_037355.1,NC_032677.1,7019124,5350268,5350270,G,GGR,2
NC_037355.1,NC_032677.1,7020841,5351987,5351988,c,ct,1
NC_037355.1,NC_032677.1,7061905,5396503,5396514,g,gttttttttttt,11
NC_037355.1,NC_032677.1,7108379,5446018,5446019,g,ga,1
NC_037355.1,NC_032677.1,7155602,5639592,5639593,a,aM,1
NC_037355.1,NC_032677.1,7226396,5709891,5709892,t,ta,1
NC_037355.1,NC_032677.1,7236670,5720166,5720167,t,ta,1
NC_037355.1,NC_032677.1,7244741,5726833,5726834,t,ta,1
NC_037355.1,NC_032677.1,7248551,5728718,5728719,G,GC,1
NC_037355.1,NC_032677.1,7254990,5735166,5735167,C,CW,1
NC_037355.1,NC_032677.1,7262182,5742356,5742357,C,CT,1
NC_037355.1,NC_032677.1,7262264,5742439,5742440,T,TG,1
NC_037355.1,NC_032677.1,7264801,5744966,5744967,G,GR,1
NC_037355.1,NC_032677.1,7265352,5745514,5745516,c,ctt,2
NC_037355.1,NC_032677.1,7267262,5747425,5747428,T,TTAA,3
NC_037355.1,NC_032677.1,7272078,5752139,5752141,g,ggK,2
NC_037355.1,NC_032677.1,7277763,5757840,5757841,t,tc,1
NC_037355.1,NC_032677.1,7304335,5784420,5784422,G,GAT,2
NC_037355.1,NC_032677.1,7305275,5785362,5785363,t,tc,1
NC_037355.1,NC_032677.1,7307893,5787980,5787982,c,cta,2
NC_037355.1,NC_032677.1,7405339,5884890,5884891,G,GC,1
NC_037355.1,NC_032677.1,7437118,5916504,5916505,T,TG,1
NC_037355.1,NC_032677.1,7489463,5968888,5968889,G,GC,1
NC_037355.1,NC_032677.1,7496837,5976258,5976284,T,TCTAGGGAAGGTGGGGAGGTGATTTTA,26
NC_037355.1,NC_032677.1,7498527,5977973,5977977,c,catgt,4
NC_037355.1,NC_032677.1,7532259,6011893,6011894,A,AG,1
NC_037355.1,NC_032677.1,7563630,6043261,6043262,G,GA,1
NC_037355.1,NC_032677.1,7613297,6092970,6092971,A,AW,1
NC_037355.1,NC_032677.1,7613533,6093206,6093207,a,at,1
NC_037355.1,NC_032677.1,7613812,6093486,6093487,t,tc,1
NC_037355.1,NC_032677.1,7650299,6129977,6129978,A,AG,1
NC_037355.1,NC_032677.1,7686509,6166185,6166186,g,ga,1
NC_037355.1,NC_032677.1,7699087,6177928,6177930,t,tNN,2
NC_037355.1,NC_032677.1,7722688,6201540,6201541,A,AR,1
NC_037355.1,NC_032677.1,7789485,6268337,6268338,C,CY,1
NC_037355.1,NC_032677.1,7797966,6276818,6276821,T,TGTG,3
NC_037355.1,NC_032677.1,7801067,6279922,6279925,G,GGGT,3
NC_037355.1,NC_032677.1,7804616,6283475,6283476,A,AR,1
NC_037355.1,NC_032677.1,7855078,6333899,6333906,G,GTCTATCT,7
NC_037355.1,NC_032677.1,7855521,6334350,6334352,t,ttg,2
NC_037355.1,NC_032677.1,7924909,6403482,6403492,c,ccatctcctgg,10
NC_037355.1,NC_032677.1,7974730,6453381,6453390,A,ACACATGAAT,9
NC_037355.1,NC_032677.1,7975734,6454394,6454396,a,aat,2
NC_037355.1,NC_032677.1,8074492,6552307,6552308,g,gc,1
NC_037355.1,NC_032677.1,8093712,6574906,6574907,c,cM,1
NC_037355.1,NC_032677.1,8120461,6601655,6601668,C,CTCATGGGTTTCTG,13
NC_037355.1,NC_032677.1,8122400,6603612,6603613,c,ca,1
NC_037355.1,NC_032677.1,8122869,6604082,6604087,a,aaaaat,5
NC_037355.1,NC_032677.1,8155897,6637136,6637137,T,TG,1
NC_037355.1,NC_032677.1,8471083,6952391,6952395,C,CTGTT,4
NC_037355.1,NC_032677.1,8564256,7045552,7045556,a,aaaag,4
NC_037355.1,NC_032677.1,8627502,7108157,7108158,t,tc,1
NC_037355.1,NC_032677.1,8762184,7242052,7242053,c,ca,1
NC_037355.1,NC_032677.1,8835577,7314365,7314367,T,TTA,2
NC_037355.1,NC_032677.1,8901311,7378932,7378936,A,ATCTG,4
NC_037355.1,NC_032677.1,9051585,7528467,7528468,T,TC,1
NC_037355.1,NC_032677.1,9422303,7960113,7960115,c,ctt,2
NC_037355.1,NC_032677.1,9492479,8030224,8030225,t,ta,1
NC_037355.1,NC_032677.1,9501770,8039517,8039526,t,ttttctggaa,9
NC_037355.1,NC_032677.1,9501774,8039530,8039534,a,agctg,4
NC_037355.1,NC_032677.1,9501821,8039581,8039582,t,tc,1
NC_037355.1,NC_032677.1,9501856,8039617,8039619,c,ctt,2
NC_037355.1,NC_032677.1,9579633,8117536,8117537,T,TG,1
NC_037355.1,NC_032677.1,9614750,8152655,8152661,c,cttcact,6
NC_037355.1,NC_032677.1,9788764,8323877,8323878,T,TC,1
NC_037355.1,NC_032677.1,9941312,8476414,8476415,c,cg,1
NC_037355.1,NC_032677.1,10169752,8729699,8729700,a,ac,1
NC_037355.1,NC_032677.1,10287902,8849403,8849404,A,AT,1
NC_037355.1,NC_032677.1,10288029,8849531,8849532,C,CA,1
NC_037355.1,NC_032677.1,10288037,8849540,8849541,c,ca,1
NC_037355.1,NC_032677.1,10383871,8944776,8944777,T,TA,1
NC_037355.1,NC_032677.1,10460140,9023412,9023413,G,GK,1
NC_037355.1,NC_032677.1,10547016,9110002,9110003,t,ta,1
NC_037355.1,NC_032677.1,10575633,9138719,9138720,t,ta,1
NC_037355.1,NC_032677.1,10929502,9495379,9495380,A,AW,1
NC_037355.1,NC_032677.1,10999481,9565363,9565364,t,ta,1
NC_037355.1,NC_032677.1,11043159,9608645,9608646,g,ga,1
NC_037355.1,NC_032677.1,11111202,9676590,9676591,a,ag,1
NC_037355.1,NC_032677.1,11150282,9717704,9717705,t,tc,1
NC_037355.1,NC_032677.1,11152231,9719654,9719655,a,at,1
NC_037355.1,NC_032677.1,11211457,9789572,9789573,c,ca,1
NC_037355.1,NC_032677.1,11272934,9851189,9851190,c,ca,1
NC_037355.1,NC_032677.1,11355218,9936280,9936281,A,AG,1
NC_037355.1,NC_032677.1,11355233,9936296,9936297,T,TG,1
NC_037355.1,NC_032677.1,11483198,10104125,10104126,t,tY,1
NC_037355.1,NC_032677.1,11555789,10176722,10176727,a,aaaaac,5
NC_037355.1,NC_032677.1,11564208,10185141,10185142,a,at,1
NC_037355.1,NC_032677.1,11583554,10204484,10204486,a,aNN,2
NC_037355.1,NC_032677.1,11638437,10261822,10261828,t,tNNNNNN,6
NC_037355.1,NC_032677.1,11674975,10298373,10298374,a,ag,1
NC_037355.1,NC_032677.1,11794308,10417721,10417736,T,TAAGTTTAGTGGGGCC,15
NC_037355.1,NC_032677.1,11822490,10445918,10445922,a,aaaac,4
NC_037355.1,NC_032677.1,12175122,10801248,10801249,T,TC,1
NC_037355.1,NC_032677.1,12206707,10832454,10832457,C,CCTT,3
NC_037355.1,NC_032677.1,12348794,10974385,10974386,c,ct,1
NC_037355.1,NC_032677.1,12474012,11101965,11101966,g,gt,1
NC_037355.1,NC_032677.1,12502047,11129990,11129991,g,gc,1
NC_037355.1,NC_032677.1,12539522,11167467,11167468,c,ct,1
NC_037355.1,NC_032677.1,12742418,11370297,11370299,g,gcc,2
NC_037355.1,NC_032677.1,12745647,11373528,11373532,g,gggac,4
NC_037355.1,NC_032677.1,12758675,11386560,11386561,g,gc,1
NC_037355.1,NC_032677.1,12758682,11386568,11386569,t,tg,1
NC_037355.1,NC_032677.1,12764749,11392641,11392642,G,GA,1
NC_037355.1,NC_032677.1,12764796,11392689,11392690,C,CA,1
NC_037355.1,NC_032677.1,12765487,11393381,11393382,t,ta,1
NC_037355.1,NC_032677.1,12765629,11393542,11393544,c,caa,2
NC_037355.1,NC_032677.1,12765661,11393576,11393577,a,at,1
NC_037355.1,NC_032677.1,12794057,11421901,11421902,t,ta,1
NC_037355.1,NC_032677.1,12981048,11608794,11608795,c,ca,1
NC_037355.1,NC_032677.1,13025885,11652565,11652566,A,AR,1
NC_037355.1,NC_032677.1,13102479,11730908,11730911,a,atct,3
NC_037355.1,NC_032677.1,13245987,11897992,11897999,c,caaggcct,7
NC_037355.1,NC_032677.1,13359945,12055498,12055499,t,tc,1
NC_037355.1,NC_032677.1,13487727,12184360,12184361,G,GR,1
NC_037355.1,NC_032677.1,13496235,12192868,12192870,G,GGC,2
NC_037355.1,NC_032677.1,13622260,12318893,12318894,C,CS,1
NC_037355.1,NC_032677.1,13689624,12386333,12386334,T,TA,1
NC_037355.1,NC_032677.1,13825055,12521770,12521773,G,GAGA,3
NC_037355.1,NC_032677.1,13894699,12596955,12596956,c,ct,1
NC_037355.1,NC_032677.1,13969702,12671969,12671987,A,ACAGACATTAAACATCCCT,18
NC_037355.1,NC_032677.1,14007246,12709211,12709214,A,ACTC,3
NC_037355.1,NC_032677.1,14015849,12717819,12717820,C,CY,1
NC_037355.1,NC_032677.1,14059495,12761454,12761455,t,ta,1
NC_037355.1,NC_032677.1,14069661,12771622,12771623,c,cg,1
NC_037355.1,NC_032677.1,14177082,12879082,12879083,a,at,1
NC_037355.1,NC_032677.1,14220810,12922831,12922833,t,tNN,2
NC_037355.1,NC_032677.1,14267870,12969890,12969893,C,CCTT,3
NC_037355.1,NC_032677.1,14271100,12973134,12973136,T,TTC,2
NC_037355.1,NC_032677.1,14273273,12975308,12975309,t,ta,1
NC_037355.1,NC_032677.1,14318241,13020281,13020286,A,AATTAT,5
NC_037355.1,NC_032677.1,14366635,13068675,13068678,A,ACTT,3
NC_037355.1,NC_032677.1,14458252,13152716,13152717,g,gc,1
NC_037355.1,NC_032677.1,14464120,13158600,13158602,t,tga,2
NC_037355.1,NC_032677.1,14485058,13179595,13179596,a,at,1
NC_037355.1,NC_032677.1,14635223,13334059,13334063,g,gtcgc,4
NC_037355.1,NC_032677.1,14659525,13360078,13360079,a,at,1
NC_037355.1,NC_032677.1,14824248,13528492,13528494,t,tNN,2
NC_037355.1,NC_032677.1,14850202,13554448,13554458,t,ttgccaacaaa,10
NC_037355.1,NC_032677.1,14850354,13554610,13554611,a,at,1
NC_037355.1,NC_032677.1,14884288,13588548,13588556,a,aNNNNNNNN,8
NC_037355.1,NC_032677.1,14884965,13589233,13589234,T,TW,1
NC_037355.1,NC_032677.1,14919226,13623501,13623502,G,GA,1
NC_037355.1,NC_032677.1,15011985,13716468,13716469,C,CS,1
NC_037355.1,NC_032677.1,15107167,13812596,13812597,C,CT,1
NC_037355.1,NC_032677.1,15110351,13815781,13815783,a,acg,2
NC_037355.1,NC_032677.1,15112373,13817805,13817806,A,AT,1
NC_037355.1,NC_032677.1,15133674,13839115,13839119,t,ttttc,4
NC_037355.1,NC_032677.1,15138901,13844345,13844347,a,aat,2
NC_037355.1,NC_032677.1,15162230,13867711,13867713,C,CAT,2
NC_037355.1,NC_032677.1,15162485,13867969,13867970,a,ag,1
NC_037355.1,NC_032677.1,15162708,13868192,13868197,c,cacaaa,5
NC_037355.1,NC_032677.1,15165574,13871063,13871064,g,gt,1
NC_037355.1,NC_032677.1,15247705,13953210,13953211,a,at,1
NC_037355.1,NC_032677.1,15280218,13985726,13985727,G,GA,1
NC_037355.1,NC_032677.1,15377874,14083385,14083399,a,aWgtgtgtgtgtgtg,14
NC_037355.1,NC_032677.1,15380863,14086388,14086390,t,taa,2
NC_037355.1,NC_032677.1,15404629,14110849,14110850,t,tc,1
NC_037355.1,NC_032677.1,15413656,14119876,14119877,T,TW,1
NC_037355.1,NC_032677.1,15415185,14121406,14121407,t,ta,1
NC_037355.1,NC_032677.1,15416110,14122332,14122333,a,aW,1
NC_037355.1,NC_032677.1,15437349,14143431,14143432,t,tc,1
NC_037355.1,NC_032677.1,15449793,14155872,14155876,a,aagcg,4
NC_037355.1,NC_032677.1,15500896,14206997,14206999,T,TCA,2
NC_037355.1,NC_032677.1,15545495,14251497,14251501,c,caatg,4
NC_037355.1,NC_032677.1,15609463,14315626,14315628,t,tag,2
NC_037355.1,NC_032677.1,15610719,14326226,14326227,t,tc,1
NC_037355.1,NC_032677.1,15655150,14376009,14376010,T,TY,1
NC_037355.1,NC_032677.1,15669888,14390748,14390750,c,ctt,2
NC_037355.1,NC_032677.1,15693118,14413987,14413988,c,ct,1
NC_037355.1,NC_032677.1,15699536,14420407,14420409,A,AAM,2
NC_037355.1,NC_032677.1,15799841,14520710,14520711,c,ca,1
NC_037355.1,NC_032677.1,15838652,14597220,14597224,C,CAGAA,4
NC_037355.1,NC_032677.1,15863736,14622306,14622314,g,gNNNNNNNN,8
NC_037355.1,NC_032677.1,15900326,14658906,14658907,t,tW,1
NC_037355.1,NC_032677.1,15931583,14690172,14690173,c,ca,1
NC_037355.1,NC_032677.1,15956737,14715324,14715326,C,CCT,2
NC_037355.1,NC_032677.1,15963860,14724381,14724392,C,CAAAGGAGCAGG,11
NC_037355.1,NC_032677.1,15998501,14759467,14759468,C,CA,1
NC_037355.1,NC_032677.1,16035699,14796657,14796658,c,ct,1
NC_037355.1,NC_032677.1,16082766,14891437,14891438,T,TA,1
NC_037355.1,NC_032677.1,16154831,14964075,14964076,t,tg,1
NC_037355.1,NC_032677.1,16168884,14977817,14977818,t,tg,1
NC_037355.1,NC_032677.1,16172255,14981194,14981195,T,TW,1
NC_037355.1,NC_032677.1,16177468,14986410,14986411,t,ta,1
NC_037355.1,NC_032677.1,16221094,15030054,15030055,g,gR,1
NC_037355.1,NC_032677.1,16239127,15048087,15048088,t,tg,1
NC_037355.1,NC_032677.1,16275702,15084670,15084671,g,ga,1
NC_037355.1,NC_032677.1,16276101,15085071,15085073,g,gaa,2
NC_037355.1,NC_032677.1,16296905,15106968,15106969,G,GT,1
NC_037355.1,NC_032677.1,16316778,15172690,15172691,G,GA,1
NC_037355.1,NC_032677.1,16318509,15174667,15174670,A,AATC,3
NC_037355.1,NC_032677.1,16318597,15174758,15174771,C,CAGAATGCGTTCTT,13
NC_037355.1,NC_032677.1,16320449,15176623,15176628,A,ATGACT,5
NC_037355.1,NC_032677.1,16332474,15188656,15188657,T,TN,1
NC_037355.1,NC_032677.1,16363317,15219501,15219502,A,AG,1
NC_037355.1,NC_032677.1,16371722,15227908,15227909,t,tc,1
NC_037355.1,NC_032677.1,16373731,15229986,15229987,a,at,1
NC_037355.1,NC_032677.1,16410698,15266956,15266957,a,at,1
NC_037355.1,NC_032677.1,16410773,15267032,15267033,G,GR,1
NC_037355.1,NC_032677.1,16412067,15268328,15268329,T,TW,1
NC_037355.1,NC_032677.1,16413911,15270172,15270174,T,TAG,2
NC_037355.1,NC_032677.1,16413917,15270180,15270181,G,GT,1
NC_037355.1,NC_032677.1,16458809,15335031,15335032,T,TG,1
NC_037355.1,NC_032677.1,16470809,15347042,15347043,a,at,1
NC_037355.1,NC_032677.1,16472459,15348692,15348693,c,ct,1
NC_037355.1,NC_032677.1,16505809,15382052,15382057,t,tttttc,5
NC_037355.1,NC_032677.1,16505822,15382070,15382071,a,at,1
NC_037355.1,NC_032677.1,16511789,15388037,15388039,G,GTC,2
NC_037355.1,NC_032677.1,16513743,15389992,15390011,C,CCTGTGGAGGTTGATCTGGG,19
NC_037355.1,NC_032677.1,16621964,15455159,15455160,t,tc,1
NC_037355.1,NC_032677.1,16624638,15457830,15457831,C,CM,1
NC_037355.1,NC_032677.1,16634671,15467516,15467517,A,AW,1
NC_037355.1,NC_032677.1,16649520,15482388,15482389,C,CG,1
NC_037355.1,NC_032677.1,16654823,15487692,15487694,G,GGA,2
NC_037355.1,NC_032677.1,16692756,15525647,15525648,t,tW,1
NC_037355.1,NC_032677.1,16711626,15544524,15544525,a,ac,1
NC_037355.1,NC_032677.1,16711680,15544579,15544580,G,GA,1
NC_037355.1,NC_032677.1,16711685,15544585,15544586,T,TA,1
NC_037355.1,NC_032677.1,16734805,15567705,15567706,a,at,1
NC_037355.1,NC_032677.1,16744362,15577736,15577737,T,TY,1
NC_037355.1,NC_032677.1,16748843,15582219,15582223,c,cttta,4
NC_037355.1,NC_032677.1,16764546,15597929,15597930,C,CT,1
NC_037355.1,NC_032677.1,16822643,15671623,15671624,a,ac,1
NC_037355.1,NC_032677.1,16856815,15705808,15705809,t,ta,1
NC_037355.1,NC_032677.1,16868524,15717519,15717533,g,ggttgggaagatccc,14
NC_037355.1,NC_032677.1,16868527,15717536,15717539,g,gaga,3
NC_037355.1,NC_032677.1,16868797,15717809,15717810,T,TA,1
NC_037355.1,NC_032677.1,16886486,15735551,15735552,a,at,1
NC_037355.1,NC_032677.1,16906745,15755872,15755873,A,AR,1
NC_037355.1,NC_032677.1,16920836,15769962,15769963,g,gt,1
NC_037355.1,NC_032677.1,16987189,15836048,15836049,a,at,1
NC_037355.1,NC_032677.1,17090580,15940188,15940189,c,ct,1
NC_037355.1,NC_032677.1,17096770,15946380,15946381,A,AT,1
NC_037355.1,NC_032677.1,17104386,15953997,15953998,G,GR,1
NC_037355.1,NC_032677.1,17171963,16025131,16025132,c,ct,1
NC_037355.1,NC_032677.1,17179561,16031507,16031522,t,ttaatttcatggctgc,15
NC_037355.1,NC_032677.1,17221615,16073343,16073345,c,cca,2
NC_037355.1,NC_032677.1,17281417,16132874,16132875,A,AC,1
NC_037355.1,NC_032677.1,17286475,16137929,16137930,T,TC,1
NC_037355.1,NC_032677.1,17358521,16247412,16247413,G,GA,1
NC_037355.1,NC_032677.1,17384952,16273845,16273846,c,ca,1
NC_037355.1,NC_032677.1,17385018,16273912,16273913,t,ta,1
NC_037355.1,NC_032677.1,17385025,16273920,16273922,a,aNN,2
NC_037355.1,NC_032677.1,17385168,16274065,16274066,g,gt,1
NC_037355.1,NC_032677.1,17443608,16332450,16332453,T,TAAG,3
NC_037355.1,NC_032677.1,17505924,16394774,16394775,t,ta,1
NC_037355.1,NC_032677.1,17552693,16441547,16441548,t,tY,1
NC_037355.1,NC_032677.1,17858504,16755764,16755765,A,AY,1
NC_037355.1,NC_032677.1,17880999,16778264,16778265,t,ta,1
NC_037355.1,NC_032677.1,17927069,16828877,16828879,a,aNN,2
NC_037355.1,NC_032677.1,17951232,16853038,16853041,c,cctt,3
NC_037355.1,NC_032677.1,17968498,16870291,16870292,G,GA,1
NC_037355.1,NC_032677.1,18000190,16900855,16900856,t,tg,1
NC_037355.1,NC_032677.1,18020132,16920815,16920816,A,AC,1
NC_037355.1,NC_032677.1,18035610,16936327,16936328,t,tc,1
NC_037355.1,NC_032677.1,18063198,16963889,16963890,A,AG,1
NC_037355.1,NC_032677.1,18111948,17011730,17011731,G,GS,1
NC_037355.1,NC_032677.1,18131054,17030264,17030265,a,ac,1
NC_037355.1,NC_032677.1,18140852,17040152,17040154,t,ttg,2
NC_037355.1,NC_032677.1,18260247,17870834,17870844,t,tagttcagttc,10
NC_037355.1,NC_032677.1,18260247,17127476,17127486,t,tagttcagttc,10
NC_037355.1,NC_032677.1,18305867,17189113,17189114,a,aN,1
NC_037355.1,NC_032677.1,18306019,17189266,17189268,C,CAK,2
NC_037355.1,NC_032677.1,18308382,17191631,17191632,t,ta,1
NC_037355.1,NC_032677.1,18428879,17315062,17315063,g,gc,1
NC_037355.1,NC_032677.1,18429455,17312546,17312547,C,CT,1
NC_037355.1,NC_032677.1,18475047,17361265,17361266,C,CY,1
NC_037355.1,NC_032677.1,18475661,17361880,17361882,t,taa,2
NC_037355.1,NC_032677.1,18478689,17364911,17364912,A,AG,1
NC_037355.1,NC_032677.1,18484298,17370522,17370523,g,ga,1
NC_037355.1,NC_032677.1,18521834,17408835,17408843,c,ccagtactg,8
NC_037355.1,NC_032677.1,18522968,17409977,17409978,A,AR,1
NC_037355.1,NC_032677.1,18523064,17410074,17410075,T,TC,1
NC_037355.1,NC_032677.1,18523739,17410749,17410750,T,TY,1
NC_037355.1,NC_032677.1,18539244,17426254,17426255,T,TG,1
NC_037355.1,NC_032677.1,18708575,17597246,17597247,c,ca,1
NC_037355.1,NC_032677.1,18709704,17598377,17598378,t,tc,1
NC_037355.1,NC_032677.1,18710040,17598714,17598715,t,ta,1
NC_037355.1,NC_032677.1,18710440,17599115,17599116,g,gt,1
NC_037355.1,NC_032677.1,18711819,17600495,17600499,g,gatct,4
NC_037355.1,NC_032677.1,18721981,17610487,17610488,A,AG,1
NC_037355.1,NC_032677.1,19029334,17926135,17926138,c,caga,3
NC_037355.1,NC_032677.1,19058297,17955112,17955117,A,ACTTAT,5
NC_037355.1,NC_032677.1,19078029,17974856,17974859,c,catt,3
NC_037355.1,NC_032677.1,19109544,18006388,18006389,A,AT,1
NC_037355.1,NC_032677.1,19118080,18014930,18014931,A,AW,1
NC_037355.1,NC_032677.1,19119939,18016794,18016795,A,AT,1
NC_037355.1,NC_032677.1,19121681,18018537,18018540,C,CTAG,3
NC_037355.1,NC_032677.1,19149844,18046703,18046704,t,ta,1
NC_037355.1,NC_032677.1,19263174,18153169,18153170,c,ct,1
NC_037355.1,NC_032677.1,19462371,18353288,18353289,a,at,1
NC_037355.1,NC_032677.1,19493912,18385444,18385445,C,CT,1
NC_037355.1,NC_032677.1,19513832,18405655,18405656,G,GA,1
NC_037355.1,NC_032677.1,19531140,18422963,18422964,C,CT,1
NC_037355.1,NC_032677.1,19607155,18509254,18509255,A,AG,1
NC_037355.1,NC_032677.1,19671297,18573474,18573475,a,ac,1
NC_037355.1,NC_032677.1,19671307,18573485,18573486,t,ta,1
NC_037355.1,NC_032677.1,19671319,18573498,18573499,g,ga,1
NC_037355.1,NC_032677.1,19673574,18575754,18575755,A,AC,1
NC_037355.1,NC_032677.1,19695358,18597543,18597544,c,ct,1
NC_037355.1,NC_032677.1,19708359,18618234,18618235,c,ca,1
NC_037355.1,NC_032677.1,19901010,18818825,18818834,a,agaatgagat,9
NC_037355.1,NC_032677.1,19901013,18818837,18818841,t,ttgaa,4
NC_037355.1,NC_032677.1,19919768,18837177,18837178,c,ct,1
NC_037355.1,NC_032677.1,19957154,18874417,18874418,a,aN,1
NC_037355.1,NC_032677.1,19977967,18895086,18895088,A,AAT,2
NC_037355.1,NC_032677.1,20021973,18939093,18939094,T,TC,1
NC_037355.1,NC_032677.1,20048271,18965393,18965394,A,AM,1
NC_037355.1,NC_032677.1,20053155,18970279,18970281,a,aNN,2
NC_037355.1,NC_032677.1,20235706,19152421,19152423,C,CTA,2
NC_037355.1,NC_032677.1,20438152,19359078,19359082,t,tNNNN,4
NC_037355.1,NC_032677.1,20462178,19383017,19383019,C,CTT,2
NC_037355.1,NC_032677.1,20518373,19439216,19439218,t,tNN,2
NC_037355.1,NC_032677.1,20551814,19484329,19484330,g,gc,1
NC_037355.1,NC_032677.1,20604464,19536809,19536810,t,tg,1
NC_037355.1,NC_032677.1,20676469,19611114,19611115,g,gc,1
NC_037355.1,NC_032677.1,20713231,19647597,19647598,a,at,1
NC_037355.1,NC_032677.1,20735156,19669628,19669630,g,gaa,2
NC_037355.1,NC_032677.1,20765238,19699707,19699708,T,TY,1
NC_037355.1,NC_032677.1,20795304,19730201,19730202,c,cM,1
NC_037355.1,NC_032677.1,20796314,19731212,19731213,t,ta,1
NC_037355.1,NC_032677.1,20797687,19732586,19732587,T,TC,1
NC_037355.1,NC_032677.1,20808784,19744455,19744457,t,taa,2
NC_037355.1,NC_032677.1,20812994,19748669,19748681,g,gcagcagcagcat,12
NC_037355.1,NC_032677.1,20813387,19749074,19749080,G,GTTATTC,6
NC_037355.1,NC_032677.1,20870425,19805722,19805723,g,gt,1
NC_037355.1,NC_032677.1,20870438,19805736,19805738,a,att,2
NC_037355.1,NC_032677.1,20870463,19805763,19805765,a,att,2
NC_037355.1,NC_032677.1,20875217,19810519,19810520,C,CA,1
NC_037355.1,NC_032677.1,20880079,19815385,19815388,c,caaa,3
NC_037355.1,NC_032677.1,20924085,19859047,19859049,A,AAC,2
NC_037355.1,NC_032677.1,20949902,19884871,19884872,A,AC,1
NC_037355.1,NC_032677.1,20951018,19885988,19885989,t,ta,1
NC_037355.1,NC_032677.1,21002417,19937410,19937411,c,ct,1
NC_037355.1,NC_032677.1,21007429,19942423,19942438,C,CAAACTACAGTTTATY,15
NC_037355.1,NC_032677.1,21010653,19945663,19945664,t,tc,1
NC_037355.1,NC_032677.1,21113204,20047241,20047248,g,gagagGCA,7
NC_037355.1,NC_032677.1,21174653,20122765,20122766,t,ta,1
NC_037355.1,NC_032677.1,21187757,20135912,20135914,a,aat,2
NC_037355.1,NC_032677.1,21191006,20139167,20139168,c,ca,1
NC_037355.1,NC_032677.1,21199632,20147788,20147790,A,ANN,2
NC_037355.1,NC_032677.1,21205474,20153631,20153635,c,cctct,4
NC_037355.1,NC_032677.1,21229823,20178408,20178412,C,CTTGT,4
NC_037355.1,NC_032677.1,21247626,20209463,20209464,g,gc,1
NC_037355.1,NC_032677.1,21250095,20211931,20211932,g,ga,1
NC_037355.1,NC_032677.1,21428168,20396742,20396744,a,aat,2
NC_037355.1,NC_032677.1,21518250,20492747,20492751,T,TAGAA,4
NC_037355.1,NC_032677.1,21520588,20495089,20495108,T,TGCATTAAGTATTGCCTTAG,19
NC_037355.1,NC_032677.1,21537802,20512249,20512250,a,at,1
NC_037355.1,NC_032677.1,21545546,20519995,20519996,t,ta,1
NC_037355.1,NC_032677.1,21675940,20650250,20650251,A,AC,1
NC_037355.1,NC_032677.1,21682006,20656317,20656318,c,ct,1
NC_037355.1,NC_032677.1,21686153,20660463,20660465,a,aNN,2
NC_037355.1,NC_032677.1,21699433,20864754,20864755,t,ta,1
NC_037355.1,NC_032677.1,21699450,20864772,20864776,c,cttct,4
NC_037355.1,NC_032677.1,21707840,20873031,20873039,c,ccagcaggg,8
NC_037355.1,NC_032677.1,21737854,20903571,20903573,g,gca,2
NC_037355.1,NC_032677.1,21748573,20914404,20914405,a,ac,1
NC_037355.1,NC_032677.1,21749397,20915229,20915231,c,cta,2
NC_037355.1,NC_032677.1,21766810,20932644,20932654,a,aggtaattatt,10
NC_037355.1,NC_032677.1,21777149,20942999,20943005,t,ttcacac,6
NC_037355.1,NC_032677.1,21778852,20944708,20944713,t,ttttta,5
NC_037355.1,NC_032677.1,21782545,20948398,20948399,C,CT,1
NC_037355.1,NC_032677.1,21785009,20950862,20950863,t,tc,1
NC_037355.1,NC_032677.1,21807215,20973064,20973065,g,gt,1
NC_037355.1,NC_032677.1,21812309,20978158,20978162,c,ctata,4
NC_037355.1,NC_032677.1,21817249,20983104,20983108,C,CACAG,4
NC_037355.1,NC_032677.1,21850451,21016323,21016324,t,ta,1
NC_037355.1,NC_032677.1,21863411,21029352,21029353,a,at,1
NC_037355.1,NC_032677.1,21905572,21070857,21070860,c,caaa,3
NC_037355.1,NC_032677.1,21968861,21136314,21136315,t,tN,1
NC_037355.1,NC_032677.1,22089211,21256383,21256384,t,tg,1
NC_037355.1,NC_032677.1,22128616,21295822,21295824,t,taa,2
NC_037355.1,NC_032677.1,22143505,21310705,21310709,A,AGCTT,4
NC_037355.1,NC_032677.1,22156740,21323980,21323982,A,AAG,2
NC_037355.1,NC_032677.1,22167567,21334739,21334757,c,cagtagtagtagtagtagt,18
NC_037355.1,NC_032677.1,22168569,21335760,21335774,t,tcaacCAAGACTcaa,14
NC_037355.1,NC_032677.1,22176568,21343774,21343775,C,CS,1
NC_037355.1,NC_032677.1,22188876,21356099,21356103,g,gtttt,4
NC_037355.1,NC_032677.1,22192798,21360029,21360030,T,TW,1
NC_037355.1,NC_032677.1,22206615,21373585,21373586,t,tN,1
NC_037355.1,NC_032677.1,22215091,21382076,21382077,a,ac,1
NC_037355.1,NC_032677.1,22245915,21436031,21436032,t,ta,1
NC_037355.1,NC_032677.1,22246128,21436245,21436250,a,atttat,5
NC_037355.1,NC_032677.1,22265876,21456015,21456016,a,at,1
NC_037355.1,NC_032677.1,22265881,21456021,21456023,c,cat,2
NC_037355.1,NC_032677.1,22333347,21527417,21527418,C,CM,1
NC_037355.1,NC_032677.1,22334137,21528208,21528211,a,aaac,3
NC_037355.1,NC_032677.1,22432021,21617953,21617954,a,at,1
NC_037355.1,NC_032677.1,22434670,21620604,21620618,g,gatagacatatatat,14
NC_037355.1,NC_032677.1,22458980,21644828,21644829,C,CM,1
NC_037355.1,NC_032677.1,22493245,21679102,21679103,A,AT,1
NC_037355.1,NC_032677.1,22574095,21762854,21762855,T,TA,1
NC_037355.1,NC_032677.1,22585279,21774436,21774437,T,TW,1
NC_037355.1,NC_032677.1,22591832,21780992,21780998,t,taaataa,6
NC_037355.1,NC_032677.1,22612980,21802144,21802145,t,ta,1
NC_037355.1,NC_032677.1,22698731,21886557,21886560,t,tata,3
NC_037355.1,NC_032677.1,22701428,21889267,21889268,t,tc,1
NC_037355.1,NC_032677.1,22712237,21900077,21900078,A,AG,1
NC_037355.1,NC_032677.1,22714873,21902714,21902715,c,ca,1
NC_037355.1,NC_032677.1,22770453,21957735,21957736,a,at,1
NC_037355.1,NC_032677.1,22847938,22035518,22035522,A,ACTGT,4
NC_037355.1,NC_032677.1,22854567,22042154,22042155,T,TA,1
NC_037355.1,NC_032677.1,22858585,22046169,22046170,t,tg,1
NC_037355.1,NC_032677.1,22882213,22069817,22069818,G,GR,1
NC_037355.1,NC_032677.1,22892723,22080307,22080326,c,ccaaaGGATTCATTCTAAAG,19
NC_037355.1,NC_032677.1,22927222,22115155,22115156,a,at,1
NC_037355.1,NC_032677.1,22930595,22118530,22118541,C,CCCCCCCCACMA,11
NC_037355.1,NC_032677.1,22931052,22118998,22118999,T,TY,1
NC_037355.1,NC_032677.1,22953501,22141396,22141397,T,TA,1
NC_037355.1,NC_032677.1,23037656,22225533,22225542,a,aactttattt,9
NC_037355.1,NC_032677.1,23039269,22227155,22227156,t,tY,1
NC_037355.1,NC_032677.1,23076906,22265137,22265138,t,tN,1
NC_037355.1,NC_032677.1,23106058,22294291,22294292,a,aM,1
NC_037355.1,NC_032677.1,23146146,22334376,22334378,c,cca,2
NC_037355.1,NC_032677.1,23146785,22335017,22335018,G,GR,1
NC_037355.1,NC_032677.1,23172639,22360869,22360870,a,at,1
NC_037355.1,NC_032677.1,23234791,22422827,22422830,g,gcaS,3
NC_037355.1,NC_032677.1,23242770,22430861,22430862,a,aW,1
NC_037355.1,NC_032677.1,23298554,22486564,22486565,T,TC,1
NC_037355.1,NC_032677.1,23308832,22496851,22496852,t,ta,1
NC_037355.1,NC_032677.1,23313215,22501227,22501234,t,ttaattta,7
NC_037355.1,NC_032677.1,23350231,22538260,22538261,a,ag,1
NC_037355.1,NC_032677.1,23372978,22560752,22560754,g,gaa,2
NC_037355.1,NC_032677.1,23409972,22597793,22597795,t,taa,2
NC_037355.1,NC_032677.1,23430110,22617932,22617933,t,ta,1
NC_037355.1,NC_032677.1,23463138,22650858,22650860,T,TAC,2
NC_037355.1,NC_032677.1,23486557,22674281,22674282,G,GK,1
NC_037355.1,NC_032677.1,23510882,22698614,22698615,G,GA,1
NC_037355.1,NC_032677.1,23522144,22709877,22709878,A,AC,1
NC_037355.1,NC_032677.1,23534976,22722715,22722716,t,tc,1
NC_037355.1,NC_032677.1,23537829,22725571,22725572,T,TG,1
NC_037355.1,NC_032677.1,23538452,22726195,22726196,T,TK,1
NC_037355.1,NC_032677.1,23539499,22727243,22727247,c,cttgt,4
NC_037355.1,NC_032677.1,23627447,22819508,22819510,c,caa,2
NC_037355.1,NC_032677.1,23658532,22850808,22850809,t,ta,1
NC_037355.1,NC_032677.1,23670948,22863236,22863237,t,ta,1
NC_037355.1,NC_032677.1,23678932,22871221,22871222,c,ct,1
NC_037355.1,NC_032677.1,23711308,22923745,22923751,t,tttttta,6
NC_037355.1,NC_032677.1,23781522,22993626,22993627,c,cg,1
NC_037355.1,NC_032677.1,23799649,23011657,23011658,a,at,1
NC_037355.1,NC_032677.1,23877839,23089764,23089765,a,ac,1
NC_037355.1,NC_032677.1,23884298,23096224,23096225,c,ct,1
NC_037355.1,NC_032677.1,23918506,23130652,23130671,C,CATGATTGAYGTGACTTAAY,19
NC_037355.1,NC_032677.1,23933225,23145404,23145406,g,gtt,2
NC_037355.1,NC_032677.1,24048414,23250620,23250621,G,GT,1
NC_037355.1,NC_032677.1,24085380,23288636,23288637,A,AS,1
NC_037355.1,NC_032677.1,24108454,23312327,23312332,a,atatat,5
NC_037355.1,NC_032677.1,24172013,23375892,23375893,C,CA,1
NC_037355.1,NC_032677.1,24172016,23375896,23375897,A,AG,1
NC_037355.1,NC_032677.1,24227787,23432305,23432310,C,CTCTCT,5
NC_037355.1,NC_032677.1,24273468,23478003,23478004,c,ca,1
NC_037355.1,NC_032677.1,24280780,23484707,23484708,g,gc,1
NC_037355.1,NC_032677.1,24281926,23485855,23485882,A,ATCATTTTTNNNNNNNNNNNNNNNNNNN,27
NC_037355.1,NC_032677.1,24304529,23512140,23512145,A,AYGGAT,5
NC_037355.1,NC_032677.1,24369639,23577267,23577268,c,ct,1
NC_037355.1,NC_032677.1,24514163,23758656,23758679,T,TAAATTAAAATAATANNNNNNNNN,23
NC_037355.1,NC_032677.1,24544689,23789200,23789214,c,cgatactggatgctt,14
NC_037355.1,NC_032677.1,24549149,23793674,23793675,T,TA,1
NC_037355.1,NC_032677.1,24630276,23873039,23873040,a,at,1
NC_037355.1,NC_032677.1,24632500,23875261,23875262,g,ga,1
NC_037355.1,NC_032677.1,24632540,23875302,23875303,g,ga,1
NC_037355.1,NC_032677.1,24632543,23875306,23875307,a,ac,1
NC_037355.1,NC_032677.1,24632549,23875313,23875314,t,tg,1
NC_037355.1,NC_032677.1,24721481,23963523,23963524,g,ga,1
NC_037355.1,NC_032677.1,24791849,24033473,24033474,g,gt,1
NC_037355.1,NC_032677.1,24809235,24051342,24051343,A,AM,1
NC_037355.1,NC_032677.1,24809718,24051826,24051827,T,TA,1
NC_037355.1,NC_032677.1,24814468,24056575,24056576,A,AC,1
NC_037355.1,NC_032677.1,24832350,24074458,24074459,t,ta,1
NC_037355.1,NC_032677.1,24911626,24153754,24153755,T,TK,1
NC_037355.1,NC_032677.1,24915717,24157846,24157850,g,gacaa,4
NC_037355.1,NC_032677.1,25160616,24400563,24400575,T,TWAGGTCAGTCCA,12
NC_037355.1,NC_032677.1,25160946,24400905,24400906,T,TC,1
NC_037355.1,NC_032677.1,25198940,24438898,24438899,G,GT,1
NC_037355.1,NC_032677.1,25219416,24459368,24459369,g,ga,1
NC_037355.1,NC_032677.1,25242072,24482032,24482041,A,AAGGCAACCG,9
NC_037355.1,NC_032677.1,25274382,24514352,24514353,G,GK,1
NC_037355.1,NC_032677.1,25465516,24708976,24708977,G,GY,1
NC_037355.1,NC_032677.1,25474713,24718182,24718183,G,GC,1
NC_037355.1,NC_032677.1,25780448,25006118,25006119,T,TC,1
NC_037355.1,NC_032677.1,25783272,25008942,25008943,T,TC,1
NC_037355.1,NC_032677.1,25849009,25074680,25074684,a,atgtg,4
NC_037355.1,NC_032677.1,25875361,25103360,25103363,c,cctg,3
NC_037355.1,NC_032677.1,25895573,25123575,25123576,C,CM,1
NC_037355.1,NC_032677.1,25904913,25132918,25132919,c,ca,1
NC_037355.1,NC_032677.1,25913057,25141061,25141062,t,tc,1
NC_037355.1,NC_032677.1,25973678,25205181,25205182,G,GA,1
NC_037355.1,NC_032677.1,25993640,25225164,25225165,A,AR,1
NC_037355.1,NC_032677.1,26001386,25232908,25232909,g,ga,1
NC_037355.1,NC_032677.1,26002119,25233642,25233643,g,gt,1
NC_037355.1,NC_032677.1,26011702,25243226,25243227,G,GK,1
NC_037355.1,NC_032677.1,26054631,25286155,25286156,A,AR,1
NC_037355.1,NC_032677.1,26083414,25315215,25315216,a,at,1
NC_037355.1,NC_032677.1,26108267,25343085,25343088,c,cagY,3
NC_037355.1,NC_032677.1,26109454,25344275,25344276,c,ct,1
NC_037355.1,NC_032677.1,26114571,25349387,25349388,a,ag,1
NC_037355.1,NC_032677.1,26145303,25380124,25380125,T,TG,1
NC_037355.1,NC_032677.1,26184107,25419810,25419816,T,TGGGGCA,6
NC_037355.1,NC_032677.1,26217867,25453603,25453605,C,CAG,2
NC_037355.1,NC_032677.1,26248475,25484216,25484217,c,ca,1
NC_037355.1,NC_032677.1,26281849,25517277,25517283,t,tNNNNNN,6
NC_037355.1,NC_032677.1,26354405,25589842,25589843,a,aR,1
NC_037355.1,NC_032677.1,26360197,25595635,25595636,A,AW,1
NC_037355.1,NC_032677.1,26375595,25611035,25611037,C,CNN,2
NC_037355.1,NC_032677.1,26426069,25661511,25661512,c,ca,1
NC_037355.1,NC_032677.1,26563724,25803450,25803458,T,TGTTTATGA,8
NC_037355.1,NC_032677.1,26567508,25807244,25807245,G,GK,1
NC_037355.1,NC_032677.1,26610265,25849904,25849905,G,GR,1
NC_037355.1,NC_032677.1,26616625,25856271,25856273,a,att,2
NC_037355.1,NC_032677.1,26662887,25902301,25902302,G,GR,1
NC_037355.1,NC_032677.1,26664348,25903763,25903774,G,GGGATGAACGGT,11
NC_037355.1,NC_032677.1,26670254,25909681,25909683,C,CTA,2
NC_037355.1,NC_032677.1,26671914,25911343,25911344,g,gt,1
NC_037355.1,NC_032677.1,26672225,25911655,25911656,t,ta,1
NC_037355.1,NC_032677.1,26675424,25914904,25914905,G,GT,1
NC_037355.1,NC_032677.1,26675539,25915020,25915027,G,GAATGACC,7
NC_037355.1,NC_032677.1,26723147,25962637,25962660,G,GCCCCAGCCTGGCCACACCCCTCT,23
NC_037355.1,NC_032677.1,26751850,25991369,25991370,C,CG,1
NC_037355.1,NC_032677.1,26801462,26052068,26052069,A,AR,1
NC_037355.1,NC_032677.1,26848793,26099353,26099354,C,CT,1
NC_037355.1,NC_032677.1,26870452,26121020,26121021,G,GA,1
NC_037355.1,NC_032677.1,26882005,26132823,26132827,C,CTAAT,4
NC_037355.1,NC_032677.1,26882178,26133000,26133001,t,ta,1
NC_037355.1,NC_032677.1,26882753,26133574,26133575,A,AT,1
NC_037355.1,NC_032677.1,26883003,26133825,26133827,t,tac,2
NC_037355.1,NC_032677.1,26883842,26134670,26134671,a,at,1
NC_037355.1,NC_032677.1,26887872,26138699,26138703,T,TTCTG,4
NC_037355.1,NC_032677.1,26903310,26154141,26154142,A,AG,1
NC_037355.1,NC_032677.1,26903811,26154643,26154644,A,AR,1
NC_037355.1,NC_032677.1,26904291,26155124,26155125,C,CA,1
NC_037355.1,NC_032677.1,26904314,26155148,26155151,C,CCAG,3
NC_037355.1,NC_032677.1,26905418,26156255,26156256,g,gt,1
NC_037355.1,NC_032677.1,26931688,26182516,26182517,C,CS,1
NC_037355.1,NC_032677.1,26961745,26212557,26212564,T,TGGACATG,7
NC_037355.1,NC_032677.1,26974371,26225189,26225190,G,GA,1
NC_037355.1,NC_032677.1,26985715,26236538,26236556,A,ACCTTTAAACAGTAGTGAC,18
NC_037355.1,NC_032677.1,27113109,26375185,26375187,G,GAC,2
NC_037355.1,NC_032677.1,27113109,26418051,26418053,G,GAC,2
NC_037355.1,NC_032677.1,27114133,26419077,26419078,G,GN,1
NC_037355.1,NC_032677.1,27120202,26382283,26382286,A,ACTG,3
NC_037355.1,NC_032677.1,27120202,26425148,26425151,A,ACTG,3
NC_037355.1,NC_032677.1,27122314,26384397,26384406,A,AAGTCAGTAT,9
NC_037355.1,NC_032677.1,27122314,26427262,26427271,A,AAGTCAGTAT,9
NC_037355.1,NC_032677.1,27132713,26437713,26437717,G,GAGAA,4
NC_037355.1,NC_032677.1,27133749,26438754,26438755,G,GA,1
NC_037355.1,NC_032677.1,27136567,26441573,26441574,A,AC,1
NC_037355.1,NC_032677.1,27148414,26453416,26453417,C,CT,1
NC_037355.1,NC_032677.1,27149700,26454703,26454705,g,ggt,2
NC_037355.1,NC_032677.1,27180835,26485843,26485853,A,ACTGGCTTTCC,10
NC_037355.1,NC_032677.1,27355668,26749841,26749866,C,CTCAGGCCTCATAAACCTCCTTCTTG,25
NC_037355.1,NC_032677.1,27398083,26792573,26792574,C,CA,1
NC_037355.1,NC_032677.1,27414265,26808756,26808758,A,AGG,2
NC_037355.1,NC_032677.1,27437670,26832169,26832175,t,tcacaca,6
NC_037355.1,NC_032677.1,27455308,26847773,26847774,C,CG,1
NC_037355.1,NC_032677.1,27457311,26849787,26849792,C,CATCTT,5
NC_037355.1,NC_032677.1,27465821,26855245,26855262,a,atggcaaaaaaaaaaagg,17
NC_037355.1,NC_032677.1,27468396,26857836,26857837,C,CT,1
NC_037355.1,NC_032677.1,27468489,26857930,26857932,C,CTG,2
NC_037355.1,NC_032677.1,27488192,26877635,26877636,C,CT,1
NC_037355.1,NC_032677.1,27539524,26929201,26929205,t,tgaga,4
NC_037355.1,NC_032677.1,27676161,27065860,27065861,G,GA,1
NC_037355.1,NC_032677.1,27676164,27065864,27065865,T,TG,1
NC_037355.1,NC_032677.1,27768275,27158153,27158154,a,ag,1
NC_037355.1,NC_032677.1,27790025,27179636,27179637,C,CS,1
NC_037355.1,NC_032677.1,27794941,27184553,27184554,g,gt,1
NC_037355.1,NC_032677.1,27806760,27196374,27196375,C,CT,1
NC_037355.1,NC_032677.1,27974436,27363841,27363859,A,ATGAGNNNNNNNNNNNNNN,18
NC_037355.1,NC_032677.1,28014028,27425747,27425748,C,CT,1
NC_037355.1,NC_032677.1,28039117,27452208,27452210,A,AAT,2
NC_037355.1,NC_032677.1,28135596,27548757,27548758,t,tc,1
NC_037355.1,NC_032677.1,28138965,27552127,27552144,g,gactctggttttgggggt,17
NC_037355.1,NC_032677.1,28139005,27552184,27552185,t,tc,1
NC_037355.1,NC_032677.1,28153815,27566998,27566999,C,CT,1
NC_037355.1,NC_032677.1,28185168,27598351,27598352,t,ta,1
NC_037355.1,NC_032677.1,28321321,27734507,27734524,G,GCCCTTCACCTCACAGGA,17
NC_037355.1,NC_032677.1,28381434,27794604,27794607,A,ACAG,3
NC_037355.1,NC_032677.1,28381441,27794614,27794618,g,gtgcc,4
NC_037355.1,NC_032677.1,28624906,28038033,28038075,A,ACNNNNNNNNNNNNNNNNNNNNNNNNNNNNNNNNNNNNNNNNN,42
NC_037355.1,NC_032677.1,28626306,28039475,28039505,A,ANNNNNNNNNNNNNNNNNNNNNNNNNNNNNN,30
NC_037355.1,NC_032677.1,28844892,28256106,28256107,c,ct,1
NC_037355.1,NC_032677.1,28854417,28265909,28265914,A,AAAATT,5
NC_037355.1,NC_032677.1,28958857,28374976,28374992,A,AAGCAGTAAACTCTATC,16
NC_037355.1,NC_032677.1,29033206,28449361,28449362,a,ac,1
NC_037355.1,NC_032677.1,29055166,28471322,28471324,a,agg,2
NC_037355.1,NC_032677.1,29159864,28575687,28575688,g,gt,1
NC_037355.1,NC_032677.1,29160036,28575860,28575862,t,ttg,2
NC_037355.1,NC_032677.1,29542866,28946739,28946740,A,AT,1
NC_037355.1,NC_032677.1,29542871,28946745,28946746,C,CA,1
NC_037355.1,NC_032677.1,29542915,28946791,28946792,T,TG,1
NC_037355.1,NC_032677.1,29738355,29143833,29143834,T,TA,1
NC_037355.1,NC_032677.1,29738403,29143883,29143884,T,TG,1
NC_037355.1,NC_032677.1,29742806,29148287,29148288,A,AC,1
NC_037355.1,NC_032677.1,29763097,29168545,29168553,C,CGGAGACTA,8
NC_037355.1,NC_032677.1,30012255,29417986,29417987,A,AM,1
NC_037355.1,NC_032677.1,30019454,29425187,29425188,g,ga,1
NC_037355.1,NC_032677.1,30026449,29432183,29432184,T,TW,1
NC_037355.1,NC_032677.1,30099286,29506696,29506699,g,gtct,3
NC_037355.1,NC_032677.1,30253476,29647595,29647596,a,ag,1
NC_037355.1,NC_032677.1,30443379,29839674,29839675,T,TG,1
NC_037355.1,NC_032677.1,30733419,30129475,30129477,C,CTA,2
NC_037355.1,NC_032677.1,30735433,30131491,30131492,G,GA,1
NC_037355.1,NC_032677.1,30843365,30239428,30239442,a,aNNNNNNNNNNNNNN,14
NC_037355.1,NC_032677.1,30857006,30253089,30253091,t,taa,2
NC_037355.1,NC_032677.1,30939918,30327394,30327399,A,ATAAKC,5
NC_037355.1,NC_032677.1,31311762,30751344,30751359,T,TNNNNNNNNNNNNNNN,15
NC_037355.1,NC_032677.1,31314769,30754366,30754368,c,cca,2
NC_037355.1,NC_032677.1,31363331,30802658,30802659,A,AW,1
NC_037355.1,NC_032677.1,31475942,30915272,30915273,G,GR,1
NC_037355.1,NC_032677.1,31735975,31175272,31175273,t,ta,1
NC_037355.1,NC_032677.1,31750479,31189775,31189776,A,AT,1
NC_037355.1,NC_032677.1,31806209,31245684,31245685,C,CA,1
NC_037355.1,NC_032677.1,32074857,31514807,31514808,A,AC,1
NC_037355.1,NC_032677.1,32175475,31615538,31615539,A,AM,1
NC_037355.1,NC_032677.1,32185206,31625271,31625272,t,tc,1
NC_037355.1,NC_032677.1,32318393,31758461,31758462,c,cg,1
NC_037355.1,NC_032677.1,33008619,32487588,32487589,t,ta,1
NC_037355.1,NC_032677.1,33041340,32520311,32520312,C,CG,1
NC_037355.1,NC_032677.1,33044301,32523273,32523297,a,agcGNNNNNNNNNNNNNNNNNNNNN,24
NC_037355.1,NC_032677.1,33103733,32582728,32582730,t,taY,2
NC_037355.1,NC_032677.1,33143489,32622158,32622159,C,CT,1
NC_037355.1,NC_032677.1,33199004,32677677,32677678,g,gc,1
NC_037355.1,NC_032677.1,33232078,32710753,32710754,g,ga,1
NC_037355.1,NC_032677.1,33256132,32734809,32734810,t,ta,1
NC_037355.1,NC_032677.1,33386025,32838887,32838888,C,CA,1
NC_037355.1,NC_032677.1,33409451,32868539,32868540,C,CT,1
NC_037355.1,NC_032677.1,33582977,33042256,33042257,c,ca,1
NC_037355.1,NC_032677.1,33692303,33152190,33152214,T,TNNNNNNNNNNNNNNNNNNNNNNNN,24
NC_037355.1,NC_032677.1,33796820,33256722,33256723,G,GS,1
NC_037355.1,NC_032677.1,33906486,33367340,33367341,c,ct,1
NC_037355.1,NC_032677.1,33924664,33385545,33385546,T,TG,1
NC_037355.1,NC_032677.1,33949646,33410525,33410526,a,ac,1
NC_037355.1,NC_032677.1,33963499,33424182,33424183,C,CS,1
NC_037355.1,NC_032677.1,34000983,33461673,33461674,A,AW,1
NC_037355.1,NC_032677.1,34008181,33468873,33468874,G,GT,1
NC_037355.1,NC_032677.1,34045556,33506250,33506251,t,tg,1
NC_037355.1,NC_032677.1,34247399,33708102,33708123,T,TTCTCTGAGATCTATACYCAGG,21
NC_037355.1,NC_032677.1,34315215,33813396,33813397,A,AN,1
NC_037355.1,NC_032677.1,34502973,34001175,34001176,C,CY,1
NC_037355.1,NC_032677.1,34503103,34001306,34001308,G,GTT,2
NC_037355.1,NC_032677.1,34534759,34043898,34043900,g,gga,2
NC_037355.1,NC_032677.1,34546835,34056052,34056053,G,GA,1
NC_037355.1,NC_032677.1,34585045,34093957,34093959,a,aNN,2
NC_037355.1,NC_032677.1,34588314,34097228,34097229,G,GC,1
NC_037355.1,NC_032677.1,34588994,34097909,34097910,G,GA,1
NC_037355.1,NC_032677.1,34598293,34107209,34107212,C,CCCT,3
NC_037355.1,NC_032677.1,34611126,34120045,34120047,T,TGG,2
NC_037355.1,NC_032677.1,34611809,34120730,34120731,C,CT,1
NC_037355.1,NC_032677.1,34617944,34126857,34126858,T,TC,1
NC_037355.1,NC_032677.1,34622741,34131654,34131659,T,TACCTG,5
NC_037355.1,NC_032677.1,34664281,34172968,34172973,t,tgaaaa,5
NC_037355.1,NC_032677.1,34671645,34180342,34180343,C,CG,1
NC_037355.1,NC_032677.1,34713788,34222550,34222551,C,CG,1
NC_037355.1,NC_032677.1,34727492,34236255,34236256,G,GC,1
NC_037355.1,NC_032677.1,34730599,34239364,34239368,G,GATCA,4
NC_037355.1,NC_032677.1,34732603,34241372,34241373,C,CG,1
NC_037355.1,NC_032677.1,34829048,34337630,34337631,G,GT,1
NC_037355.1,NC_032677.1,34837133,34345734,34345736,g,gta,2
NC_037355.1,NC_032677.1,34841228,34349831,34349832,T,TA,1
NC_037355.1,NC_032677.1,34935973,34518278,34518279,A,AR,1
NC_037355.1,NC_032677.1,34951468,34533773,34533774,A,AT,1
NC_037355.1,NC_032677.1,34951753,34534059,34534060,T,TG,1
NC_037355.1,NC_032677.1,34981416,34563723,34563724,T,TK,1
NC_037355.1,NC_032677.1,34996371,34578633,34578637,T,TGTAA,4
NC_037355.1,NC_032677.1,35009886,34592139,34592140,C,CG,1
NC_037355.1,NC_032677.1,35013673,34595925,34595926,T,TG,1
NC_037355.1,NC_032677.1,35037779,34620003,34620004,c,ct,1
NC_037355.1,NC_032677.1,35050278,34632561,34632562,G,GA,1
NC_037355.1,NC_032677.1,35104561,34685128,34685129,g,gt,1
NC_037355.1,NC_032677.1,35105870,34686438,34686439,T,TA,1
NC_037355.1,NC_032677.1,35108013,34688581,34688582,A,AC,1
NC_037355.1,NC_032677.1,35108036,34688605,34688606,g,gc,1
NC_037355.1,NC_032677.1,35138741,34719264,34719265,t,tg,1
NC_037355.1,NC_032677.1,35227050,34807139,34807142,T,TGAG,3
NC_037355.1,NC_032677.1,35253484,34833575,34833577,a,acg,2
NC_037355.1,NC_032677.1,35260510,34840400,34840401,g,ga,1
NC_037355.1,NC_032677.1,35291504,34871675,34871676,t,ta,1
NC_037355.1,NC_032677.1,35291716,34871888,34871889,t,tc,1
NC_037355.1,NC_032677.1,35320393,34900567,34900568,c,ct,1
NC_037355.1,NC_032677.1,35327675,34908274,34908283,c,cccagcagtg,9
NC_037355.1,NC_032677.1,35330357,34910964,34910965,a,at,1
NC_037355.1,NC_032677.1,35331372,34911982,34911983,t,tg,1
NC_037355.1,NC_032677.1,35335046,34915656,34915657,t,tg,1
NC_037355.1,NC_032677.1,35346970,34927586,34927588,a,agt,2
NC_037355.1,NC_032677.1,35395813,34976969,34976971,A,AAT,2
NC_037355.1,NC_032677.1,35476760,35018974,35018975,A,AG,1
NC_037355.1,NC_032677.1,35528260,35024660,35024661,t,tN,1
NC_037355.1,NC_032677.1,35530773,35027174,35027175,G,GA,1
NC_037355.1,NC_032677.1,35543073,35041224,35041225,C,CT,1
NC_037355.1,NC_032677.1,35543843,35041997,35042000,C,CCAA,3
NC_037355.1,NC_032677.1,35580103,35077752,35077754,t,taa,2
NC_037355.1,NC_032677.1,35588942,35086589,35086591,a,aag,2
NC_037355.1,NC_032677.1,35591834,35089484,35089485,g,gt,1
NC_037355.1,NC_032677.1,35612770,35112458,35112465,G,GTGCACCA,7
NC_037355.1,NC_032677.1,35666617,35169412,35169418,a,agaaatg,6
NC_037355.1,NC_032677.1,35668919,35171719,35171720,G,GT,1
NC_037355.1,NC_032677.1,35682147,35184930,35184931,A,AC,1
NC_037355.1,NC_032677.1,35685597,35188376,35188377,C,CT,1
NC_037355.1,NC_032677.1,35722783,35225556,35225557,c,cN,1
NC_037355.1,NC_032677.1,35775095,35286916,35286917,T,TG,1
NC_037355.1,NC_032677.1,35784782,35296596,35296597,C,CT,1
NC_037355.1,NC_032677.1,35796105,35307928,35307929,g,gc,1
NC_037355.1,NC_032677.1,35808215,35320039,35320040,A,AG,1
NC_037355.1,NC_032677.1,35853571,35364887,35364888,t,ta,1
NC_037355.1,NC_032677.1,35917635,35428969,35428970,c,ct,1
NC_037355.1,NC_032677.1,35974044,35521336,35521337,t,tg,1
NC_037355.1,NC_032677.1,35974469,35521762,35521765,c,cagg,3
NC_037355.1,NC_032677.1,35983230,35530475,35530477,C,CAG,2
NC_037355.1,NC_032677.1,35985829,35533077,35533079,G,GGW,2
NC_037355.1,NC_032677.1,36030838,35577697,35577703,c,cttcact,6
NC_037355.1,NC_032677.1,36047289,35593834,35593837,t,ttta,3
NC_037355.1,NC_032677.1,36063159,35609713,35609714,t,tc,1
NC_037355.1,NC_032677.1,36071096,35617651,35617652,A,AR,1
NC_037355.1,NC_032677.1,36076836,35623389,35623390,C,CY,1
NC_037355.1,NC_032677.1,36114228,35691659,35691660,c,ct,1
NC_037355.1,NC_032677.1,36186736,35758308,35758309,A,AG,1
NC_037355.1,NC_032677.1,36193151,35764724,35764725,G,GA,1
NC_037355.1,NC_032677.1,36289931,35862152,35862153,a,ac,1
NC_037355.1,NC_032677.1,36290097,35862319,35862321,t,ttc,2
NC_037355.1,NC_032677.1,36302519,35874756,35874758,T,TTA,2
NC_037355.1,NC_032677.1,36305463,35877709,35877713,c,caaaa,4
NC_037355.1,NC_032677.1,36307260,35879510,35879511,t,tg,1
NC_037355.1,NC_032677.1,36324797,35901628,35901638,a,actgatctgat,10
NC_037355.1,NC_032677.1,36330567,35907404,35907405,g,gt,1
NC_037355.1,NC_032677.1,36330586,35907424,35907425,t,ta,1
NC_037355.1,NC_032677.1,36330592,35907431,35907432,t,tg,1
NC_037355.1,NC_032677.1,36331899,35908740,35908741,c,ca,1
NC_037355.1,NC_032677.1,36526059,36102539,36102540,A,AM,1
NC_037355.1,NC_032677.1,36537444,36113932,36113933,g,ga,1
NC_037355.1,NC_032677.1,36550238,36126728,36126729,g,ga,1
NC_037355.1,NC_032677.1,36559719,36136214,36136220,a,aNNNNNN,6
NC_037355.1,NC_032677.1,36587086,36163593,36163594,A,AR,1
NC_037355.1,NC_032677.1,36600699,36177511,36177513,c,ctt,2
NC_037355.1,NC_032677.1,36717299,36294899,36294921,A,ATATAGGTAACCAGAAGTATAGG,22
NC_037355.1,NC_032677.1,36758004,36335630,36335631,g,ga,1
NC_037355.1,NC_032677.1,36778530,36356157,36356158,t,tg,1
NC_037355.1,NC_032677.1,36800439,36378066,36378087,C,CAATTGCTTTCCAATATTGGCA,21
NC_037355.1,NC_032677.1,36801622,36379270,36379274,T,TCTTA,4
NC_037355.1,NC_032677.1,36817233,36394890,36394891,t,tc,1
NC_037355.1,NC_032677.1,36824482,36402140,36402142,C,CCA,2
NC_037355.1,NC_032677.1,36828838,36406500,36406501,T,TW,1
NC_037355.1,NC_032677.1,36834025,36411689,36411697,A,AATTTATGN,8
NC_037355.1,NC_032677.1,36840328,36418001,36418002,G,GA,1
NC_037355.1,NC_032677.1,36907147,36484516,36484517,c,ct,1
NC_037355.1,NC_032677.1,37083762,36660297,36660298,C,CA,1
NC_037355.1,NC_032677.1,37101850,36678387,36678389,g,gta,2
NC_037355.1,NC_032677.1,37119289,36695841,36695843,t,taa,2
NC_037355.1,NC_032677.1,37167690,36744246,36744247,c,ca,1
NC_037355.1,NC_032677.1,37214053,36790603,36790604,T,TA,1
NC_037355.1,NC_032677.1,37253679,36830237,36830256,G,GCTCTCCAGGATTTCTAAGT,19
NC_037355.1,NC_032677.1,37253967,36830547,36830548,a,at,1
NC_037355.1,NC_032677.1,37253979,36830560,36830562,t,tta,2
NC_037355.1,NC_032677.1,37267056,36843642,36843643,G,GC,1
NC_037355.1,NC_032677.1,37307142,36883741,36883743,A,AAR,2
NC_037355.1,NC_032677.1,37307923,36884524,36884526,G,GTA,2
NC_037355.1,NC_032677.1,37309402,36886006,36886007,C,CY,1
NC_037355.1,NC_032677.1,37319255,36895843,36895844,C,CT,1
NC_037355.1,NC_032677.1,37430702,37006923,37006933,A,AGCTATTATTT,10
NC_037355.1,NC_032677.1,37473239,37049473,37049474,A,AG,1
NC_037355.1,NC_032677.1,37486343,37062465,37062466,T,TC,1
NC_037355.1,NC_032677.1,37542309,37117561,37117569,G,GAGAGATAS,8
NC_037355.1,NC_032677.1,37559830,37135106,37135107,A,AC,1
NC_037355.1,NC_032677.1,37569160,37144439,37144440,t,ta,1
NC_037355.1,NC_032677.1,37571202,37146483,37146484,t,tc,1
NC_037355.1,NC_032677.1,37575677,37150944,37150945,c,cg,1
NC_037355.1,NC_032677.1,37578467,37153736,37153737,A,AG,1
NC_037355.1,NC_032677.1,37583788,37159062,37159085,t,tgccatctgtggggtcacacagag,23
NC_037355.1,NC_032677.1,37598834,37180624,37180625,T,TK,1
NC_037355.1,NC_032677.1,37607647,37189449,37189450,T,TW,1
NC_037355.1,NC_032677.1,37611900,37193705,37193709,a,aaaat,4
NC_037355.1,NC_032677.1,37615890,37197699,37197700,t,ta,1
NC_037355.1,NC_032677.1,37619808,37201622,37201623,T,TA,1
NC_037355.1,NC_032677.1,37630714,37212530,37212532,c,caa,2
NC_037355.1,NC_032677.1,37634148,37215967,37215968,C,CA,1
NC_037355.1,NC_032677.1,37635174,37216994,37216995,c,ct,1
NC_037355.1,NC_032677.1,37636752,37218575,37218576,t,tc,1
NC_037355.1,NC_032677.1,37636867,37218691,37218692,G,GA,1
NC_037355.1,NC_032677.1,37641142,37222991,37222995,C,CTAAT,4
NC_037355.1,NC_032677.1,37642258,37224112,37224113,a,at,1
NC_037355.1,NC_032677.1,37666304,37249713,37249714,A,AT,1
NC_037355.1,NC_032677.1,37690885,37274348,37274359,g,ggttggtcataa,11
NC_037355.1,NC_032677.1,37700341,37283815,37283822,A,AACATTTG,7
NC_037355.1,NC_032677.1,37713602,37297077,37297089,T,TTGGTTTARCCAC,12
NC_037355.1,NC_032677.1,37731173,37314669,37314671,c,caa,2
NC_037355.1,NC_032677.1,37744561,37328057,37328058,T,TA,1
NC_037355.1,NC_032677.1,37751189,37334689,37334690,T,TK,1
NC_037355.1,NC_032677.1,37754695,37338195,37338196,A,AW,1
NC_037355.1,NC_032677.1,37757722,37341223,37341224,t,ta,1
NC_037355.1,NC_032677.1,37769986,37364646,37364661,C,CCAGTTGTGTGGTATG,15
NC_037355.1,NC_032677.1,37773646,37368317,37368318,C,CA,1
NC_037355.1,NC_032677.1,37782455,37377129,37377130,g,gt,1
NC_037355.1,NC_032677.1,37814055,37408524,37408525,a,at,1
NC_037355.1,NC_032677.1,37827917,37422391,37422392,A,AR,1
NC_037355.1,NC_032677.1,37831945,37426412,37426413,C,CT,1
NC_037355.1,NC_032677.1,37839714,37434143,37434144,T,TY,1
NC_037355.1,NC_032677.1,37848924,37443354,37443356,c,cca,2
NC_037355.1,NC_032677.1,37856732,37451168,37451171,A,ARMT,3
NC_037355.1,NC_032677.1,37889305,37483798,37483799,G,GA,1
NC_037355.1,NC_032677.1,37892380,37486893,37486898,A,ACAGAT,5
NC_037355.1,NC_032677.1,37892566,37487084,37487085,A,AG,1
NC_037355.1,NC_032677.1,37892889,37487408,37487412,c,cccaa,4
NC_037355.1,NC_032677.1,37904061,37498585,37498589,T,TTCTG,4
NC_037355.1,NC_032677.1,37915357,37509881,37509882,a,at,1
NC_037355.1,NC_032677.1,37916366,37510891,37510892,a,at,1
NC_037355.1,NC_032677.1,38031953,37629032,37629034,C,CTY,2
NC_037355.1,NC_032677.1,38186283,37783754,37783770,t,ttttactttttttttta,16
NC_037355.1,NC_032677.1,38214904,37812391,37812392,T,TC,1
NC_037355.1,NC_032677.1,38227948,37825259,37825260,A,AT,1
NC_037355.1,NC_032677.1,38329573,38003194,38003250,t,tgatcAAACCNNNNNNNNNNNNNNNNNNNNNNNNNNNNNNNNNNNNNNNNNNNNNNN,56
NC_037355.1,NC_032677.1,38409409,37925254,37925255,c,ct,1
NC_037355.1,NC_032677.1,38453437,38127026,38127028,t,ttc,2
NC_037355.1,NC_032677.1,38500639,38174234,38174236,a,aNN,2
NC_037355.1,NC_032677.1,38541625,38215223,38215224,g,ga,1
NC_037355.1,NC_032677.1,38554427,38228024,38228025,T,TY,1
NC_037355.1,NC_032677.1,38554538,38228138,38228139,C,CT,1
NC_037355.1,NC_032677.1,38732653,38376845,38376847,A,ANN,2
NC_037355.1,NC_032677.1,38780986,38425019,38425020,T,TC,1
NC_037355.1,NC_032677.1,38884356,38528516,38528517,g,gc,1
NC_037355.1,NC_032677.1,38896748,38540917,38540922,G,GCCAGC,5
NC_037355.1,NC_032677.1,38915289,38559464,38559465,G,GS,1
NC_037355.1,NC_032677.1,38942480,38586660,38586661,C,CR,1
NC_037355.1,NC_032677.1,39031386,38675341,38675342,a,aN,1
NC_037355.1,NC_032677.1,39047191,38691150,38691152,a,aNN,2
NC_037355.1,NC_032677.1,39055936,38699897,38699898,g,ga,1
NC_037355.1,NC_032677.1,39055951,38699913,38699914,g,ga,1
NC_037355.1,NC_032677.1,39055972,38699935,38699936,t,tg,1
NC_037355.1,NC_032677.1,39099186,38743134,38743136,a,aNN,2
NC_037355.1,NC_032677.1,39275911,39039914,39039915,a,at,1
NC_037355.1,NC_032677.1,39317243,39080788,39080805,C,CTGCAGGTTCTGTTTTAG,17
NC_037355.1,NC_032677.1,39335664,39099230,39099231,T,TW,1
NC_037355.1,NC_032677.1,39438103,39201826,39201827,C,CG,1
NC_037355.1,NC_032677.1,39615182,39485109,39485111,t,ttc,2
NC_037355.1,NC_032677.1,39615211,39485140,39485141,c,ct,1
NC_037355.1,NC_032677.1,39635848,39505776,39505777,g,ga,1
NC_037355.1,NC_032677.1,39635912,39505841,39505843,c,ctg,2
NC_037355.1,NC_032677.1,39650444,39522040,39522043,g,gaga,3
NC_037355.1,NC_032677.1,39664045,39535647,39535648,c,ct,1
NC_037355.1,NC_032677.1,39684399,39561187,39561197,a,atatNNNNNNN,10
NC_037355.1,NC_032677.1,39688420,39565224,39565231,T,TACCCTTG,7
NC_037355.1,NC_032677.1,39694298,39571115,39571116,G,GT,1
NC_037355.1,NC_032677.1,39702813,39579629,39579631,C,CCM,2
NC_037355.1,NC_032677.1,39792282,39669192,39669197,a,aattgt,5
NC_037355.1,NC_032677.1,39822362,39700103,39700114,c,cagtgaggaaat,11
NC_037355.1,NC_032677.1,40007168,39824260,39824261,g,ga,1
NC_037355.1,NC_032677.1,40010034,39827127,39827129,t,ttg,2
NC_037355.1,NC_032677.1,40011444,39828546,39828547,a,ag,1
NC_037355.1,NC_032677.1,40016806,39834054,39834057,t,tctc,3
NC_037355.1,NC_032677.1,40024832,39842083,39842085,g,ggt,2
NC_037355.1,NC_032677.1,40047175,39864165,39864166,c,ca,1
NC_037355.1,NC_032677.1,40061499,39878497,39878498,T,TY,1
NC_037355.1,NC_032677.1,40065584,39882583,39882601,g,gatgtctctgctttttaat,18
NC_037355.1,NC_032677.1,40102237,39919262,39919263,G,GS,1
NC_037355.1,NC_032677.1,40178747,39996368,39996369,C,CT,1
NC_037355.1,NC_032677.1,40185876,40003490,40003491,g,gt,1
NC_037355.1,NC_032677.1,40241158,40059481,40059483,C,CYT,2
NC_037355.1,NC_032677.1,40245721,40064044,40064046,C,CTT,2
NC_037355.1,NC_032677.1,40247065,40065388,40065390,c,ctg,2
NC_037355.1,NC_032677.1,40250588,40068916,40068918,t,tta,2
NC_037355.1,NC_032677.1,40330310,40148379,40148381,t,ttc,2
NC_037355.1,NC_032677.1,40362073,40180152,40180153,g,gc,1
NC_037355.1,NC_032677.1,40385530,40203642,40203643,A,AW,1
NC_037355.1,NC_032677.1,40394952,40213071,40213072,G,GC,1
NC_037355.1,NC_032677.1,40421782,40239919,40239923,a,acacM,4
NC_037355.1,NC_032677.1,40446739,40266175,40266200,t,taggttcaatccctgggttgggaaga,25
NC_037355.1,NC_032677.1,40457211,40276672,40276674,C,CAG,2
NC_037355.1,NC_032677.1,40462013,40281476,40281477,g,gt,1
NC_037355.1,NC_032677.1,40476373,40295842,40295843,G,GT,1
NC_037355.1,NC_032677.1,40482493,40301961,40302003,G,GCACAGCCTGCCCAGCACCAAGTGCACCRAGAGTCCACACCCA,42
NC_037355.1,NC_032677.1,40484102,40303602,40303607,G,GTTGTC,5
NC_037355.1,NC_032677.1,40485299,40304807,40304811,C,CTCTG,4
NC_037355.1,NC_032677.1,40485301,40304813,40304819,A,AAGCTAC,6
NC_037355.1,NC_032677.1,40486263,40305782,40305783,t,tg,1
NC_037355.1,NC_032677.1,40487477,40306996,40306997,C,CA,1
NC_037355.1,NC_032677.1,40492951,40312468,40312477,T,TATGAACCCA,9
NC_037355.1,NC_032677.1,40499686,40319211,40319212,a,ag,1
NC_037355.1,NC_032677.1,40499691,40319217,40319218,c,ca,1
NC_037355.1,NC_032677.1,40532973,40352445,40352446,c,ca,1
NC_037355.1,NC_032677.1,40547601,40443819,40443820,C,CG,1
NC_037355.1,NC_032677.1,40599251,40557379,40557380,c,ct,1
NC_037355.1,NC_032677.1,40641974,40599992,40600091,a,aNNNNNNNNNNNNNNNNNNNNNNNNNNNNNNNNNNNNNNNNNNNNNNNNNNNNNNNNNNNNNNNNNNNNNNNNNNNNNNNNNNNNNNNNNNNNNNNNNNN,99
NC_037355.1,NC_032677.1,40732448,40690622,40690624,g,gcR,2
NC_037355.1,NC_032677.1,40838864,40796504,40796505,T,TR,1
NC_037355.1,NC_032677.1,40847780,40805427,40805428,A,AC,1
NC_037355.1,NC_032677.1,40848019,40805667,40805668,C,CA,1
NC_037355.1,NC_032677.1,40880365,40833737,40833738,C,CY,1
NC_037355.1,NC_032677.1,40892882,40846259,40846260,g,gt,1
NC_037355.1,NC_032677.1,40955063,40908446,40908448,G,GAC,2
NC_037355.1,NC_032677.1,40964961,40918402,40918404,C,CAY,2
NC_037355.1,NC_032677.1,40985963,40939406,40939407,A,AR,1
NC_037355.1,NC_032677.1,41035245,40988689,40988690,C,CT,1
NC_037355.1,NC_032677.1,41037954,40991400,40991402,c,cat,2
NC_037355.1,NC_032677.1,41050070,41003439,41003440,a,ac,1
NC_037355.1,NC_032677.1,41078332,41031543,41031544,T,TA,1
NC_037355.1,NC_032677.1,41095942,41048910,41048911,C,CM,1
NC_037355.1,NC_032677.1,41104069,41057074,41057075,C,CT,1
NC_037355.1,NC_032677.1,41107057,41060063,41060064,t,tg,1
NC_037355.1,NC_032677.1,41132777,41085789,41085833,C,CCTGCCCTGAGCTGTGATTGCCAGCCGGTCTGCTATTTGCTCTCA,44
NC_037355.1,NC_032677.1,41137359,41090414,41090416,C,CAG,2
NC_037355.1,NC_032677.1,41138094,41091151,41091152,G,GK,1
NC_037355.1,NC_032677.1,41139649,41092708,41092709,G,GS,1
NC_037355.1,NC_032677.1,41140989,41094046,41094047,C,CT,1
NC_037355.1,NC_032677.1,41261067,41215086,41215087,A,AM,1
NC_037355.1,NC_032677.1,41288274,41241841,41241843,a,aat,2
NC_037355.1,NC_032677.1,41299110,41252687,41252688,T,TC,1
NC_037355.1,NC_032677.1,41333995,41287574,41287576,G,GKK,2
NC_037355.1,NC_032677.1,41334046,41287627,41287636,A,AGGCCTGCCT,9
NC_037355.1,NC_032677.1,41378607,41332600,41332601,T,TY,1
NC_037355.1,NC_032677.1,41396970,41350963,41350964,t,ta,1
NC_037355.1,NC_032677.1,41445935,41399966,41399972,a,aNNNNNN,6
NC_037355.1,NC_032677.1,41445975,41400012,41400013,a,ag,1
NC_037355.1,NC_032677.1,41478317,41432454,41432455,T,TY,1
NC_037355.1,NC_032677.1,41487991,41440726,41440727,T,TA,1
NC_037355.1,NC_032677.1,41543989,41496689,41496693,C,CTAGT,4
NC_037355.1,NC_032677.1,41553010,41505633,41505637,T,TAAAC,4
NC_037355.1,NC_032677.1,41583758,41536821,41536835,C,CAGGGCGGTGCACGT,14
NC_037355.1,NC_032677.1,41628886,41581981,41581985,a,atgtg,4
NC_037355.1,NC_032677.1,41628921,41582020,41582022,c,ctg,2
NC_037355.1,NC_032677.1,41629444,41582543,41582545,c,ctg,2
NC_037355.1,NC_032677.1,41645094,41598196,41598197,C,CA,1
NC_037355.1,NC_032677.1,41670970,41624074,41624075,g,gt,1
NC_037355.1,NC_032677.1,41677389,41630512,41630513,T,TG,1
NC_037355.1,NC_032677.1,41682534,41635657,41635659,G,GGA,2
NC_037355.1,NC_032677.1,41682618,41635743,41635744,c,ct,1
NC_037355.1,NC_032677.1,41682623,41635749,41635750,g,gc,1
NC_037355.1,NC_032677.1,41689967,41643100,41643101,g,ga,1
NC_037355.1,NC_032677.1,41692083,41645216,41645217,t,ta,1
NC_037355.1,NC_032677.1,41704303,41657442,41657443,t,tc,1
NC_037355.1,NC_032677.1,41704364,41657504,41657505,c,ca,1
NC_037355.1,NC_032677.1,41710727,41663871,41663873,a,aNN,2
NC_037355.1,NC_032677.1,41742068,41695215,41695216,A,AC,1
NC_037355.1,NC_032677.1,41773675,41741129,41741136,T,TATGTAAC,7
NC_037355.1,NC_032677.1,41831438,41716400,41716401,t,ta,1
NC_037355.1,NC_032677.1,41895734,41793775,41793776,C,CY,1
NC_037355.1,NC_032677.1,41906366,41805507,41805508,a,at,1
NC_037355.1,NC_032677.1,41933737,41832878,41832880,g,gaa,2
NC_037355.1,NC_032677.1,41944321,41843394,41843398,a,atatg,4
NC_037355.1,NC_032677.1,41978768,41879881,41879883,C,CCA,2
NC_037355.1,NC_032677.1,41986179,41887290,41887297,a,acttttac,7
NC_037355.1,NC_032677.1,41990872,41892013,41892014,T,TA,1
NC_037355.1,NC_032677.1,41991066,41892208,41892209,A,AG,1
NC_037355.1,NC_032677.1,41992259,41893401,41893402,A,AG,1
NC_037355.1,NC_032677.1,41994337,41895480,41895481,C,CA,1
NC_037355.1,NC_032677.1,42001794,41902814,41902815,T,TW,1
NC_037355.1,NC_032677.1,42001978,41902984,41902985,T,TY,1
NC_037355.1,NC_032677.1,42010335,41911340,41911341,t,ta,1
NC_037355.1,NC_032677.1,42029224,41930232,41930233,T,TY,1
NC_037355.1,NC_032677.1,42035200,41937740,41937742,G,GGT,2
NC_037355.1,NC_032677.1,42037112,41939641,41939642,G,GC,1
NC_037355.1,NC_032677.1,42054715,41957257,41957258,a,ag,1
NC_037355.1,NC_032677.1,42057784,41960328,41960330,t,ttc,2
NC_037355.1,NC_032677.1,42061240,41963806,41963807,G,GA,1
NC_037355.1,NC_032677.1,42074327,41976892,41976893,C,CG,1
NC_037355.1,NC_032677.1,42080875,41983570,41983571,G,GS,1
NC_037355.1,NC_032677.1,42081825,41984521,41984522,T,TY,1
NC_037355.1,NC_032677.1,42110645,42013312,42013313,g,ga,1
NC_037355.1,NC_032677.1,42173405,42075671,42075709,C,CCCGNNNNNNNNNNNNNNNNNNNNNNNNNNNNNNNNNNN,38
NC_037355.1,NC_032677.1,42173688,42075992,42075993,A,AC,1
NC_037355.1,NC_032677.1,42183944,42086237,42086238,A,AM,1
NC_037355.1,NC_032677.1,42202798,42105116,42105118,A,AAM,2
NC_037355.1,NC_032677.1,42203358,42105777,42105802,T,TGGAGGCAGGCCTGGGGCACAGGCAC,25
NC_037355.1,NC_032677.1,42213127,42115579,42115613,C,CCTACCCACAATGCMCACCTACCCACAATGCACAS,34
NC_037355.1,NC_032677.1,42216660,42119147,42119148,g,ga,1
NC_037355.1,NC_032677.1,42228134,42129737,42129751,T,TGCGGCGTCCGGATC,14
NC_037355.1,NC_032677.1,42228149,42129766,42129770,C,CCGCG,4
NC_037355.1,NC_032677.1,42230327,42131950,42131951,a,at,1
NC_037355.1,NC_032677.1,42231987,42133594,42133597,A,AGAC,3
NC_037355.1,NC_032677.1,42237516,42139129,42139130,G,GS,1
NC_037355.1,NC_032677.1,42237971,42139585,42139586,G,GA,1
NC_037355.1,NC_032677.1,42242622,42144237,42144244,G,GAGGAGCC,7
NC_037355.1,NC_032677.1,42251031,42152650,42152651,T,TY,1
NC_037355.1,NC_032677.1,42259895,42161513,42161514,G,GR,1
NC_037355.1,NC_032677.1,42279230,42180851,42180852,G,GT,1
NC_037355.1,NC_032677.1,42302486,42204099,42204100,C,CG,1
NC_037355.1,NC_032677.1,42302534,42204148,42204149,C,CA,1
NC_037355.1,NC_032677.1,42410345,42312057,42312059,g,gta,2
NC_037355.1,NC_032677.1,42419394,42321108,42321109,T,TC,1
NC_037355.1,NC_032677.1,42430504,42332223,42332224,a,ac,1
NC_037355.1,NC_032677.1,42430549,42332269,42332270,t,tc,1
NC_037355.1,NC_032677.1,42478194,42379999,42380000,G,GC,1
NC_037355.1,NC_032677.1,42480693,42382499,42382500,G,GA,1
NC_037355.1,NC_032677.1,42523995,42425809,42425812,A,AAAG,3
NC_037355.1,NC_032677.1,42531727,42433549,42433550,A,AR,1
NC_037355.1,NC_032677.1,42532620,42434443,42434444,a,at,1
NC_037355.1,NC_032677.1,42533764,42435588,42435592,a,atttg,4
NC_037355.1,NC_032677.1,42551681,42453508,42453511,t,ttcc,3
NC_037355.1,NC_032677.1,42551703,42453533,42453534,g,gt,1
NC_037355.1,NC_032677.1,42551820,42453651,42453652,a,ag,1
NC_037355.1,NC_032677.1,42560703,42462408,42462409,g,ga,1
NC_037355.1,NC_032677.1,42611975,42514035,42514037,T,TTG,2
NC_037355.1,NC_032677.1,42629239,42531302,42531303,a,ac,1
NC_037355.1,NC_032677.1,42630041,42532105,42532106,A,AC,1
NC_037355.1,NC_032677.1,42641325,42543395,42543396,G,GA,1
NC_037355.1,NC_032677.1,42663602,42565677,42565678,T,TG,1
NC_037355.1,NC_032677.1,42664055,42566132,42566133,c,ca,1
NC_037355.1,NC_032677.1,42664217,42566295,42566303,a,attttttct,8
NC_037355.1,NC_032677.1,42668039,42570119,42570121,G,GAA,2
NC_037355.1,NC_032677.1,42675298,42577365,42577380,G,GTGTATCTCAGTTCCT,15
NC_037355.1,NC_032677.1,42681754,42583885,42583888,c,ccaa,3
NC_037355.1,NC_032677.1,42713187,42615318,42615319,C,CA,1
NC_037355.1,NC_032677.1,42854510,42764646,42764647,G,GT,1
NC_037355.1,NC_032677.1,42899882,42810003,42810004,A,AC,1
NC_037355.1,NC_032677.1,42930790,42840848,42840858,c,ccaaaaaaaaa,10
NC_037355.1,NC_032677.1,42947466,42857533,42857541,c,cttcCTTAN,8
NC_037355.1,NC_032677.1,42982514,42892593,42892594,G,GS,1
NC_037355.1,NC_032677.1,43001433,42911513,42911518,C,CTGGGT,5
NC_037355.1,NC_032677.1,43052716,42962655,42962656,T,TA,1
NC_037355.1,NC_032677.1,43069288,42979343,42979348,g,ggtttt,5
NC_037355.1,NC_032677.1,43102741,43012838,43012839,A,AR,1
NC_037355.1,NC_032677.1,43104181,43014276,43014277,T,TK,1
NC_037355.1,NC_032677.1,43116626,43026812,43026814,g,ggt,2
NC_037355.1,NC_032677.1,43132333,43042517,43042518,T,TY,1
NC_037355.1,NC_032677.1,43139401,43049586,43049590,t,taaac,4
NC_037355.1,NC_032677.1,43182408,43092597,43092598,C,CY,1
NC_037355.1,NC_032677.1,43186379,43096568,43096629,T,TGTCAGGAGACACATGTGGTTGTCATGACTTGGTGGGGAAGCTCCCAGGGGCCATTGCCAAC,61
NC_037355.1,NC_032677.1,43219918,43130240,43130255,C,CCCATAgactggagat,15
NC_037355.1,NC_032677.1,43220992,43131400,43131404,c,ctata,4
NC_037355.1,NC_032677.1,43222821,43133226,43133227,a,ac,1
NC_037355.1,NC_032677.1,43222827,43133233,43133234,c,ct,1
NC_037355.1,NC_032677.1,43224395,43134803,43134804,T,TG,1
NC_037355.1,NC_032677.1,43249026,43159502,43159506,G,GAAGT,4
NC_037355.1,NC_032677.1,43279068,43189551,43189552,T,TA,1
NC_037355.1,NC_032677.1,43304374,43214854,43214855,G,GS,1
NC_037355.1,NC_032677.1,43355037,43265787,43265788,C,CA,1
NC_037355.1,NC_032677.1,43372845,43283557,43283558,C,CG,1
NC_037355.1,NC_032677.1,43448748,43359156,43359157,G,GA,1
NC_037355.1,NC_032677.1,43456829,43368115,43368116,t,ta,1
NC_037355.1,NC_032677.1,43468731,43380021,43380022,G,GC,1
NC_037355.1,NC_032677.1,43480563,43634650,43634651,T,TA,1
NC_037355.1,NC_032677.1,43509887,43663732,43663735,G,GTGC,3
NC_037355.1,NC_032677.1,43518240,43672088,43672090,c,cca,2
NC_037355.1,NC_032677.1,43518258,43672108,43672109,c,ca,1
NC_037355.1,NC_032677.1,43518277,43672128,43672129,T,TC,1
NC_037355.1,NC_032677.1,43518321,43672174,43672175,A,AC,1
NC_037355.1,NC_032677.1,43530219,43684074,43684075,a,ac,1
NC_037355.1,NC_032677.1,43536884,43690741,43690748,A,AGACACTT,7
NC_037355.1,NC_032677.1,43575370,43729236,43729237,A,AN,1
NC_037355.1,NC_032677.1,43580187,43734055,43734058,A,AGCC,3
NC_037355.1,NC_032677.1,43619676,43601895,43601896,G,GS,1
NC_037355.1,NC_032677.1,43619789,43602009,43602010,C,CY,1
NC_037355.1,NC_032677.1,43665059,43809269,43809270,t,tg,1
NC_037355.1,NC_032677.1,43699530,43843629,43843630,G,GR,1
NC_037355.1,NC_032677.1,43707918,43852022,43852024,C,CTG,2
NC_037355.1,NC_032677.1,43708568,43852674,43852675,G,GA,1
NC_037355.1,NC_032677.1,43718308,43862725,43862726,g,ga,1
NC_037355.1,NC_032677.1,43755189,43900387,43900396,a,agtaagctac,9
NC_037355.1,NC_032677.1,43756684,43901890,43901891,a,ag,1
NC_037355.1,NC_032677.1,43763979,43909123,43909124,A,AR,1
NC_037355.1,NC_032677.1,43788762,43933686,43933687,T,TC,1
NC_037355.1,NC_032677.1,43793541,43938466,43938471,T,TATCTC,5
NC_037355.1,NC_032677.1,43793582,43938512,43938515,T,TTGG,3
NC_037355.1,NC_032677.1,43793665,43938598,43938656,C,CAGCTTTCCWTTCTAGAGAACCGGAAGAACCAAGCAAGGCCTGTGGGTGGGGAAGCAGA,58
NC_037355.1,NC_032677.1,43882682,44031783,44031784,c,ct,1
NC_037355.1,NC_032677.1,43883964,44033066,44033067,a,ag,1
NC_037355.1,NC_032677.1,43951183,44100082,44100083,C,CG,1
NC_037355.1,NC_032677.1,43955875,44104810,44104813,G,GTTC,3
NC_037355.1,NC_032677.1,43978414,44127355,44127356,c,cg,1
NC_037355.1,NC_032677.1,44033376,44182285,44182286,t,tg,1
NC_037355.1,NC_032677.1,44033380,44182290,44182291,c,ct,1
NC_037355.1,NC_032677.1,44040920,44189833,44189837,C,CACAG,4
NC_037355.1,NC_032677.1,44069754,44218670,44218671,a,ac,1
NC_037355.1,NC_032677.1,44088902,44237810,44237811,a,ac,1
NC_037355.1,NC_032677.1,44092818,44241723,44241726,C,CCTA,3
NC_037355.1,NC_032677.1,44099239,44248815,44248816,t,ta,1
NC_037355.1,NC_032677.1,44099273,44248850,44248851,C,CG,1
NC_037355.1,NC_032677.1,44099331,44248909,44249057,T,TAANNNNNNNNNNNNNNNNNNNNNNNNNNNNNNNNNNNNNNNNNNNNNNNNNNNNNNNNNNNNNNNNNNNNNNNNNNNNNNNNNNNNNNNNNNNNNNNNNNNNNNNNNNNNNNNNNNNNNNNNNNNNNNNNNNNNNNNNNNNNNNNNNN,148
NC_037355.1,NC_032677.1,44099496,44249222,44249223,C,CA,1
NC_037355.1,NC_032677.1,44126751,44276457,44276458,G,GA,1
NC_037355.1,NC_032677.1,44134771,44284360,44284369,T,TCCAGCAAGA,9
NC_037355.1,NC_032677.1,44143648,44293721,44293723,c,ctt,2
NC_037355.1,NC_032677.1,44206095,44356695,44356696,A,AC,1
NC_037355.1,NC_032677.1,44227621,44378224,44378225,C,CG,1
NC_037355.1,NC_032677.1,44229657,44380261,44380264,t,tttW,3
NC_037355.1,NC_032677.1,44233364,44383972,44383973,c,ct,1
NC_037355.1,NC_032677.1,44239015,44389624,44389633,G,GATGTCCCAA,9
NC_037355.1,NC_032677.1,44386780,44537193,44537196,A,AGAC,3
NC_037355.1,NC_032677.1,44392569,44542985,44542986,g,gc,1
NC_037355.1,NC_032677.1,44392707,44543124,44543128,c,ccccg,4
NC_037355.1,NC_032677.1,44412869,44563285,44563286,t,ta,1
NC_037355.1,NC_032677.1,44447740,44598075,44598077,a,att,2
NC_037355.1,NC_032677.1,44455151,44605488,44605492,a,aNNNN,4
NC_037355.1,NC_032677.1,44521517,44685376,44685377,c,ca,1
NC_037355.1,NC_032677.1,44521718,44685174,44685175,g,gt,1
NC_037355.1,NC_032677.1,44521735,44685156,44685157,a,at,1
NC_037355.1,NC_032677.1,44522006,44726316,44726317,c,ca,1
NC_037355.1,NC_032677.1,44522556,44726867,44726877,t,tataaaaaaaa,10
NC_037355.1,NC_032677.1,44537604,44741928,44741929,t,tc,1
NC_037355.1,NC_032677.1,44552290,44756609,44756610,c,ct,1
NC_037355.1,NC_032677.1,44556835,44761155,44761156,a,ac,1
NC_037355.1,NC_032677.1,44608594,44813326,44813338,t,tagcagcagcagc,12
NC_037355.1,NC_032677.1,44609237,44813981,44813982,G,GS,1
NC_037355.1,NC_032677.1,44616461,44821206,44821207,T,TA,1
NC_037355.1,NC_032677.1,44633307,44837708,44837710,t,tta,2
NC_037355.1,NC_032677.1,44704730,44916121,44916122,C,CT,1
NC_037355.1,NC_032677.1,44720111,44935023,44935037,t,tgcctttctttggga,14
NC_037355.1,NC_032677.1,44750984,44965911,44965913,A,ATR,2
NC_037355.1,NC_032677.1,44790580,45005511,45005513,T,TTA,2
NC_037355.1,NC_032677.1,44800425,45015505,45015506,G,GR,1
NC_037355.1,NC_032677.1,44832022,45047101,45047102,a,aW,1
NC_037355.1,NC_032677.1,44858743,45073785,45073786,A,AC,1
NC_037355.1,NC_032677.1,44904075,45118881,45118882,C,CG,1
NC_037355.1,NC_032677.1,44916470,45131106,45131107,t,tc,1
NC_037355.1,NC_032677.1,44936004,45150744,45150756,G,GGATGACCTCCCT,12
NC_037355.1,NC_032677.1,44967187,45181932,45181933,A,AM,1
NC_037355.1,NC_032677.1,44969076,45183822,45183823,C,CT,1
NC_037355.1,NC_032677.1,44970803,45185553,45185554,A,AR,1
NC_037355.1,NC_032677.1,44970840,45185591,45185592,T,TK,1
NC_037355.1,NC_032677.1,45019633,45234329,45234330,A,AG,1
NC_037355.1,NC_032677.1,45068349,45283054,45283055,C,CA,1
NC_037355.1,NC_032677.1,45105102,45320470,45320471,g,ga,1
NC_037355.1,NC_032677.1,45125360,45340740,45340749,T,TTTAGCCTCC,9
NC_037355.1,NC_032677.1,45127865,45343254,45343255,G,GA,1
NC_037355.1,NC_032677.1,45143650,45359030,45359052,G,Ggccccctccctctctgccccca,22
NC_037355.1,NC_032677.1,45147366,45362768,45362770,A,AST,2
NC_037355.1,NC_032677.1,45147962,45363366,45363368,C,CCA,2
NC_037355.1,NC_032677.1,45162798,45378226,45378227,C,CS,1
NC_037355.1,NC_032677.1,45169027,45384456,45384458,c,ctg,2
NC_037355.1,NC_032677.1,45197162,45412597,45412598,a,ac,1
NC_037355.1,NC_032677.1,45281918,45497444,45497446,A,ATT,2
NC_037355.1,NC_032677.1,45301523,45517048,45517049,G,GA,1
NC_037355.1,NC_032677.1,45317108,45532741,45532744,a,aaac,3
NC_037355.1,NC_032677.1,45319941,45535577,45535585,a,atctttact,8
NC_037355.1,NC_032677.1,45322448,45538093,45538094,c,ct,1
NC_037355.1,NC_032677.1,45349628,45565271,45565272,g,ga,1
NC_037355.1,NC_032677.1,45475237,45690619,45690620,A,AW,1
NC_037355.1,NC_032677.1,45495682,45711073,45711074,c,ct,1
NC_037355.1,NC_032677.1,45510535,45725929,45725931,a,aac,2
NC_037355.1,NC_032677.1,45520245,45735642,45735668,t,tgagagtcccttggactgcaaggagac,26
NC_037355.1,NC_032677.1,45557634,45777863,45777865,t,ttc,2
NC_037355.1,NC_032677.1,45579249,45803423,45803424,a,ac,1
NC_037355.1,NC_032677.1,45612325,45836498,45836499,c,ct,1
NC_037355.1,NC_032677.1,45615713,45839888,45839889,a,at,1
NC_037355.1,NC_032677.1,45662392,45886041,45886042,T,TG,1
NC_037355.1,NC_032677.1,45689800,45926864,45926865,A,AT,1
NC_037355.1,NC_032677.1,45708877,45945943,45945944,c,ca,1
NC_037355.1,NC_032677.1,45709189,45946256,45946259,a,agat,3
NC_037355.1,NC_032677.1,45713236,45950307,45950308,A,AC,1
NC_037355.1,NC_032677.1,45747861,45984987,45984988,a,at,1
