Reference ID,Query ID,Reference POS,Query POS,Query END,REF,ALT,SVLEN
NC_037353.1,NC_032675.1,284148,252042,252067,g,gactACAACAGTACAGAANNNNNNNN,25
NC_037353.1,NC_032675.1,300205,268699,268700,t,tc,1
NC_037353.1,NC_032675.1,341362,310033,310039,a,aaaccat,6
NC_037353.1,NC_032675.1,358642,327311,327312,t,tN,1
NC_037353.1,NC_032675.1,469346,438032,438033,a,at,1
NC_037353.1,NC_032675.1,532250,501377,501378,a,aW,1
NC_037353.1,NC_032675.1,670343,661085,661086,t,ta,1
NC_037353.1,NC_032675.1,763369,758500,758503,a,aaac,3
NC_037353.1,NC_032675.1,834063,830978,830979,G,GA,1
NC_037353.1,NC_032675.1,926314,931046,931047,t,ta,1
NC_037353.1,NC_032675.1,965464,970206,970207,A,AT,1
NC_037353.1,NC_032675.1,980050,984799,984800,a,ac,1
NC_037353.1,NC_032675.1,991304,996063,996065,a,aat,2
NC_037353.1,NC_032675.1,1049914,1049191,1049192,g,gc,1
NC_037353.1,NC_032675.1,1074361,1073636,1073637,c,cg,1
NC_037353.1,NC_032675.1,1162481,1161911,1161912,t,tW,1
NC_037353.1,NC_032675.1,1165978,1165408,1165409,G,GS,1
NC_037353.1,NC_032675.1,1209375,1208834,1208835,a,at,1
NC_037353.1,NC_032675.1,1210630,1210088,1210089,C,CT,1
NC_037353.1,NC_032675.1,1214787,1214251,1214253,T,TTA,2
NC_037353.1,NC_032675.1,1217999,1217465,1217490,g,gcctggcatacttcaaaaaaaaaaaN,25
NC_037353.1,NC_032675.1,1227480,1227637,1227640,T,TTSW,3
NC_037353.1,NC_032675.1,1229772,1229942,1229948,c,cgctgct,6
NC_037353.1,NC_032675.1,1285810,1275588,1275592,T,TGAGA,4
NC_037353.1,NC_032675.1,1285888,1275670,1275671,a,aN,1
NC_037353.1,NC_032675.1,1293717,1283496,1283498,t,tWa,2
NC_037353.1,NC_032675.1,1374128,1365384,1365386,t,tNN,2
NC_037353.1,NC_032675.1,1431077,1422346,1422347,g,gt,1
NC_037353.1,NC_032675.1,1468210,1458582,1458583,a,ac,1
NC_037353.1,NC_032675.1,1473052,1462793,1462794,g,gt,1
NC_037353.1,NC_032675.1,1504276,1494340,1494341,c,ct,1
NC_037353.1,NC_032675.1,1512269,1941611,1941612,a,aN,1
NC_037353.1,NC_032675.1,1544792,1972868,1972870,A,AAC,2
NC_037353.1,NC_032675.1,1611546,1626973,1626974,t,tg,1
NC_037353.1,NC_032675.1,1641585,1657297,1657303,g,ggggggt,6
NC_037353.1,NC_032675.1,1712972,1725118,1725119,a,ac,1
NC_037353.1,NC_032675.1,1716641,1728791,1728792,C,CM,1
NC_037353.1,NC_032675.1,1729878,1743215,1743216,C,CT,1
NC_037353.1,NC_032675.1,1732016,1745394,1745395,g,ga,1
NC_037353.1,NC_032675.1,1732555,1745934,1745935,a,ac,1
NC_037353.1,NC_032675.1,1735510,1748869,1748870,A,AC,1
NC_037353.1,NC_032675.1,1735569,1748929,1748938,C,CCAGTAAGTT,9
NC_037353.1,NC_032675.1,1736648,1750017,1750018,C,CT,1
NC_037353.1,NC_032675.1,1782252,1793166,1793167,C,CA,1
NC_037353.1,NC_032675.1,1783637,1794552,1794553,a,ag,1
NC_037353.1,NC_032675.1,1793297,1806267,1806268,a,at,1
NC_037353.1,NC_032675.1,1797650,1810632,1810634,C,CTA,2
NC_037353.1,NC_032675.1,1800686,1813671,1813675,g,gagta,4
NC_037353.1,NC_032675.1,1800710,1813699,1813700,c,ca,1
NC_037353.1,NC_032675.1,1807958,1820750,1820751,G,GC,1
NC_037353.1,NC_032675.1,1823354,1838988,1838990,T,TSW,2
NC_037353.1,NC_032675.1,1830588,1846217,1846218,g,gt,1
NC_037353.1,NC_032675.1,1830602,1846232,1846233,a,ac,1
NC_037353.1,NC_032675.1,1830602,1851634,1851635,a,ac,1
NC_037353.1,NC_032675.1,1831638,1847269,1847274,t,tacaca,5
NC_037353.1,NC_032675.1,1832658,1853689,1853690,A,AN,1
NC_037353.1,NC_032675.1,1842355,1863555,1863556,T,TY,1
NC_037353.1,NC_032675.1,1842396,1863597,1863598,G,GK,1
NC_037353.1,NC_032675.1,1863283,1884486,1884487,G,GA,1
NC_037353.1,NC_032675.1,2575333,2021260,2021261,A,AG,1
NC_037353.1,NC_032675.1,2576933,2022859,2022862,T,TCAA,3
NC_037353.1,NC_032675.1,2704688,2258880,2258881,a,aN,1
NC_037353.1,NC_032675.1,2725602,2279799,2279800,a,at,1
NC_037353.1,NC_032675.1,2802600,2357218,2357219,A,AG,1
NC_037353.1,NC_032675.1,2840736,2396036,2396037,g,ga,1
NC_037353.1,NC_032675.1,2851681,2406950,2406951,g,ga,1
NC_037353.1,NC_032675.1,2851897,2407163,2407164,a,ag,1
NC_037353.1,NC_032675.1,3000604,2560084,2560085,t,tc,1
NC_037353.1,NC_032675.1,3010251,2569731,2569733,T,TTG,2
NC_037353.1,NC_032675.1,3027721,2587217,2587223,t,tttttta,6
NC_037353.1,NC_032675.1,3145823,2697259,2697260,a,ac,1
NC_037353.1,NC_032675.1,3161865,2713310,2713313,c,ccct,3
NC_037353.1,NC_032675.1,3167274,2718719,2718721,g,gct,2
NC_037353.1,NC_032675.1,3192153,2743344,2743345,t,tg,1
NC_037353.1,NC_032675.1,3192518,2743711,2743712,T,TC,1
NC_037353.1,NC_032675.1,3193587,2744782,2744784,T,TAA,2
NC_037353.1,NC_032675.1,3197506,2748703,2748704,g,ga,1
NC_037353.1,NC_032675.1,3227248,2778444,2778449,T,TATATA,5
NC_037353.1,NC_032675.1,3227975,2779181,2779182,g,gc,1
NC_037353.1,NC_032675.1,3250134,2801326,2801336,a,aaaaaaaaaag,10
NC_037353.1,NC_032675.1,3251010,2802212,2802213,a,ag,1
NC_037353.1,NC_032675.1,3252949,2804152,2804154,g,ggt,2
NC_037353.1,NC_032675.1,3263476,2814688,2814690,A,AAT,2
NC_037353.1,NC_032675.1,3339625,2884737,2884738,t,ta,1
NC_037353.1,NC_032675.1,3353172,2901874,2901875,T,TA,1
NC_037353.1,NC_032675.1,3358939,2907639,2907640,G,GT,1
NC_037353.1,NC_032675.1,3360472,2910912,2910913,t,tc,1
NC_037353.1,NC_032675.1,3371947,2922216,2922217,t,ta,1
NC_037353.1,NC_032675.1,3371955,2922225,2922227,t,tta,2
NC_037353.1,NC_032675.1,3391537,2941806,2941807,T,TC,1
NC_037353.1,NC_032675.1,3391574,2941844,2941845,G,GT,1
NC_037353.1,NC_032675.1,3392861,2943132,2943133,g,gY,1
NC_037353.1,NC_032675.1,3398824,2949096,2949098,t,tca,2
NC_037353.1,NC_032675.1,3529041,3069816,3069818,t,tNN,2
NC_037353.1,NC_032675.1,3635512,3177174,3177175,g,gt,1
NC_037353.1,NC_032675.1,3663044,3204706,3204707,A,AG,1
NC_037353.1,NC_032675.1,3665942,3207609,3207618,a,atatggcttt,9
NC_037353.1,NC_032675.1,3676051,3218843,3218849,a,aaaaatg,6
NC_037353.1,NC_032675.1,3680207,3223047,3223048,C,CA,1
NC_037353.1,NC_032675.1,3753769,3288568,3288569,c,ct,1
NC_037353.1,NC_032675.1,3754663,3289463,3289464,g,ga,1
NC_037353.1,NC_032675.1,3767312,3302127,3302128,T,TC,1
NC_037353.1,NC_032675.1,3768291,3303106,3303107,G,GR,1
NC_037353.1,NC_032675.1,3768610,3303425,3303426,T,TG,1
NC_037353.1,NC_032675.1,3787542,3322223,3322227,T,TGTGA,4
NC_037353.1,NC_032675.1,3847749,3382444,3382446,a,aNN,2
NC_037353.1,NC_032675.1,3877158,3411854,3411855,g,ga,1
NC_037353.1,NC_032675.1,3877560,3412257,3412260,c,cttg,3
NC_037353.1,NC_032675.1,3878403,3413101,3413103,a,aat,2
NC_037353.1,NC_032675.1,3928634,3468547,3468548,C,CT,1
NC_037353.1,NC_032675.1,3941515,3481323,3481325,G,GGT,2
NC_037353.1,NC_032675.1,3968741,3523074,3523075,a,at,1
NC_037353.1,NC_032675.1,3968758,3523092,3523093,a,at,1
NC_037353.1,NC_032675.1,3969767,3524104,3524105,c,ct,1
NC_037353.1,NC_032675.1,3997683,3551891,3551895,g,gaaaa,4
NC_037353.1,NC_032675.1,4004650,3558862,3558871,a,agtccaaggg,9
NC_037353.1,NC_032675.1,4004988,3559202,3559206,c,ctttt,4
NC_037353.1,NC_032675.1,4005011,3559229,3559231,t,taa,2
NC_037353.1,NC_032675.1,4006652,3560873,3560874,A,AR,1
NC_037353.1,NC_032675.1,4007526,3561744,3561745,c,cW,1
NC_037353.1,NC_032675.1,4009267,3563491,3563496,C,CTATAG,5
NC_037353.1,NC_032675.1,4012052,3566163,3566164,C,CT,1
NC_037353.1,NC_032675.1,4024563,3578682,3578684,g,ggt,2
NC_037353.1,NC_032675.1,4073780,3670540,3670551,g,gcttatttaact,11
NC_037353.1,NC_032675.1,4080193,3676964,3676965,A,AM,1
NC_037353.1,NC_032675.1,4082012,3678784,3678786,t,tcc,2
NC_037353.1,NC_032675.1,4126146,3738285,3738286,t,tg,1
NC_037353.1,NC_032675.1,4129128,3741313,3741320,C,CTTGTCCA,7
NC_037353.1,NC_032675.1,4129608,3741800,3741803,T,TTTC,3
NC_037353.1,NC_032675.1,4137050,3749250,3749253,A,ATAT,3
NC_037353.1,NC_032675.1,4152874,3765093,3765094,g,gt,1
NC_037353.1,NC_032675.1,4214928,3827123,3827124,t,tc,1
NC_037353.1,NC_032675.1,4220811,3833006,3833007,C,CA,1
NC_037353.1,NC_032675.1,4233796,3845986,3845988,a,aat,2
NC_037353.1,NC_032675.1,4236469,3848666,3848700,C,CTTGCATCATACAATTTTAGAAACTTGGTAAGAGA,34
NC_037353.1,NC_032675.1,4295344,3911080,3911081,t,tY,1
NC_037353.1,NC_032675.1,4296717,3912455,3912456,t,tg,1
NC_037353.1,NC_032675.1,4380055,3993352,3993353,G,GT,1
NC_037353.1,NC_032675.1,4380113,3993411,3993412,A,AR,1
NC_037353.1,NC_032675.1,4404064,4017366,4017367,A,AR,1
NC_037353.1,NC_032675.1,4664091,4482872,4482874,t,tNN,2
NC_037353.1,NC_032675.1,4669361,4488145,4488146,G,GR,1
NC_037353.1,NC_032675.1,4730827,4548421,4548422,t,tc,1
NC_037353.1,NC_032675.1,4730951,4548544,4548545,g,ga,1
NC_037353.1,NC_032675.1,4733447,4551033,4551034,t,ta,1
NC_037353.1,NC_032675.1,4735307,4552893,4552894,c,ca,1
NC_037353.1,NC_032675.1,4735362,4552949,4552999,g,gtgtgtgtatatatatatatatatatatatatatatatatatatatatata,50
NC_037353.1,NC_032675.1,4736020,4553657,4553658,T,TG,1
NC_037353.1,NC_032675.1,4736693,4554416,4554432,c,ctaaagaacctcttatt,16
NC_037353.1,NC_032675.1,4738119,4555861,4555864,G,GATA,3
NC_037353.1,NC_032675.1,4749381,4565846,4565847,t,ta,1
NC_037353.1,NC_032675.1,4749857,4566323,4566324,G,GT,1
NC_037353.1,NC_032675.1,4750345,4566794,4566796,C,CAG,2
NC_037353.1,NC_032675.1,4770821,4587269,4587270,G,GA,1
NC_037353.1,NC_032675.1,4771654,4588103,4588105,c,caa,2
NC_037353.1,NC_032675.1,4816719,4635331,4635332,c,ca,1
NC_037353.1,NC_032675.1,4818533,4637146,4637147,t,ta,1
NC_037353.1,NC_032675.1,4823990,4642217,4642218,g,ga,1
NC_037353.1,NC_032675.1,4898441,4693736,4693737,c,ca,1
NC_037353.1,NC_032675.1,4900530,4695826,4695828,c,cca,2
NC_037353.1,NC_032675.1,4904375,4700129,4700134,a,attttt,5
NC_037353.1,NC_032675.1,4907918,4703677,4703678,A,AG,1
NC_037353.1,NC_032675.1,4916308,4712081,4712082,t,tg,1
NC_037353.1,NC_032675.1,4964226,4759839,4759845,a,aNNNNNN,6
NC_037353.1,NC_032675.1,4964255,4759874,4759875,t,ta,1
NC_037353.1,NC_032675.1,4982911,4778518,4778524,t,tagcagc,6
NC_037353.1,NC_032675.1,5003344,4798907,4798908,A,AG,1
NC_037353.1,NC_032675.1,5025132,4820219,4820220,t,ta,1
NC_037353.1,NC_032675.1,5026425,4821513,4821516,c,ctta,3
NC_037353.1,NC_032675.1,5029005,4824097,4824098,a,at,1
NC_037353.1,NC_032675.1,5034189,4832177,4832181,c,ctttt,4
NC_037353.1,NC_032675.1,5036945,4834935,4834936,C,CT,1
NC_037353.1,NC_032675.1,5045567,4843568,4843577,g,gtgtgttttt,9
NC_037353.1,NC_032675.1,5046576,4844586,4844587,a,at,1
NC_037353.1,NC_032675.1,5092500,4890555,4890556,a,at,1
NC_037353.1,NC_032675.1,5107297,4905450,4905452,C,CTG,2
NC_037353.1,NC_032675.1,5241474,5062497,5062498,t,tg,1
NC_037353.1,NC_032675.1,5348617,5169647,5169648,A,AG,1
NC_037353.1,NC_032675.1,5406559,5227591,5227595,A,ANNNN,4
NC_037353.1,NC_032675.1,5424967,5245970,5245971,T,TW,1
NC_037353.1,NC_032675.1,5433133,5254138,5254139,t,ta,1
NC_037353.1,NC_032675.1,5434181,5255187,5255188,t,tg,1
NC_037353.1,NC_032675.1,5435293,5256300,5256306,t,tgggaga,6
NC_037353.1,NC_032675.1,5437984,5259001,5259002,C,CY,1
NC_037353.1,NC_032675.1,5441571,5262865,5262866,t,ta,1
NC_037353.1,NC_032675.1,5443170,5264465,5264466,c,ct,1
NC_037353.1,NC_032675.1,5447010,5268329,5268330,t,tK,1
NC_037353.1,NC_032675.1,5469173,5290489,5290490,t,ta,1
NC_037353.1,NC_032675.1,5640407,5555116,5555118,a,aaM,2
NC_037353.1,NC_032675.1,5668788,5583485,5583489,a,atttt,4
NC_037353.1,NC_032675.1,5670639,5585496,5585505,t,ttttttatta,9
NC_037353.1,NC_032675.1,6010302,6250723,6250724,a,at,1
NC_037353.1,NC_032675.1,6014750,6254998,6255174,T,TGTTAGATTCCTAATAGGCANNNNNNNNNNNNNNNNNNNNNNNNNNNNNNNNNNNNNNNNNNNNNNNNNNNNNNNNNNNNNNNNNNNNNNNNNNNNNNNNNNNNNNNNNNNNNNNNNNNNNNNNNNNNNNNNNNNNNNNNNNNNNNNNNNNNNNNNNNNNNNNNNNNNNNNNCTAAA,176
NC_037353.1,NC_032675.1,6128464,6369316,6369329,c,ctatgCGATTNNNN,13
NC_037353.1,NC_032675.1,6185660,6425939,6425940,G,GA,1
NC_037353.1,NC_032675.1,6226479,6466293,6466294,a,ac,1
NC_037353.1,NC_032675.1,6325821,6564863,6564864,a,ag,1
NC_037353.1,NC_032675.1,6386347,6625549,6625550,t,tY,1
NC_037353.1,NC_032675.1,6419183,6658045,6658056,G,GATGGTATTACT,11
NC_037353.1,NC_032675.1,6420749,6659626,6659628,a,atc,2
NC_037353.1,NC_032675.1,6437356,6676232,6676233,A,AG,1
NC_037353.1,NC_032675.1,6447637,6686515,6686516,A,AT,1
NC_037353.1,NC_032675.1,6489109,6728003,6728005,c,cct,2
NC_037353.1,NC_032675.1,6562199,6846903,6846904,t,ta,1
NC_037353.1,NC_032675.1,6588023,6872638,6872639,a,ag,1
NC_037353.1,NC_032675.1,6588191,6872807,6872808,A,AC,1
NC_037353.1,NC_032675.1,6588681,6873298,6873302,a,aatat,4
NC_037353.1,NC_032675.1,6590460,6875082,6875083,g,ga,1
NC_037353.1,NC_032675.1,6591721,6876344,6876347,g,gaaa,3
NC_037353.1,NC_032675.1,6623308,6746968,6746969,T,TW,1
NC_037353.1,NC_032675.1,6633267,6757232,6757237,T,TGTAAA,5
NC_037353.1,NC_032675.1,6633459,6757429,6757432,A,AATM,3
NC_037353.1,NC_032675.1,6648276,6772674,6772685,g,ggtttttttttt,11
NC_037353.1,NC_032675.1,6658291,6924254,6924255,t,tc,1
NC_037353.1,NC_032675.1,6745843,7012847,7012860,A,AAGTTGACACCAAT,13
NC_037353.1,NC_032675.1,6765450,7032762,7032763,c,ct,1
NC_037353.1,NC_032675.1,6783667,7050775,7050776,t,tc,1
NC_037353.1,NC_032675.1,6783682,7050791,7050792,a,ac,1
NC_037353.1,NC_032675.1,6793177,7060394,7060395,a,at,1
NC_037353.1,NC_032675.1,6804191,7071406,7071444,G,GCTTGAAAGAAYAAATCATGCCACAATAATTTTGTGCTT,38
NC_037353.1,NC_032675.1,6818835,7086085,7086086,g,gc,1
NC_037353.1,NC_032675.1,6907815,7175048,7175049,t,ta,1
NC_037353.1,NC_032675.1,6910530,7177765,7177766,C,CA,1
NC_037353.1,NC_032675.1,7062789,7330221,7330222,g,gt,1
NC_037353.1,NC_032675.1,7087575,7460432,7460433,t,ta,1
NC_037353.1,NC_032675.1,7209130,7510886,7510889,T,TATA,3
NC_037353.1,NC_032675.1,7212506,7514255,7514256,G,GR,1
NC_037353.1,NC_032675.1,7217250,7519001,7519005,t,tctNN,4
NC_037353.1,NC_032675.1,7225185,7526948,7526949,a,ac,1
NC_037353.1,NC_032675.1,7225686,7527450,7527451,c,ct,1
NC_037353.1,NC_032675.1,7229771,7531522,7531523,t,ta,1
NC_037353.1,NC_032675.1,7229985,7531737,7531738,T,TC,1
NC_037353.1,NC_032675.1,7235050,7536787,7536789,t,ttg,2
NC_037353.1,NC_032675.1,7239329,7541069,7541070,G,GA,1
NC_037353.1,NC_032675.1,7248354,7550097,7550099,a,aac,2
NC_037353.1,NC_032675.1,7250307,7552047,7552048,T,TG,1
NC_037353.1,NC_032675.1,7270124,7573666,7573667,t,ta,1
NC_037353.1,NC_032675.1,7296132,7599678,7599679,g,ga,1
NC_037353.1,NC_032675.1,7306462,7610009,7610025,g,gtgtgtgtgtgtgtgtR,16
NC_037353.1,NC_032675.1,7308330,7611891,7611895,t,tcaca,4
NC_037353.1,NC_032675.1,7312938,7616516,7616517,t,ta,1
NC_037353.1,NC_032675.1,7349811,7653406,7653407,A,AM,1
NC_037353.1,NC_032675.1,7353733,7657329,7657332,a,atat,3
NC_037353.1,NC_032675.1,7378110,7681483,7681485,g,gga,2
NC_037353.1,NC_032675.1,7418173,7721552,7721556,T,TTGAA,4
NC_037353.1,NC_032675.1,7422932,7726310,7726317,c,ctttcact,7
NC_037353.1,NC_032675.1,7479502,7782890,7782897,G,GGGGGTGT,7
NC_037353.1,NC_032675.1,7505533,7808932,7808936,t,ttaaa,4
NC_037353.1,NC_032675.1,7508710,7812126,7812128,G,GAT,2
NC_037353.1,NC_032675.1,7523000,7826456,7826471,G,GACCCAGGCAGGGCCA,15
NC_037353.1,NC_032675.1,7526122,7829591,7829592,T,TC,1
NC_037353.1,NC_032675.1,7531498,7834637,7834639,C,CAT,2
NC_037353.1,NC_032675.1,7561902,7865044,7865046,t,tcc,2
NC_037353.1,NC_032675.1,7582906,7886054,7886055,t,tg,1
NC_037353.1,NC_032675.1,7583082,7886231,7886232,g,ga,1
NC_037353.1,NC_032675.1,7586855,7890005,7890007,c,caa,2
NC_037353.1,NC_032675.1,7587483,7890635,7890636,a,ac,1
NC_037353.1,NC_032675.1,7587667,7890820,7890825,t,tgaacc,5
NC_037353.1,NC_032675.1,7597025,7900243,7900244,C,CA,1
NC_037353.1,NC_032675.1,7624573,7927794,7927821,C,CAACAGACTTCCACATTTTCCAAGTTCA,27
NC_037353.1,NC_032675.1,7628602,7931847,7931848,g,gc,1
NC_037353.1,NC_032675.1,7634199,7937462,7937465,c,cact,3
NC_037353.1,NC_032675.1,7637351,7940630,7940631,g,ga,1
NC_037353.1,NC_032675.1,7646086,7949373,7949375,c,ctt,2
NC_037353.1,NC_032675.1,7650762,7954055,7954056,A,AR,1
NC_037353.1,NC_032675.1,7655066,7958364,7958365,G,GA,1
NC_037353.1,NC_032675.1,7662420,7965721,7965727,T,TGATATA,6
NC_037353.1,NC_032675.1,7662879,7966186,7966187,c,ct,1
NC_037353.1,NC_032675.1,7665371,7968679,7968680,C,CA,1
NC_037353.1,NC_032675.1,7675697,7979048,7979049,T,TW,1
NC_037353.1,NC_032675.1,7695874,7999225,7999226,a,ag,1
NC_037353.1,NC_032675.1,7695923,7999275,7999276,t,tY,1
NC_037353.1,NC_032675.1,7728023,8031375,8031380,c,caaaaa,5
NC_037353.1,NC_032675.1,7739835,8043193,8043194,A,AR,1
NC_037353.1,NC_032675.1,7743388,8046747,8046753,T,TCTGAAY,6
NC_037353.1,NC_032675.1,7744579,8047944,8047945,t,ta,1
NC_037353.1,NC_032675.1,7812975,8116880,8116881,T,TA,1
NC_037353.1,NC_032675.1,7904843,8257263,8257264,T,TA,1
NC_037353.1,NC_032675.1,7904867,8257287,8257288,T,TG,1
NC_037353.1,NC_032675.1,7938418,8291049,8291053,t,taaac,4
NC_037353.1,NC_032675.1,8031992,8384168,8384170,G,GNN,2
NC_037353.1,NC_032675.1,8046844,8399027,8399030,t,ttag,3
NC_037353.1,NC_032675.1,8068606,8420833,8420834,A,AT,1
NC_037353.1,NC_032675.1,8106513,8459109,8459112,t,tgaa,3
NC_037353.1,NC_032675.1,8108252,8460850,8460851,A,AG,1
NC_037353.1,NC_032675.1,8114052,8466649,8466650,A,AR,1
NC_037353.1,NC_032675.1,8117483,8470092,8470093,t,tg,1
NC_037353.1,NC_032675.1,8117579,8470189,8470190,a,at,1
NC_037353.1,NC_032675.1,8149960,8502578,8502580,t,tNN,2
NC_037353.1,NC_032675.1,8242775,8636870,8636873,t,tagc,3
NC_037353.1,NC_032675.1,8277141,8672124,8672125,A,AG,1
NC_037353.1,NC_032675.1,8347876,8872499,8872500,c,ca,1
NC_037353.1,NC_032675.1,8370667,8899297,8899298,T,TC,1
NC_037353.1,NC_032675.1,8428057,8956863,8956864,T,TA,1
NC_037353.1,NC_032675.1,8429762,8958571,8958575,T,TACTC,4
NC_037353.1,NC_032675.1,8429762,8729228,8729232,T,TACTC,4
NC_037353.1,NC_032675.1,8431429,8960242,8960243,A,AG,1
NC_037353.1,NC_032675.1,8437221,8966035,8966036,a,ac,1
NC_037353.1,NC_032675.1,8438081,8966896,8966897,t,ta,1
NC_037353.1,NC_032675.1,8438885,8967701,8967702,A,AG,1
NC_037353.1,NC_032675.1,8438885,8738359,8738360,A,AG,1
NC_037353.1,NC_032675.1,8439430,8968248,8968249,c,cg,1
NC_037353.1,NC_032675.1,8439430,8738906,8738907,c,cg,1
NC_037353.1,NC_032675.1,8442661,8971476,8971480,G,GNNNN,4
NC_037353.1,NC_032675.1,8463265,8762864,8762865,C,CN,1
NC_037353.1,NC_032675.1,8464195,8763796,8763797,G,GC,1
NC_037353.1,NC_032675.1,8480101,8779322,8779323,c,ca,1
NC_037353.1,NC_032675.1,8480101,8981292,8981293,c,ca,1
NC_037353.1,NC_032675.1,8480427,8779651,8779658,a,aNNNNNNN,7
NC_037353.1,NC_032675.1,8539899,9041497,9041498,A,AG,1
NC_037353.1,NC_032675.1,8727860,9260323,9260328,a,atatat,5
NC_037353.1,NC_032675.1,8758230,9290704,9290708,c,caaaa,4
NC_037353.1,NC_032675.1,8760261,9292739,9292750,G,GNNNNNNNNNNN,11
NC_037353.1,NC_032675.1,8768411,9300908,9300909,g,gt,1
NC_037353.1,NC_032675.1,8796135,9328644,9328648,t,tNNNN,4
NC_037353.1,NC_032675.1,8848362,9380885,9380886,C,CA,1
NC_037353.1,NC_032675.1,8852643,9385167,9385168,A,AR,1
NC_037353.1,NC_032675.1,8854762,9387287,9387296,g,gaaacagtgt,9
NC_037353.1,NC_032675.1,8857386,9389921,9389926,a,aaaaac,5
NC_037353.1,NC_032675.1,8889618,9423320,9423325,t,tatata,5
NC_037353.1,NC_032675.1,8909535,9443199,9443200,t,ta,1
NC_037353.1,NC_032675.1,8916508,9450173,9450175,T,TGA,2
NC_037353.1,NC_032675.1,8932713,9466385,9466387,g,gca,2
NC_037353.1,NC_032675.1,8955010,9488681,9488682,A,AG,1
NC_037353.1,NC_032675.1,8985747,9519416,9519418,t,ttc,2
NC_037353.1,NC_032675.1,9016117,9549788,9549789,C,CN,1
NC_037353.1,NC_032675.1,9016159,9549831,9549832,A,AW,1
NC_037353.1,NC_032675.1,9024051,9557731,9557732,G,GC,1
NC_037353.1,NC_032675.1,9041015,9574696,9574697,A,AC,1
NC_037353.1,NC_032675.1,9046852,9580513,9580514,A,AT,1
NC_037353.1,NC_032675.1,9077484,9611256,9611260,T,TTGTC,4
NC_037353.1,NC_032675.1,9165998,9699387,9699388,A,AG,1
NC_037353.1,NC_032675.1,9314564,9835987,9835989,G,GAC,2
NC_037353.1,NC_032675.1,9339239,9860648,9860649,G,GA,1
NC_037353.1,NC_032675.1,9354834,9876466,9876478,c,catctcatgagat,12
NC_037353.1,NC_032675.1,9361985,9883631,9883635,t,tttaa,4
NC_037353.1,NC_032675.1,9465249,9986895,9986897,T,TTA,2
NC_037353.1,NC_032675.1,9465251,9986899,9986900,C,CA,1
NC_037353.1,NC_032675.1,9570190,10084921,10084922,T,TC,1
NC_037353.1,NC_032675.1,9570201,10084933,10084934,C,CA,1
NC_037353.1,NC_032675.1,9636030,10150794,10150795,g,ga,1
NC_037353.1,NC_032675.1,9684159,10199757,10199760,A,ATTG,3
NC_037353.1,NC_032675.1,9695770,10211373,10211377,t,tacac,4
NC_037353.1,NC_032675.1,9697954,10213560,10213561,A,AG,1
NC_037353.1,NC_032675.1,9704744,10220352,10220353,T,TN,1
NC_037353.1,NC_032675.1,9725283,10240915,10240917,G,GAC,2
NC_037353.1,NC_032675.1,9744828,10260458,10260460,t,tNN,2
NC_037353.1,NC_032675.1,9748860,10264494,10264496,c,cct,2
NC_037353.1,NC_032675.1,9784458,10299308,10299309,c,ct,1
NC_037353.1,NC_032675.1,9786348,10301199,10301200,A,AR,1
NC_037353.1,NC_032675.1,9828260,10342546,10342547,G,GK,1
NC_037353.1,NC_032675.1,9878904,10392577,10392578,G,GT,1
NC_037353.1,NC_032675.1,9878904,10423400,10423401,G,GT,1
NC_037353.1,NC_032675.1,10044951,10592702,10592707,t,tgtttg,5
NC_037353.1,NC_032675.1,10073083,10620839,10620840,g,ga,1
NC_037353.1,NC_032675.1,10081050,10628827,10628828,A,AT,1
NC_037353.1,NC_032675.1,10089127,10637164,10637165,G,GC,1
NC_037353.1,NC_032675.1,10189065,10737088,10737089,g,gt,1
NC_037353.1,NC_032675.1,10196207,10744219,10744220,C,CY,1
NC_037353.1,NC_032675.1,10198380,10746392,10746393,t,tc,1
NC_037353.1,NC_032675.1,10198454,10746467,10746468,g,gc,1
NC_037353.1,NC_032675.1,10199114,10747126,10747127,a,at,1
NC_037353.1,NC_032675.1,10199569,10747582,10747583,c,ca,1
NC_037353.1,NC_032675.1,10207152,10755184,10755186,A,ATT,2
NC_037353.1,NC_032675.1,10212140,10760169,10760171,A,AAG,2
NC_037353.1,NC_032675.1,10221834,10769868,10769869,t,ta,1
NC_037353.1,NC_032675.1,10221840,10769875,10769877,a,aat,2
NC_037353.1,NC_032675.1,10254336,10802386,10802389,A,ATAT,3
NC_037353.1,NC_032675.1,10255093,10803146,10803150,a,aNNNN,4
NC_037353.1,NC_032675.1,10259551,10807610,10807611,a,at,1
NC_037353.1,NC_032675.1,10260831,10808896,10808899,t,tagc,3
NC_037353.1,NC_032675.1,10264609,10812680,10812684,C,CTATT,4
NC_037353.1,NC_032675.1,10265499,10813574,10813575,a,ag,1
NC_037353.1,NC_032675.1,10267654,10815726,10815727,t,ta,1
NC_037353.1,NC_032675.1,10268699,10816769,10816770,T,TC,1
NC_037353.1,NC_032675.1,10269185,10817252,10817256,A,ATGTC,4
NC_037353.1,NC_032675.1,10292680,10841272,10841273,a,ac,1
NC_037353.1,NC_032675.1,10296490,10845089,10845090,a,ac,1
NC_037353.1,NC_032675.1,10299950,10848550,10848551,A,AT,1
NC_037353.1,NC_032675.1,10308513,10857116,10857117,g,gc,1
NC_037353.1,NC_032675.1,10310019,10858623,10858624,a,at,1
NC_037353.1,NC_032675.1,10310673,10859278,10859279,g,gt,1
NC_037353.1,NC_032675.1,10317545,10865759,10865760,a,ag,1
NC_037353.1,NC_032675.1,10336799,10884814,10884815,t,tg,1
NC_037353.1,NC_032675.1,10344108,10892121,10892124,A,AAAG,3
NC_037353.1,NC_032675.1,10346307,10894323,10894324,G,GC,1
NC_037353.1,NC_032675.1,10351744,10899772,10899778,T,TTGGAAC,6
NC_037353.1,NC_032675.1,10355286,10903322,10903324,c,cta,2
NC_037353.1,NC_032675.1,10357061,10905096,10905097,T,TA,1
NC_037353.1,NC_032675.1,10359276,10907304,10907305,g,gt,1
NC_037353.1,NC_032675.1,10359383,10907412,10907414,c,cca,2
NC_037353.1,NC_032675.1,10360163,10908194,10908195,t,tY,1
NC_037353.1,NC_032675.1,10360695,10908726,10908727,a,ag,1
NC_037353.1,NC_032675.1,10371564,10919653,10919654,C,CY,1
NC_037353.1,NC_032675.1,10411519,10962554,10962555,C,CY,1
NC_037353.1,NC_032675.1,10422914,10973954,10973957,G,GATA,3
NC_037353.1,NC_032675.1,10424179,10975222,10975223,A,AW,1
NC_037353.1,NC_032675.1,10465948,10995491,10995506,t,ttgccaaagtctctgc,15
NC_037353.1,NC_032675.1,10481144,11043683,11043684,g,gc,1
NC_037353.1,NC_032675.1,10481358,11043898,11043910,T,TCATTTATACATC,12
NC_037353.1,NC_032675.1,10510543,11073294,11073296,A,AAC,2
NC_037353.1,NC_032675.1,10512315,11075067,11075069,C,CCA,2
NC_037353.1,NC_032675.1,10519340,11082094,11082100,A,ACCTGCT,6
NC_037353.1,NC_032675.1,10526651,11089412,11089416,t,ttttg,4
NC_037353.1,NC_032675.1,10680056,11242584,11242585,a,ag,1
NC_037353.1,NC_032675.1,10716021,11278566,11278567,A,AT,1
NC_037353.1,NC_032675.1,10726577,11289150,11289151,t,tN,1
NC_037353.1,NC_032675.1,10760918,11323497,11323503,a,aaaaaac,6
NC_037353.1,NC_032675.1,10768645,11331231,11331232,a,ag,1
NC_037353.1,NC_032675.1,10797661,11360814,11360815,T,TA,1
NC_037353.1,NC_032675.1,10921813,11427411,11427418,a,aagtggag,7
NC_037353.1,NC_032675.1,10949132,11455698,11455699,A,AT,1
NC_037353.1,NC_032675.1,10962485,11469050,11469051,G,GN,1
NC_037353.1,NC_032675.1,10963953,11470521,11470522,t,ta,1
NC_037353.1,NC_032675.1,10974434,11481003,11481004,c,cg,1
NC_037353.1,NC_032675.1,10975100,11481670,11481673,c,caaM,3
NC_037353.1,NC_032675.1,10987646,11494228,11494229,A,AG,1
NC_037353.1,NC_032675.1,10997863,11504446,11504447,A,AG,1
NC_037353.1,NC_032675.1,11012219,11518746,11518786,G,GNNNNNNNNNNNNNNNNNNNNNNNNNNNNNNNNNNNNNNNN,40
NC_037353.1,NC_032675.1,11022866,11529436,11529439,A,AGCC,3
NC_037353.1,NC_032675.1,11023616,11530189,11530190,G,GR,1
NC_037353.1,NC_032675.1,11037963,11544539,11544543,c,cacaa,4
NC_037353.1,NC_032675.1,11077822,11585145,11585146,T,TA,1
NC_037353.1,NC_032675.1,11092802,11600131,11600133,G,GAC,2
NC_037353.1,NC_032675.1,11097220,11604554,11604556,A,ATC,2
NC_037353.1,NC_032675.1,11129556,11637044,11637045,a,at,1
NC_037353.1,NC_032675.1,11251041,11766589,11766590,c,ct,1
NC_037353.1,NC_032675.1,11252899,11768448,11768449,c,ca,1
NC_037353.1,NC_032675.1,11297283,11812841,11812842,T,TA,1
NC_037353.1,NC_032675.1,11302993,11818553,11818554,G,GR,1
NC_037353.1,NC_032675.1,11317870,11833431,11833432,a,at,1
NC_037353.1,NC_032675.1,11409748,11925261,11925263,t,ttg,2
NC_037353.1,NC_032675.1,11416935,11932449,11932454,c,cgctgg,5
NC_037353.1,NC_032675.1,11431265,11946785,11946787,a,atN,2
NC_037353.1,NC_032675.1,11458692,11974028,11974056,t,tattgtgtatatatatatatatatatata,28
NC_037353.1,NC_032675.1,11483518,11998884,11998885,a,at,1
NC_037353.1,NC_032675.1,11536094,12051791,12051792,a,ac,1
NC_037353.1,NC_032675.1,11537265,12052962,12052963,t,ta,1
NC_037353.1,NC_032675.1,11863567,12405289,12405290,A,AG,1
NC_037353.1,NC_032675.1,11864014,12405732,12405749,C,CCAACTTAACTGACATTT,17
NC_037353.1,NC_032675.1,11878444,12420176,12420177,C,CM,1
NC_037353.1,NC_032675.1,11883591,12425314,12425315,g,ga,1
NC_037353.1,NC_032675.1,11889393,12431092,12431093,T,TA,1
NC_037353.1,NC_032675.1,11890932,12432780,12432782,c,cat,2
NC_037353.1,NC_032675.1,11892172,12434030,12434031,G,GK,1
NC_037353.1,NC_032675.1,11896459,12438347,12438348,A,AT,1
NC_037353.1,NC_032675.1,11907007,12448900,12448902,G,GGA,2
NC_037353.1,NC_032675.1,11908903,12450800,12450806,a,attgcag,6
NC_037353.1,NC_032675.1,11912796,12454484,12454485,G,GK,1
NC_037353.1,NC_032675.1,11916258,12457947,12457948,t,tc,1
NC_037353.1,NC_032675.1,11917424,12459114,12459115,T,TC,1
NC_037353.1,NC_032675.1,11917438,12459129,12459130,C,CS,1
NC_037353.1,NC_032675.1,11967258,12508870,12508871,a,ag,1
NC_037353.1,NC_032675.1,11976991,12519343,12519344,a,at,1
NC_037353.1,NC_032675.1,12005237,12535819,12535826,t,tgctttAG,7
NC_037353.1,NC_032675.1,12035684,12565175,12565176,a,at,1
NC_037353.1,NC_032675.1,12046741,12576235,12576236,g,ga,1
NC_037353.1,NC_032675.1,12046840,12576335,12576340,c,ctcata,5
NC_037353.1,NC_032675.1,12053937,12594933,12594936,A,AAAG,3
NC_037353.1,NC_032675.1,12083963,12624683,12624684,g,gc,1
NC_037353.1,NC_032675.1,12083989,12624710,12624711,t,ta,1
NC_037353.1,NC_032675.1,12090098,12630830,12630831,A,AC,1
NC_037353.1,NC_032675.1,12104041,12644387,12644388,C,CY,1
NC_037353.1,NC_032675.1,12195453,12681640,12681641,g,gR,1
NC_037353.1,NC_032675.1,12199535,12685732,12685734,T,TAC,2
NC_037353.1,NC_032675.1,12204639,12690832,12690833,G,GT,1
NC_037353.1,NC_032675.1,12215672,12701864,12701866,a,agg,2
NC_037353.1,NC_032675.1,12221148,12707343,12707345,g,gaa,2
NC_037353.1,NC_032675.1,12222953,12709153,12709156,G,GAGA,3
NC_037353.1,NC_032675.1,12234712,12720659,12720660,T,TY,1
NC_037353.1,NC_032675.1,12268436,12754213,12754214,A,AT,1
NC_037353.1,NC_032675.1,12283053,12768828,12768830,C,CCA,2
NC_037353.1,NC_032675.1,12283544,12769258,12769260,c,ctt,2
NC_037353.1,NC_032675.1,12283568,12769284,12769285,g,gc,1
NC_037353.1,NC_032675.1,12284246,12769963,12769966,t,ttcc,3
NC_037353.1,NC_032675.1,12300527,12786241,12786245,A,ATTGT,4
NC_037353.1,NC_032675.1,12330052,12815768,12815774,a,aNNNNNN,6
NC_037353.1,NC_032675.1,12341569,12827337,12827338,T,TY,1
NC_037353.1,NC_032675.1,12342750,12828519,12828520,g,gc,1
NC_037353.1,NC_032675.1,12342825,12828595,12828596,c,ca,1
NC_037353.1,NC_032675.1,12352523,12838299,12838300,a,ac,1
NC_037353.1,NC_032675.1,12355468,12841243,12841244,C,CM,1
NC_037353.1,NC_032675.1,12426858,12912973,12912974,a,ag,1
NC_037353.1,NC_032675.1,12645377,13152393,13152394,g,gt,1
NC_037353.1,NC_032675.1,12715922,13241396,13241401,c,cacaca,5
NC_037353.1,NC_032675.1,12724043,13249531,13249532,t,tc,1
NC_037353.1,NC_032675.1,12729366,13254813,13254815,C,CCT,2
NC_037353.1,NC_032675.1,12731827,13257276,13257277,T,TC,1
NC_037353.1,NC_032675.1,12748178,13273632,13273635,t,tagc,3
NC_037353.1,NC_032675.1,12824937,13353139,13353140,t,tY,1
NC_037353.1,NC_032675.1,12836898,13365097,13365098,c,ca,1
NC_037353.1,NC_032675.1,12837856,13366056,13366060,t,tNNNN,4
NC_037353.1,NC_032675.1,12861003,13389208,13389211,T,TCTC,3
NC_037353.1,NC_032675.1,12870815,13398981,13398982,T,TK,1
NC_037353.1,NC_032675.1,13017472,13545592,13545593,a,at,1
NC_037353.1,NC_032675.1,13072299,13597148,13597149,t,tg,1
NC_037353.1,NC_032675.1,13085301,13610163,13610171,G,GAATATTAC,8
NC_037353.1,NC_032675.1,13146184,13671274,13671275,T,TC,1
NC_037353.1,NC_032675.1,13191902,13718342,13718343,T,TY,1
NC_037353.1,NC_032675.1,13233401,13759832,13759833,a,at,1
NC_037353.1,NC_032675.1,13234906,13761343,13761350,G,GGCAGCGT,7
NC_037353.1,NC_032675.1,13237974,13764418,13764419,T,TA,1
NC_037353.1,NC_032675.1,13240235,13766727,13766728,C,CA,1
NC_037353.1,NC_032675.1,13255444,13781937,13781938,T,TC,1
NC_037353.1,NC_032675.1,13255587,13782079,13782081,G,GGA,2
NC_037353.1,NC_032675.1,13257421,13783605,13783606,G,GT,1
NC_037353.1,NC_032675.1,13274819,13801006,13801008,a,atg,2
NC_037353.1,NC_032675.1,13362852,13900006,13900007,c,ct,1
NC_037353.1,NC_032675.1,13392093,13928990,13928991,G,GS,1
NC_037353.1,NC_032675.1,13405808,13942706,13942710,t,taatg,4
NC_037353.1,NC_032675.1,13416819,13953721,13953724,a,aaac,3
NC_037353.1,NC_032675.1,13423617,13960522,13960523,A,AG,1
NC_037353.1,NC_032675.1,13423620,13960526,13960527,T,TA,1
NC_037353.1,NC_032675.1,13441902,13978815,13978816,t,ta,1
NC_037353.1,NC_032675.1,13445452,13982372,13982373,a,ag,1
NC_037353.1,NC_032675.1,13543704,14119415,14119418,A,AATC,3
NC_037353.1,NC_032675.1,13592221,14167937,14167939,C,CTA,2
NC_037353.1,NC_032675.1,13651488,14227213,14227214,c,ca,1
NC_037353.1,NC_032675.1,13704039,14279763,14279764,C,CY,1
NC_037353.1,NC_032675.1,13760830,14037372,14037373,g,gt,1
NC_037353.1,NC_032675.1,13767922,14044466,14044467,g,ga,1
NC_037353.1,NC_032675.1,13768546,14045091,14045092,a,ag,1
NC_037353.1,NC_032675.1,13841952,14418981,14418982,t,ta,1
NC_037353.1,NC_032675.1,13857950,14434992,14434994,a,aat,2
NC_037353.1,NC_032675.1,13886343,14464526,14464529,A,AATG,3
NC_037353.1,NC_032675.1,13911065,14489248,14489249,A,AW,1
NC_037353.1,NC_032675.1,13929546,14507731,14507732,t,ta,1
NC_037353.1,NC_032675.1,13931535,14509721,14509722,t,tg,1
NC_037353.1,NC_032675.1,13934656,14512843,14512845,A,ACT,2
NC_037353.1,NC_032675.1,13936670,14514859,14514860,A,AR,1
NC_037353.1,NC_032675.1,13945601,14523797,14523798,c,ct,1
NC_037353.1,NC_032675.1,13952669,14530899,14530902,A,AAAC,3
NC_037353.1,NC_032675.1,13953113,14531346,14531348,T,TTA,2
NC_037353.1,NC_032675.1,13992861,14571585,14571586,c,ct,1
NC_037353.1,NC_032675.1,13994536,14573261,14573262,c,ct,1
NC_037353.1,NC_032675.1,14002773,14581506,14581507,c,ct,1
NC_037353.1,NC_032675.1,14010091,14593962,14593963,c,ct,1
NC_037353.1,NC_032675.1,14010104,14593976,14593977,c,ca,1
NC_037353.1,NC_032675.1,14010113,14593986,14593987,G,GN,1
NC_037353.1,NC_032675.1,14062043,14646077,14646080,t,tgta,3
NC_037353.1,NC_032675.1,14076743,14660683,14660684,C,CY,1
NC_037353.1,NC_032675.1,14081308,14665259,14665261,A,ATT,2
NC_037353.1,NC_032675.1,14150666,14745129,14745131,T,TTC,2
NC_037353.1,NC_032675.1,14155673,14750139,14750140,t,ta,1
NC_037353.1,NC_032675.1,14157950,14752420,14752421,t,tg,1
NC_037353.1,NC_032675.1,14179908,14774457,14774458,a,at,1
NC_037353.1,NC_032675.1,14363636,14958975,14958976,t,ta,1
NC_037353.1,NC_032675.1,14420747,15016088,15016090,g,ggt,2
NC_037353.1,NC_032675.1,14560522,15164283,15164284,G,GA,1
NC_037353.1,NC_032675.1,14561305,15165067,15165069,g,gaa,2
NC_037353.1,NC_032675.1,14705005,15309878,15309881,a,aaac,3
NC_037353.1,NC_032675.1,14864462,15472068,15472072,t,ttttg,4
NC_037353.1,NC_032675.1,14867249,15474859,15474860,T,TG,1
NC_037353.1,NC_032675.1,14868713,15476324,15476325,C,CA,1
NC_037353.1,NC_032675.1,14920180,15527778,15527779,A,AW,1
NC_037353.1,NC_032675.1,14938455,15546057,15546058,G,GA,1
NC_037353.1,NC_032675.1,14951879,15559517,15559521,t,tttta,4
NC_037353.1,NC_032675.1,15027767,15600283,15600284,a,ag,1
NC_037353.1,NC_032675.1,15036648,15634161,15634162,C,CM,1
NC_037353.1,NC_032675.1,15057926,15655444,15655445,G,GC,1
NC_037353.1,NC_032675.1,15062969,15660489,15660491,a,acc,2
NC_037353.1,NC_032675.1,15065176,15662698,15662699,C,CA,1
NC_037353.1,NC_032675.1,15108165,5929573,5929578,A,AGGAGG,5
NC_037353.1,NC_032675.1,15150802,5972171,5972172,c,ct,1
NC_037353.1,NC_032675.1,15150809,5972179,5972180,t,tc,1
NC_037353.1,NC_032675.1,15151064,5972434,5972436,T,TTG,2
NC_037353.1,NC_032675.1,15151082,5972454,5972455,C,CA,1
NC_037353.1,NC_032675.1,15151465,5972839,5972840,G,GC,1
NC_037353.1,NC_032675.1,15151525,5972901,5972902,A,AK,1
NC_037353.1,NC_032675.1,15203530,15680065,15680066,A,AG,1
NC_037353.1,NC_032675.1,15239917,15688079,15688080,T,TW,1
NC_037353.1,NC_032675.1,15290870,15738840,15738841,a,at,1
NC_037353.1,NC_032675.1,15321254,15769223,15769224,G,GA,1
NC_037353.1,NC_032675.1,15366796,15816792,15816793,g,gt,1
NC_037353.1,NC_032675.1,15381752,15831752,15831753,A,AT,1
NC_037353.1,NC_032675.1,15466125,15915843,15915844,g,ga,1
NC_037353.1,NC_032675.1,15481817,15931439,15931440,A,AC,1
NC_037353.1,NC_032675.1,15504510,15954141,15954144,t,taaa,3
NC_037353.1,NC_032675.1,15587085,16036728,16036729,g,ga,1
NC_037353.1,NC_032675.1,15589884,16039530,16039531,t,ta,1
NC_037353.1,NC_032675.1,15600877,16077891,16077892,T,TC,1
NC_037353.1,NC_032675.1,15613901,16090915,16090916,A,AR,1
NC_037353.1,NC_032675.1,15648552,16125572,16125573,c,ca,1
NC_037353.1,NC_032675.1,15705058,16182084,16182089,T,TGTATA,5
NC_037353.1,NC_032675.1,15705743,16182773,16182774,t,tg,1
NC_037353.1,NC_032675.1,15706562,16183593,16183604,G,GCTTCCTATTGT,11
NC_037353.1,NC_032675.1,15776834,16259801,16259828,T,TTACCTCTTTGCACTTGGGAGAAAATAG,27
NC_037353.1,NC_032675.1,15822511,16306745,16306746,C,CG,1
NC_037353.1,NC_032675.1,15856767,16341055,16341056,a,ac,1
NC_037353.1,NC_032675.1,15877826,16362098,16362099,t,tK,1
NC_037353.1,NC_032675.1,15908400,16392255,16392256,t,ta,1
NC_037353.1,NC_032675.1,15909276,16393131,16393132,T,TA,1
NC_037353.1,NC_032675.1,15987273,16470312,16470313,T,TW,1
NC_037353.1,NC_032675.1,16111286,16594232,16594233,t,ta,1
NC_037353.1,NC_032675.1,16154718,16642222,16642223,G,GA,1
NC_037353.1,NC_032675.1,16219862,16707375,16707376,C,CA,1
NC_037353.1,NC_032675.1,16219870,16707384,16707385,C,CT,1
NC_037353.1,NC_032675.1,16222082,16709597,16709598,A,AR,1
NC_037353.1,NC_032675.1,16331017,16818236,16818237,t,tc,1
NC_037353.1,NC_032675.1,16336964,16822823,16822832,g,gggaaacagt,9
NC_037353.1,NC_032675.1,16349681,16835542,16835543,c,ca,1
NC_037353.1,NC_032675.1,16383459,16869270,16869271,c,ct,1
NC_037353.1,NC_032675.1,16419877,16906220,16906221,t,ta,1
NC_037353.1,NC_032675.1,16557453,17044590,17044593,a,aaag,3
NC_037353.1,NC_032675.1,16577217,17063668,17063669,a,at,1
NC_037353.1,NC_032675.1,16691535,17173160,17173161,a,aN,1
NC_037353.1,NC_032675.1,16722492,17204117,17204119,a,agg,2
NC_037353.1,NC_032675.1,16754276,17235904,17235905,T,TK,1
NC_037353.1,NC_032675.1,16786621,17268104,17268106,A,ACW,2
NC_037353.1,NC_032675.1,16788271,17269759,17269764,a,aacttM,5
NC_037353.1,NC_032675.1,16797029,17278517,17278524,G,GCTTAACA,7
NC_037353.1,NC_032675.1,16804861,17293747,17293748,A,AC,1
NC_037353.1,NC_032675.1,16808916,17297748,17297750,a,agt,2
NC_037353.1,NC_032675.1,16944392,17433392,17433397,c,cagggg,5
NC_037353.1,NC_032675.1,16983634,17472636,17472637,c,ct,1
NC_037353.1,NC_032675.1,17007974,17496928,17496929,A,AG,1
NC_037353.1,NC_032675.1,17011868,17500823,17500848,T,TTCGATGCAAGCATCAGAATCCCTGG,25
NC_037353.1,NC_032675.1,17018324,17507304,17507337,g,gctcattcaggGNNNNNNNNNNNNNNNNNNNNNN,33
NC_037353.1,NC_032675.1,17030158,17519183,17519184,C,CY,1
NC_037353.1,NC_032675.1,17051761,17540871,17540889,G,GGTGGGTGTGTAACAGACA,18
NC_037353.1,NC_032675.1,17068946,17558074,17558075,A,AG,1
NC_037353.1,NC_032675.1,17083338,17572471,17572483,g,ggataaagaagat,12
NC_037353.1,NC_032675.1,17146102,17635131,17635132,g,ga,1
NC_037353.1,NC_032675.1,17155352,17644384,17644385,g,gc,1
NC_037353.1,NC_032675.1,17180373,17669269,17669271,t,tac,2
NC_037353.1,NC_032675.1,17184873,17673772,17673794,A,ATaggagtcacacagctagtttt,22
NC_037353.1,NC_032675.1,17191145,17680066,17680067,a,at,1
NC_037353.1,NC_032675.1,17396384,17948561,17948564,a,actc,3
NC_037353.1,NC_032675.1,17530686,18082095,18082096,T,TA,1
NC_037353.1,NC_032675.1,17537077,18088295,18088296,A,AR,1
NC_037353.1,NC_032675.1,17539425,18090644,18090645,C,CA,1
NC_037353.1,NC_032675.1,17545817,18097036,18097037,T,TY,1
NC_037353.1,NC_032675.1,17570675,18121895,18121896,c,ct,1
NC_037353.1,NC_032675.1,17570887,18122108,18122109,g,gt,1
NC_037353.1,NC_032675.1,17577809,18129032,18129034,c,caa,2
NC_037353.1,NC_032675.1,17577872,18129097,18129100,t,tNNN,3
NC_037353.1,NC_032675.1,17577972,18129201,18129202,a,at,1
NC_037353.1,NC_032675.1,17578051,18129281,18129282,g,gt,1
NC_037353.1,NC_032675.1,17578154,18129385,18129386,g,gt,1
NC_037353.1,NC_032675.1,17578185,18129417,18129418,t,ta,1
NC_037353.1,NC_032675.1,17578646,18129879,18129883,t,tttcc,4
NC_037353.1,NC_032675.1,17664772,18226992,18226994,c,ctg,2
NC_037353.1,NC_032675.1,17664856,18227078,18227079,c,ct,1
NC_037353.1,NC_032675.1,17679605,18241877,18241878,C,CT,1
NC_037353.1,NC_032675.1,17684989,18247262,18247263,A,AG,1
NC_037353.1,NC_032675.1,17696473,18258749,18258750,a,at,1
NC_037353.1,NC_032675.1,17723630,18285911,18285912,T,TW,1
NC_037353.1,NC_032675.1,17740213,18302495,18302496,T,TC,1
NC_037353.1,NC_032675.1,17781970,18344851,18344871,T,TGCTGGGGGTGAGGGTTACCA,20
NC_037353.1,NC_032675.1,17782475,18345409,18345410,t,ta,1
NC_037353.1,NC_032675.1,17784056,18346991,18346992,G,GA,1
NC_037353.1,NC_032675.1,17784573,18347509,18347510,c,ca,1
NC_037353.1,NC_032675.1,17789519,18352476,18352485,g,ggcaggagga,9
NC_037353.1,NC_032675.1,17860675,18423642,18423651,a,acactgtttc,9
NC_037353.1,NC_032675.1,17881928,18444903,18444904,A,AG,1
NC_037353.1,NC_032675.1,17927998,18490442,18490443,G,GA,1
NC_037353.1,NC_032675.1,17950052,18512370,18512372,g,ggt,2
NC_037353.1,NC_032675.1,18051839,18614026,18614027,G,GR,1
NC_037353.1,NC_032675.1,20728854,21158591,21158592,T,TG,1
NC_037353.1,NC_032675.1,20762110,21191638,21191639,T,TA,1
NC_037353.1,NC_032675.1,20810686,21240349,21240350,A,AG,1
NC_037353.1,NC_032675.1,20817263,21246929,21246931,g,gca,2
NC_037353.1,NC_032675.1,20823487,21253157,21253159,C,CAA,2
NC_037353.1,NC_032675.1,20837845,21267517,21267521,a,aaacc,4
NC_037353.1,NC_032675.1,20885465,21315345,21315346,C,CG,1
NC_037353.1,NC_032675.1,20888550,21318362,21318364,a,aag,2
NC_037353.1,NC_032675.1,20895573,21325297,21325299,A,AAG,2
NC_037353.1,NC_032675.1,20916752,21348849,21348850,a,at,1
NC_037353.1,NC_032675.1,20929630,21361769,21361770,a,aM,1
NC_037353.1,NC_032675.1,20940835,21372976,21372978,T,TTA,2
NC_037353.1,NC_032675.1,20942418,21374561,21374562,T,TN,1
NC_037353.1,NC_032675.1,20944571,21376723,21376726,g,gttc,3
NC_037353.1,NC_032675.1,20947539,21379478,21379494,t,tagttttttgaatgtca,16
NC_037353.1,NC_032675.1,21010708,21410338,21410339,T,TK,1
NC_037353.1,NC_032675.1,21021753,21421386,21421393,C,CNNNNNNN,7
NC_037353.1,NC_032675.1,21049148,21448797,21448798,C,CY,1
NC_037353.1,NC_032675.1,21057154,21456806,21456807,A,AW,1
NC_037353.1,NC_032675.1,21058230,21457883,21457884,A,AW,1
NC_037353.1,NC_032675.1,21060027,21459679,21459680,C,CA,1
NC_037353.1,NC_032675.1,21060801,21460454,21460455,T,TY,1
NC_037353.1,NC_032675.1,21082818,21482473,21482475,a,aNN,2
NC_037353.1,NC_032675.1,21288644,21673179,21673180,A,AT,1
NC_037353.1,NC_032675.1,21323825,21708287,21708288,C,CT,1
NC_037353.1,NC_032675.1,21356699,21741176,21741177,T,TK,1
NC_037353.1,NC_032675.1,21388541,21773030,21773032,c,ctg,2
NC_037353.1,NC_032675.1,21415421,21799912,21799936,g,gCCTGCAGACGGTTCTCCNNNNNNN,24
NC_037353.1,NC_032675.1,21482210,21867403,21867404,a,ag,1
NC_037353.1,NC_032675.1,21498365,21883561,21883563,t,ttg,2
NC_037353.1,NC_032675.1,21570539,21955919,21955920,A,AR,1
NC_037353.1,NC_032675.1,21597265,21985333,21985337,t,tgttg,4
NC_037353.1,NC_032675.1,21684878,22097286,22097289,a,atat,3
NC_037353.1,NC_032675.1,21856951,22269579,22269583,c,catga,4
NC_037353.1,NC_032675.1,21856956,22269588,22269589,g,ga,1
NC_037353.1,NC_032675.1,21860760,22273396,22273397,G,GR,1
NC_037353.1,NC_032675.1,21942077,22357175,22357204,t,tctctgtgaacccagggactgcagcgtgtc,29
NC_037353.1,NC_032675.1,21973856,22388993,22388995,G,GGA,2
NC_037353.1,NC_032675.1,22096767,22511827,22511828,C,CT,1
NC_037353.1,NC_032675.1,22135840,22550899,22550900,T,TK,1
NC_037353.1,NC_032675.1,22232894,22647969,22647970,t,tc,1
NC_037353.1,NC_032675.1,22245418,22660494,22660495,A,AG,1
NC_037353.1,NC_032675.1,22290871,22705969,22705970,G,GC,1
NC_037353.1,NC_032675.1,22296315,22711414,22711415,G,GC,1
NC_037353.1,NC_032675.1,22453092,22868088,22868090,t,tta,2
NC_037353.1,NC_032675.1,22551936,22965910,22965911,G,GA,1
NC_037353.1,NC_032675.1,22569274,22983251,22983252,T,TN,1
NC_037353.1,NC_032675.1,22646122,23060796,23060797,c,ca,1
NC_037353.1,NC_032675.1,22792454,23106818,23106819,C,CY,1
NC_037353.1,NC_032675.1,23034065,23596828,23596829,C,CA,1
NC_037353.1,NC_032675.1,23034152,23596915,23596917,A,AAG,2
NC_037353.1,NC_032675.1,23034285,23597048,23597049,C,CT,1
NC_037353.1,NC_032675.1,23098218,23660860,23660861,T,TC,1
NC_037353.1,NC_032675.1,23098794,23661439,23661440,G,GA,1
NC_037353.1,NC_032675.1,23107074,23669427,23669428,T,TK,1
NC_037353.1,NC_032675.1,23115805,23678160,23678161,A,AR,1
NC_037353.1,NC_032675.1,23280203,23804186,23804188,c,cgt,2
NC_037353.1,NC_032675.1,23292862,23816849,23816850,g,gt,1
NC_037353.1,NC_032675.1,23315566,24338816,24338817,a,ac,1
NC_037353.1,NC_032675.1,23330459,24353720,24353725,a,atttat,5
NC_037353.1,NC_032675.1,23356581,24379731,24379733,C,CTA,2
NC_037353.1,NC_032675.1,23356581,23850835,23850837,C,CTA,2
NC_037353.1,NC_032675.1,23361463,23855737,23855738,a,aN,1
NC_037353.1,NC_032675.1,23379276,24402533,24402534,G,GC,1
NC_037353.1,NC_032675.1,23381302,24404560,24404562,c,caa,2
NC_037353.1,NC_032675.1,23381968,24405228,24405230,t,tgg,2
NC_037353.1,NC_032675.1,23382079,24405341,24405342,c,ct,1
NC_037353.1,NC_032675.1,23415831,23909144,23909147,G,GATA,3
NC_037353.1,NC_032675.1,23418389,23911705,23911708,G,GATT,3
NC_037353.1,NC_032675.1,23461820,23922237,23922238,t,tg,1
NC_037353.1,NC_032675.1,23467177,23927367,23927368,g,gt,1
NC_037353.1,NC_032675.1,23581883,24045699,24045700,t,tc,1
NC_037353.1,NC_032675.1,23617692,24081507,24081513,A,ATATTCT,6
NC_037353.1,NC_032675.1,23620726,24084543,24084544,T,TC,1
NC_037353.1,NC_032675.1,23620964,24084782,24084805,C,CTGGGGTGCCACAGTTCTTCTCCT,23
NC_037353.1,NC_032675.1,23622424,24086265,24086269,C,CAGTG,4
NC_037353.1,NC_032675.1,23623734,24087579,24087585,A,ACTCTCC,6
NC_037353.1,NC_032675.1,23653564,24117414,24117415,a,ag,1
NC_037353.1,NC_032675.1,23653620,24117470,24117471,a,at,1
NC_037353.1,NC_032675.1,23660964,24124815,24124816,a,aR,1
NC_037353.1,NC_032675.1,23677058,24140899,24140900,C,CT,1
NC_037353.1,NC_032675.1,23739699,24203572,24203573,a,at,1
NC_037353.1,NC_032675.1,23837441,24299881,24299882,G,GA,1
NC_037353.1,NC_032675.1,23870202,24434070,24434078,t,tNNNNNNNN,8
NC_037353.1,NC_032675.1,23923246,24487128,24487129,C,CT,1
NC_037353.1,NC_032675.1,23928902,24492796,24492797,C,CY,1
NC_037353.1,NC_032675.1,23936674,24500569,24500570,c,ct,1
NC_037353.1,NC_032675.1,23948829,24512724,24512725,a,aN,1
NC_037353.1,NC_032675.1,23963547,24527439,24527440,c,ct,1
NC_037353.1,NC_032675.1,24094249,24704100,24704103,a,aaac,3
NC_037353.1,NC_032675.1,24138228,24748007,24748017,C,CCTCCACTCAG,10
NC_037353.1,NC_032675.1,24139948,24749737,24749738,T,TG,1
NC_037353.1,NC_032675.1,24155301,24765090,24765091,G,GR,1
NC_037353.1,NC_032675.1,24159030,24768821,24768822,C,CT,1
NC_037353.1,NC_032675.1,24179632,24788884,24788885,C,CT,1
NC_037353.1,NC_032675.1,24190564,24799817,24799818,C,CM,1
NC_037353.1,NC_032675.1,24297001,24957198,24957199,A,AR,1
NC_037353.1,NC_032675.1,24298449,24958650,24958651,A,AC,1
NC_037353.1,NC_032675.1,24362099,25022328,25022330,t,tNN,2
NC_037353.1,NC_032675.1,24749326,25130526,25130528,T,TAC,2
NC_037353.1,NC_032675.1,24792946,25174156,25174161,T,TAAAAC,5
NC_037353.1,NC_032675.1,24797364,25178578,25178579,G,GC,1
NC_037353.1,NC_032675.1,24804856,25186072,25186090,C,CAAACAGTTAGATTAGTTN,18
NC_037353.1,NC_032675.1,24809304,25190539,25190540,g,gt,1
NC_037353.1,NC_032675.1,24817225,25198474,25198477,g,gttt,3
NC_037353.1,NC_032675.1,24820305,25201557,25201561,T,TACTC,4
NC_037353.1,NC_032675.1,24824878,25206134,25206139,A,ACACAG,5
NC_037353.1,NC_032675.1,24827465,25208719,25208721,C,CTA,2
NC_037353.1,NC_032675.1,24827468,25208724,25208725,A,AT,1
NC_037353.1,NC_032675.1,24830072,25211038,25211042,C,CTTCT,4
NC_037353.1,NC_032675.1,24830520,25211488,25211489,A,AT,1
NC_037353.1,NC_032675.1,24830701,25211671,25211677,A,ATTTAAT,6
NC_037353.1,NC_032675.1,24857097,25238078,25238079,T,TG,1
NC_037353.1,NC_032675.1,24888575,25269560,25269579,A,ATATCAACTATTGANNNNNN,19
NC_037353.1,NC_032675.1,24894424,25275431,25275432,T,TA,1
NC_037353.1,NC_032675.1,24910974,25303259,25303260,a,at,1
NC_037353.1,NC_032675.1,24924762,25316533,25316534,A,AT,1
NC_037353.1,NC_032675.1,24925749,25317119,25317126,g,gaaagtga,7
NC_037353.1,NC_032675.1,24934844,25326225,25326227,T,TTC,2
NC_037353.1,NC_032675.1,24945474,25336859,25336861,T,TYA,2
NC_037353.1,NC_032675.1,24975281,25366672,25366673,T,TK,1
NC_037353.1,NC_032675.1,24981567,25372968,25372969,T,TK,1
NC_037353.1,NC_032675.1,24984755,25376156,25376157,C,CS,1
NC_037353.1,NC_032675.1,24987466,25378868,25378869,A,AT,1
NC_037353.1,NC_032675.1,25039294,25430720,25430721,G,GK,1
NC_037353.1,NC_032675.1,25131189,25522874,25522878,g,gtgtt,4
NC_037353.1,NC_032675.1,25134058,25525749,25525755,t,tNNNNNN,6
NC_037353.1,NC_032675.1,25136332,25528028,25528029,c,ct,1
NC_037353.1,NC_032675.1,25136388,25528085,25528090,G,GTCTCA,5
NC_037353.1,NC_032675.1,25152721,25544769,25544770,A,AR,1
NC_037353.1,NC_032675.1,25153096,25545147,25545148,T,TG,1
NC_037353.1,NC_032675.1,25169345,25586905,25586925,G,GGCGGGCGAGGGTTATANNNN,20
NC_037353.1,NC_032675.1,25170277,25587861,25587862,a,ac,1
NC_037353.1,NC_032675.1,25174533,25592118,25592119,A,AR,1
NC_037353.1,NC_032675.1,25183012,25600594,25600595,A,AW,1
NC_037353.1,NC_032675.1,25201934,25619517,25619518,A,AG,1
NC_037353.1,NC_032675.1,25201937,25619521,25619536,C,CGGGCTGCCAGCGCCT,15
NC_037353.1,NC_032675.1,25205089,25622688,25622689,T,TA,1
NC_037353.1,NC_032675.1,25240799,25658422,25658423,c,ct,1
NC_037353.1,NC_032675.1,25241243,25658866,25658868,c,cag,2
NC_037353.1,NC_032675.1,25242579,25660204,25660205,T,TY,1
NC_037353.1,NC_032675.1,25330990,25698123,25698126,g,gttt,3
NC_037353.1,NC_032675.1,25390972,25758310,25758311,C,CA,1
NC_037353.1,NC_032675.1,25394343,25761678,25761680,t,tca,2
NC_037353.1,NC_032675.1,25422558,25789579,25789581,C,CCT,2
NC_037353.1,NC_032675.1,25425303,25792324,25792325,T,TA,1
NC_037353.1,NC_032675.1,25438404,25805014,25805015,a,at,1
NC_037353.1,NC_032675.1,25458123,25824719,25824722,c,ccgg,3
NC_037353.1,NC_032675.1,25471409,25838000,25838021,T,TCATAGTGTCTAACAATTCTAA,21
NC_037353.1,NC_032675.1,25472910,25839521,25839522,T,TA,1
NC_037353.1,NC_032675.1,25801803,25885531,25885533,C,CTA,2
NC_037353.1,NC_032675.1,25857520,25932033,25932034,t,tc,1
NC_037353.1,NC_032675.1,25860110,25934625,25934626,c,ca,1
NC_037353.1,NC_032675.1,25885090,25959610,25959615,G,GTATAA,5
NC_037353.1,NC_032675.1,25909798,25984325,25984326,a,aC,1
NC_037353.1,NC_032675.1,25917496,25992023,25992024,a,ag,1
NC_037353.1,NC_032675.1,25917686,25992214,25992216,c,ctg,2
NC_037353.1,NC_032675.1,25945680,26020297,26020298,g,gt,1
NC_037353.1,NC_032675.1,25945683,26020301,26020302,g,ga,1
NC_037353.1,NC_032675.1,26040525,26115843,26115844,T,TC,1
NC_037353.1,NC_032675.1,26053722,26129037,26129038,G,GT,1
NC_037353.1,NC_032675.1,26070187,26145509,26145513,a,aaatc,4
NC_037353.1,NC_032675.1,26074924,26150247,26150248,A,AR,1
NC_037353.1,NC_032675.1,26093444,26168777,26168778,A,AT,1
NC_037353.1,NC_032675.1,26150135,26225537,26225538,g,ga,1
NC_037353.1,NC_032675.1,26198046,26269344,26269354,A,AAGTGTATCAC,10
NC_037353.1,NC_032675.1,26222394,26293875,26293876,A,AG,1
NC_037353.1,NC_032675.1,26225458,26296895,26296896,g,ga,1
NC_037353.1,NC_032675.1,26229557,26300995,26300996,A,AG,1
NC_037353.1,NC_032675.1,26264773,26336041,26336042,t,tg,1
NC_037353.1,NC_032675.1,26304008,26375462,26375463,c,ca,1
NC_037353.1,NC_032675.1,26312434,26383889,26383890,T,TG,1
NC_037353.1,NC_032675.1,26343643,26415126,26415128,g,gtN,2
NC_037353.1,NC_032675.1,26343648,26415133,26415134,t,tg,1
NC_037353.1,NC_032675.1,26343811,26415296,26415297,G,GR,1
NC_037353.1,NC_032675.1,26366080,26437300,26437301,T,TG,1
NC_037353.1,NC_032675.1,26372207,26443430,26443431,t,tg,1
NC_037353.1,NC_032675.1,26395091,26450300,26450301,t,ta,1
NC_037353.1,NC_032675.1,26415481,26473921,26473923,A,AAC,2
NC_037353.1,NC_032675.1,26458748,26520490,26520502,t,tcagccttcttca,12
NC_037353.1,NC_032675.1,26461342,26523101,26523102,C,CT,1
NC_037353.1,NC_032675.1,26468153,26529912,26529914,t,ttg,2
NC_037353.1,NC_032675.1,26486900,26548656,26548658,T,TAA,2
NC_037353.1,NC_032675.1,26504910,26566671,26566672,T,TA,1
NC_037353.1,NC_032675.1,26632894,26694662,26694663,A,AT,1
NC_037353.1,NC_032675.1,26636008,26697777,26697778,A,AG,1
NC_037353.1,NC_032675.1,26651663,26713555,26713556,t,ta,1
NC_037353.1,NC_032675.1,26705929,26767827,26767828,C,CG,1
NC_037353.1,NC_032675.1,26716604,26778500,26778501,G,GR,1
NC_037353.1,NC_032675.1,26850931,26914289,26914292,G,GAAA,3
NC_037353.1,NC_032675.1,26858623,26921982,26921991,c,ccagttctaa,9
NC_037353.1,NC_032675.1,26865013,26928383,26928384,A,AC,1
NC_037353.1,NC_032675.1,26865073,26928444,26928445,G,GK,1
NC_037353.1,NC_032675.1,26875092,26938462,26938466,t,tNNNN,4
NC_037353.1,NC_032675.1,26894120,26957465,26957466,t,tg,1
NC_037353.1,NC_032675.1,26931434,26999681,26999682,T,TG,1
NC_037353.1,NC_032675.1,26963248,27031493,27031494,g,gK,1
NC_037353.1,NC_032675.1,26964254,27032500,27032506,a,aatatat,6
NC_037353.1,NC_032675.1,26972602,27045722,27045723,T,TN,1
NC_037353.1,NC_032675.1,26998666,27071944,27071946,c,ctg,2
NC_037353.1,NC_032675.1,27010136,27083416,27083417,g,gt,1
NC_037353.1,NC_032675.1,27020772,27094055,27094056,a,at,1
NC_037353.1,NC_032675.1,27043252,27116547,27116548,t,tg,1
NC_037353.1,NC_032675.1,27081649,27154946,27154947,c,ct,1
NC_037353.1,NC_032675.1,27102128,27175237,27175238,c,ct,1
NC_037353.1,NC_032675.1,27355298,27489702,27489705,a,aaac,3
NC_037353.1,NC_032675.1,27356047,27490454,27490455,g,gt,1
NC_037353.1,NC_032675.1,27505653,27628047,27628049,c,ctt,2
NC_037353.1,NC_032675.1,27526549,27648924,27648925,A,AR,1
NC_037353.1,NC_032675.1,27526887,27649264,27649265,A,AG,1
NC_037353.1,NC_032675.1,27526928,27649307,27649308,A,AT,1
NC_037353.1,NC_032675.1,27527009,27649390,27649391,A,AS,1
NC_037353.1,NC_032675.1,27557614,27680007,27680008,a,aM,1
NC_037353.1,NC_032675.1,27559340,27681734,27681735,C,CY,1
NC_037353.1,NC_032675.1,27573317,27697517,27697518,t,tg,1
NC_037353.1,NC_032675.1,27612954,27737157,27737158,T,TY,1
NC_037353.1,NC_032675.1,27649805,27774000,27774001,t,tg,1
NC_037353.1,NC_032675.1,27657650,27780313,27780314,C,CT,1
NC_037353.1,NC_032675.1,27731349,27854200,27854201,t,ta,1
NC_037353.1,NC_032675.1,27754897,27877658,27877659,T,TC,1
NC_037353.1,NC_032675.1,27795978,27918739,27918741,a,att,2
NC_037353.1,NC_032675.1,27806891,27929655,27929656,c,ct,1
NC_037353.1,NC_032675.1,27835240,27958017,27958021,T,TAGAC,4
NC_037353.1,NC_032675.1,27874538,27997345,27997346,T,TA,1
NC_037353.1,NC_032675.1,27917918,28040731,28040733,t,taa,2
NC_037353.1,NC_032675.1,27922702,28045517,28045518,t,tg,1
NC_037353.1,NC_032675.1,27970705,28093533,28093536,C,CCTG,3
NC_037353.1,NC_032675.1,27976277,28099109,28099121,t,tgggaaatagatg,12
NC_037353.1,NC_032675.1,28001183,28124027,28124028,t,tg,1
NC_037353.1,NC_032675.1,28028819,28151667,28151668,g,ga,1
NC_037353.1,NC_032675.1,28030043,28152892,28152894,t,taa,2
NC_037353.1,NC_032675.1,28051855,28174717,28174721,a,aNNNN,4
NC_037353.1,NC_032675.1,28053939,28176838,28176840,A,AAT,2
NC_037353.1,NC_032675.1,28055714,28178620,28178621,A,AT,1
NC_037353.1,NC_032675.1,28059095,28182007,28182015,t,ttttttttc,8
NC_037353.1,NC_032675.1,28065141,28188066,28188069,t,ttcc,3
NC_037353.1,NC_032675.1,28090798,28213728,28213729,t,ta,1
NC_037353.1,NC_032675.1,28111756,28239252,28239253,A,AN,1
NC_037353.1,NC_032675.1,28145433,28272930,28272931,t,tg,1
NC_037353.1,NC_032675.1,28151527,28279024,28279026,t,tNN,2
NC_037353.1,NC_032675.1,28393327,28518955,28518956,a,ac,1
NC_037353.1,NC_032675.1,28393859,28519488,28519489,a,at,1
NC_037353.1,NC_032675.1,28394969,28520600,28520601,a,at,1
NC_037353.1,NC_032675.1,28472448,28597651,28597657,t,tNNNNNN,6
NC_037353.1,NC_032675.1,28490402,28615164,28615165,G,GC,1
NC_037353.1,NC_032675.1,28492989,28617232,28617236,C,CACAA,4
NC_037353.1,NC_032675.1,28504003,28628251,28628252,T,TA,1
NC_037353.1,NC_032675.1,28507178,28631427,28631431,A,AAAAT,4
NC_037353.1,NC_032675.1,28507584,28631837,28631845,c,ctctctctt,8
NC_037353.1,NC_032675.1,28513783,28638059,28638060,G,GA,1
NC_037353.1,NC_032675.1,28535821,28660051,28660052,C,CA,1
NC_037353.1,NC_032675.1,28783255,28908926,28908927,a,ag,1
NC_037353.1,NC_032675.1,28790256,28915928,28915948,g,gagacatgactttacctccaa,20
NC_037353.1,NC_032675.1,28804349,28930036,28930039,c,caaa,3
NC_037353.1,NC_032675.1,28809067,28934757,28934760,C,CTCT,3
NC_037353.1,NC_032675.1,28816539,28942233,28942235,a,aNN,2
NC_037353.1,NC_032675.1,28890517,29016234,29016245,c,cgtttttttttt,11
NC_037353.1,NC_032675.1,28942817,29068535,29068539,t,tNNNN,4
NC_037353.1,NC_032675.1,28956599,29082333,29082334,G,GY,1
NC_037353.1,NC_032675.1,28959257,29085001,29085002,c,ct,1
NC_037353.1,NC_032675.1,28967466,29093245,29093247,a,aat,2
NC_037353.1,NC_032675.1,28984371,29110149,29110154,t,tctctc,5
NC_037353.1,NC_032675.1,28990734,29116523,29116524,t,tc,1
NC_037353.1,NC_032675.1,29121841,29250988,29250991,T,TTTC,3
NC_037353.1,NC_032675.1,29193571,29331854,29331855,t,tc,1
NC_037353.1,NC_032675.1,29194790,29333074,29333082,a,aaaaANNNN,8
NC_037353.1,NC_032675.1,29210968,29349284,29349285,t,ta,1
NC_037353.1,NC_032675.1,29219258,29301325,29301326,g,ga,1
NC_037353.1,NC_032675.1,29233968,29432011,29432012,t,tg,1
NC_037353.1,NC_032675.1,29248827,29446870,29446871,t,ta,1
NC_037353.1,NC_032675.1,29257227,29455270,29455272,c,cat,2
NC_037353.1,NC_032675.1,29262360,29460405,29460413,c,ctttttttt,8
NC_037353.1,NC_032675.1,29266571,29464551,29464552,a,ac,1
NC_037353.1,NC_032675.1,29268553,29466534,29466535,G,GT,1
NC_037353.1,NC_032675.1,29278099,29476091,29476094,A,AAAT,3
NC_037353.1,NC_032675.1,29282533,29480528,29480529,C,CA,1
NC_037353.1,NC_032675.1,29285922,29483921,29483922,a,ac,1
NC_037353.1,NC_032675.1,29293958,29491958,29491959,A,AC,1
NC_037353.1,NC_032675.1,29328991,29527024,29527033,T,TACCATGCAC,9
NC_037353.1,NC_032675.1,29331823,29529865,29529869,T,TATAA,4
NC_037353.1,NC_032675.1,29331828,29529874,29529876,A,AGG,2
NC_037353.1,NC_032675.1,29343371,29541418,29541419,C,CA,1
NC_037353.1,NC_032675.1,29358372,29556420,29556438,g,gaaaaacatctatttctgc,18
NC_037353.1,NC_032675.1,29358460,29556526,29556527,a,ac,1
NC_037353.1,NC_032675.1,29367977,29566045,29566046,a,ag,1
NC_037353.1,NC_032675.1,29373072,29571140,29571141,t,tg,1
NC_037353.1,NC_032675.1,29406471,29604548,29604549,t,tg,1
NC_037353.1,NC_032675.1,29506249,29693252,29693267,t,tactgtgtcccacagg,15
NC_037353.1,NC_032675.1,29506695,29693713,29693714,t,tg,1
NC_037353.1,NC_032675.1,29515681,29702685,29702686,a,ag,1
NC_037353.1,NC_032675.1,29532045,29719015,29719016,a,at,1
NC_037353.1,NC_032675.1,29550555,29737525,29737534,t,ttgagaaatc,9
NC_037353.1,NC_032675.1,29607781,29794477,29794478,a,ac,1
NC_037353.1,NC_032675.1,29646987,29825212,29825213,A,AG,1
NC_037353.1,NC_032675.1,29648342,29826568,29826570,t,taa,2
NC_037353.1,NC_032675.1,29651370,29829597,29829602,G,GTAGGT,5
NC_037353.1,NC_032675.1,29658021,29836256,29836257,a,at,1
NC_037353.1,NC_032675.1,29660286,29838523,29838524,a,ag,1
NC_037353.1,NC_032675.1,29702204,29874751,29874756,A,AAAATG,5
NC_037353.1,NC_032675.1,29704551,29877102,29877103,a,at,1
NC_037353.1,NC_032675.1,29704826,29877375,29877376,C,CA,1
NC_037353.1,NC_032675.1,29726424,29898974,29898975,g,ga,1
NC_037353.1,NC_032675.1,29729187,29901736,29901737,C,CT,1
NC_037353.1,NC_032675.1,29731371,29903921,29903922,g,gt,1
NC_037353.1,NC_032675.1,29732075,29904625,29904626,c,cg,1
NC_037353.1,NC_032675.1,29734395,29906965,29906966,a,at,1
NC_037353.1,NC_032675.1,29758191,29930785,29930786,A,AR,1
NC_037353.1,NC_032675.1,29760935,29933529,29933530,c,ca,1
NC_037353.1,NC_032675.1,29776937,29949361,29949362,T,TG,1
NC_037353.1,NC_032675.1,29800004,29972198,29972206,a,atgtatatg,8
NC_037353.1,NC_032675.1,29903364,30077661,30077663,C,CAG,2
NC_037353.1,NC_032675.1,29913511,30087832,30087833,C,CT,1
NC_037353.1,NC_032675.1,29913586,30087908,30087909,A,AC,1
NC_037353.1,NC_032675.1,29925310,30138384,30138385,T,TN,1
NC_037353.1,NC_032675.1,29927821,30140897,30140898,A,AN,1
NC_037353.1,NC_032675.1,29927847,30102175,30102176,C,CT,1
NC_037353.1,NC_032675.1,29932992,30146068,30146070,c,ctt,2
NC_037353.1,NC_032675.1,29942121,30155208,30155233,c,caacgagatccaatcagtccattctg,25
NC_037353.1,NC_032675.1,29949369,30162484,30162485,g,gc,1
NC_037353.1,NC_032675.1,29955730,30168755,30168775,t,tacacacacacacacacacac,20
NC_037353.1,NC_032675.1,29965845,30178886,30178887,a,at,1
NC_037353.1,NC_032675.1,29997833,30210576,30210577,A,AC,1
NC_037353.1,NC_032675.1,29997833,30061644,30061645,A,AC,1
NC_037353.1,NC_032675.1,30015882,30228536,30228537,t,ta,1
NC_037353.1,NC_032675.1,30027130,30238736,30238737,G,GA,1
NC_037353.1,NC_032675.1,30036572,30249710,30249711,T,TC,1
NC_037353.1,NC_032675.1,30055974,30269226,30269227,g,gc,1
NC_037353.1,NC_032675.1,30148087,30401604,30401607,t,tcta,3
NC_037353.1,NC_032675.1,30150293,30403812,30403813,t,tN,1
NC_037353.1,NC_032675.1,30150599,30404115,30404116,c,ct,1
NC_037353.1,NC_032675.1,30240074,30496402,30496412,A,ACACATAGAGC,10
NC_037353.1,NC_032675.1,30252051,30506392,30506394,t,tNN,2
NC_037353.1,NC_032675.1,30295986,30550140,30550142,a,aat,2
NC_037353.1,NC_032675.1,30374609,30628272,30628273,T,TW,1
NC_037353.1,NC_032675.1,30379588,30633252,30633253,g,gt,1
NC_037353.1,NC_032675.1,30381454,30635122,30635124,T,TCA,2
NC_037353.1,NC_032675.1,30407285,30728054,30728055,G,GK,1
NC_037353.1,NC_032675.1,30426757,30747529,30747531,T,TTA,2
NC_037353.1,NC_032675.1,30443547,30770601,30770602,A,AG,1
NC_037353.1,NC_032675.1,30571888,30936452,30936456,t,tNNNN,4
NC_037353.1,NC_032675.1,30666709,31031261,31031265,A,AATTT,4
NC_037353.1,NC_032675.1,30781854,31146658,31146659,c,ct,1
NC_037353.1,NC_032675.1,30867840,31232009,31232010,c,ca,1
NC_037353.1,NC_032675.1,30875789,31239959,31239967,A,ATGAACAAC,8
NC_037353.1,NC_032675.1,30881766,31245947,31245948,G,GA,1
NC_037353.1,NC_032675.1,30952370,31316450,31316456,G,GGAGCAR,6
NC_037353.1,NC_032675.1,31034729,31416451,31416452,G,GC,1
NC_037353.1,NC_032675.1,31051523,31433266,31433278,c,ctttgcgacccca,12
NC_037353.1,NC_032675.1,31055625,31437394,31437396,C,CTG,2
NC_037353.1,NC_032675.1,31055741,31437512,31437514,G,GTA,2
NC_037353.1,NC_032675.1,31064454,31446236,31446237,C,CG,1
NC_037353.1,NC_032675.1,31064755,31446538,31446543,t,ttttca,5
NC_037353.1,NC_032675.1,31074488,31456271,31456275,G,GGGGA,4
NC_037353.1,NC_032675.1,31128895,31510683,31510696,A,ACTAATTTTATCCC,13
NC_037353.1,NC_032675.1,31190106,31571912,31571913,A,AT,1
NC_037353.1,NC_032675.1,31202835,31584643,31584644,T,TS,1
NC_037353.1,NC_032675.1,31221493,31603302,31603304,a,aNN,2
NC_037353.1,NC_032675.1,31316101,31697624,31697626,c,caa,2
NC_037353.1,NC_032675.1,31326840,31708497,31708517,T,TCCACAGTAACTTTCATAGGA,20
NC_037353.1,NC_032675.1,31361221,31742902,31742903,T,TY,1
NC_037353.1,NC_032675.1,31367538,31749223,31749226,A,ATAG,3
NC_037353.1,NC_032675.1,31381019,31762521,31762522,A,AG,1
NC_037353.1,NC_032675.1,31390515,31772018,31772019,c,ca,1
NC_037353.1,NC_032675.1,31390519,31772023,31772025,c,cca,2
NC_037353.1,NC_032675.1,31390556,31772062,31772063,a,ac,1
NC_037353.1,NC_032675.1,31390612,31772119,31772121,c,cca,2
NC_037353.1,NC_032675.1,31390761,31772272,31772274,c,cNN,2
NC_037353.1,NC_032675.1,31412221,31793736,31793737,a,at,1
NC_037353.1,NC_032675.1,31425171,31806686,31806687,T,TA,1
NC_037353.1,NC_032675.1,31456303,31837821,31837824,T,TAAG,3
NC_037353.1,NC_032675.1,31474932,31856451,31856452,t,ta,1
NC_037353.1,NC_032675.1,31489139,31870660,31870661,T,TA,1
NC_037353.1,NC_032675.1,31522414,31903809,31903813,t,tgata,4
NC_037353.1,NC_032675.1,31530031,31911430,31911431,A,AR,1
NC_037353.1,NC_032675.1,31582309,31973478,31973479,g,ga,1
NC_037353.1,NC_032675.1,31623814,32017179,32017180,A,AC,1
NC_037353.1,NC_032675.1,31668634,32062136,32062137,t,tg,1
NC_037353.1,NC_032675.1,31696566,32090075,32090076,T,TC,1
NC_037353.1,NC_032675.1,31835265,32228970,32228971,c,ca,1
NC_037353.1,NC_032675.1,31839992,32233698,32233700,c,cct,2
NC_037353.1,NC_032675.1,31854055,32247981,32247982,c,ct,1
NC_037353.1,NC_032675.1,31937170,32332931,32332934,C,CNNN,3
NC_037353.1,NC_032675.1,31938904,32334667,32334668,C,CT,1
NC_037353.1,NC_032675.1,32018720,32414505,32414506,c,ca,1
NC_037353.1,NC_032675.1,32031744,32427532,32427535,a,acag,3
NC_037353.1,NC_032675.1,32038948,32434758,32434759,C,CM,1
NC_037353.1,NC_032675.1,32132231,32564846,32564852,t,tNNNNNN,6
NC_037353.1,NC_032675.1,32154140,32586762,32586774,t,tatagtgaaggac,12
NC_037353.1,NC_032675.1,32155853,32588488,32588491,t,tctc,3
NC_037353.1,NC_032675.1,32171471,32604109,32604113,t,ttttg,4
NC_037353.1,NC_032675.1,32183750,32616394,32616395,A,AW,1
NC_037353.1,NC_032675.1,32190330,32624768,32624779,A,ATAATTACATTG,11
NC_037353.1,NC_032675.1,32197046,32631495,32631496,a,at,1
NC_037353.1,NC_032675.1,32203776,32638326,32638327,T,TC,1
NC_037353.1,NC_032675.1,32273138,32707698,32707699,A,AT,1
NC_037353.1,NC_032675.1,32275789,32710350,32710351,C,CT,1
NC_037353.1,NC_032675.1,32284739,32719303,32719304,c,ca,1
NC_037353.1,NC_032675.1,32326157,32761303,32761304,t,tc,1
NC_037353.1,NC_032675.1,32498297,32995806,32995808,A,AAC,2
NC_037353.1,NC_032675.1,32512014,33009527,33009528,t,tg,1
NC_037353.1,NC_032675.1,32528898,33026408,33026409,C,CA,1
NC_037353.1,NC_032675.1,32530029,33027540,33027541,T,TA,1
NC_037353.1,NC_032675.1,32533586,33031100,33031101,a,ag,1
NC_037353.1,NC_032675.1,32644248,33166712,33166714,t,tta,2
NC_037353.1,NC_032675.1,32644910,33167375,33167376,G,GA,1
NC_037353.1,NC_032675.1,32644933,33167399,33167403,C,CTGTA,4
NC_037353.1,NC_032675.1,32672945,33195426,33195427,G,GS,1
NC_037353.1,NC_032675.1,32765094,33287590,33287591,t,ta,1
NC_037353.1,NC_032675.1,32831587,33354124,33354125,G,GR,1
NC_037353.1,NC_032675.1,32844858,33367530,33367531,a,aN,1
NC_037353.1,NC_032675.1,32851558,33374230,33374231,T,TC,1
NC_037353.1,NC_032675.1,32859141,33381814,33381815,G,GC,1
NC_037353.1,NC_032675.1,32891565,33414243,33414244,A,AW,1
NC_037353.1,NC_032675.1,32952491,33474915,33474916,a,aR,1
NC_037353.1,NC_032675.1,32964625,33487050,33487051,C,CY,1
NC_037353.1,NC_032675.1,33018419,33541867,33541869,A,AGT,2
NC_037353.1,NC_032675.1,33021367,33544818,33544819,C,CY,1
NC_037353.1,NC_032675.1,33051143,33574601,33574602,T,TY,1
NC_037353.1,NC_032675.1,33064266,33587732,33587733,A,AM,1
NC_037353.1,NC_032675.1,33084546,33651086,33651087,T,TG,1
NC_037353.1,NC_032675.1,33104428,33627573,33627576,a,aaag,3
NC_037353.1,NC_032675.1,33105163,33671704,33671705,t,tN,1
NC_037353.1,NC_032675.1,33159774,33724793,33724795,g,gta,2
NC_037353.1,NC_032675.1,33180373,33745391,33745393,T,TTC,2
NC_037353.1,NC_032675.1,33186689,33751710,33751711,t,tg,1
NC_037353.1,NC_032675.1,33233812,33798850,33798851,a,ag,1
NC_037353.1,NC_032675.1,33280765,33845926,33845927,G,GT,1
NC_037353.1,NC_032675.1,33287284,33852451,33852452,G,GC,1
NC_037353.1,NC_032675.1,33293879,33859047,33859067,g,gagtgggctgccatgccttcc,20
NC_037353.1,NC_032675.1,33370638,33935774,33935775,T,TC,1
NC_037353.1,NC_032675.1,33381186,33946397,33946400,G,GAGT,3
NC_037353.1,NC_032675.1,33397526,33963059,33963060,g,ga,1
NC_037353.1,NC_032675.1,33433783,33999319,33999320,T,TW,1
NC_037353.1,NC_032675.1,33485809,34049413,34049414,G,GC,1
NC_037353.1,NC_032675.1,33508481,34072100,34072105,T,TAAAAR,5
NC_037353.1,NC_032675.1,33611564,34175194,34175198,A,ACACT,4
NC_037353.1,NC_032675.1,33650181,34213604,34213606,A,AAG,2
NC_037353.1,NC_032675.1,33665686,34229108,34229109,G,GK,1
NC_037353.1,NC_032675.1,33670810,34234233,34234235,T,TAA,2
NC_037353.1,NC_032675.1,33681552,34244931,34244960,T,TGACACCCTGTTTTAAGAGTGGATGGTGAA,29
NC_037353.1,NC_032675.1,33716967,34280393,34280394,c,ca,1
NC_037353.1,NC_032675.1,33718520,34281946,34281948,t,tca,2
NC_037353.1,NC_032675.1,33735011,34298440,34298441,G,GR,1
NC_037353.1,NC_032675.1,33756214,34319525,34319526,a,at,1
NC_037353.1,NC_032675.1,33769724,34333045,34333046,T,TA,1
NC_037353.1,NC_032675.1,33793460,34356775,34356776,T,TY,1
NC_037353.1,NC_032675.1,33808124,34372030,34372038,A,ATNNACTGT,8
NC_037353.1,NC_032675.1,33808961,34372875,34372876,a,ag,1
NC_037353.1,NC_032675.1,33816259,34380174,34380177,A,AGAW,3
NC_037353.1,NC_032675.1,33883254,34447358,34447374,C,CAANNNNNNNNNNNNNN,16
NC_037353.1,NC_032675.1,33982734,34546857,34546858,C,CA,1
NC_037353.1,NC_032675.1,34006422,34570517,34570518,C,CY,1
NC_037353.1,NC_032675.1,34009454,34574334,34574335,a,ag,1
NC_037353.1,NC_032675.1,34111784,34676867,34676868,a,ag,1
NC_037353.1,NC_032675.1,34146113,34711281,34711284,A,AATG,3
NC_037353.1,NC_032675.1,34177869,34743038,34743039,t,ta,1
NC_037353.1,NC_032675.1,34509576,35074627,35074628,a,ag,1
NC_037353.1,NC_032675.1,34591799,35157220,35157221,T,TM,1
NC_037353.1,NC_032675.1,34646678,35210253,35210254,A,AG,1
NC_037353.1,NC_032675.1,34661887,35266507,35266508,T,TC,1
NC_037353.1,NC_032675.1,34834831,35437664,35437665,G,GC,1
NC_037353.1,NC_032675.1,35154344,35758376,35758377,A,AR,1
NC_037353.1,NC_032675.1,35283426,35795365,35795366,c,ct,1
NC_037353.1,NC_032675.1,35297683,35809624,35809639,A,AGCACACAGACTTAGG,15
NC_037353.1,NC_032675.1,35303339,35815298,35815300,g,gca,2
NC_037353.1,NC_032675.1,35325937,35837765,35837767,T,TAC,2
NC_037353.1,NC_032675.1,35334082,35845935,35845936,t,ta,1
NC_037353.1,NC_032675.1,35336463,35848314,35848325,G,GTGATCACCATA,11
NC_037353.1,NC_032675.1,35346308,35858145,35858146,G,GR,1
NC_037353.1,NC_032675.1,35424669,35936586,35936587,A,AT,1
NC_037353.1,NC_032675.1,35424677,35936595,35936596,C,CA,1
NC_037353.1,NC_032675.1,35434450,35946372,35946373,a,ac,1
NC_037353.1,NC_032675.1,35443547,35955472,35955473,G,GA,1
NC_037353.1,NC_032675.1,35450148,35962146,35962147,T,TA,1
NC_037353.1,NC_032675.1,35453300,35965299,35965308,a,aaaatgaagc,9
NC_037353.1,NC_032675.1,35460019,35972019,35972020,A,AG,1
NC_037353.1,NC_032675.1,35468799,35980802,35980803,G,GA,1
NC_037353.1,NC_032675.1,35469942,35981946,35981947,T,TK,1
NC_037353.1,NC_032675.1,35487050,35997505,35997506,c,ct,1
NC_037353.1,NC_032675.1,35625472,36138265,36138269,A,AAAAC,4
NC_037353.1,NC_032675.1,35693157,36205962,36205963,G,GA,1
NC_037353.1,NC_032675.1,35698540,36211581,36211582,t,tc,1
NC_037353.1,NC_032675.1,35704879,36217922,36217924,A,ACC,2
NC_037353.1,NC_032675.1,35768889,36282344,36282345,a,at,1
NC_037353.1,NC_032675.1,35769030,36282486,36282489,t,tccc,3
NC_037353.1,NC_032675.1,35903829,36419858,36419870,A,ACTTCATATATAT,12
NC_037353.1,NC_032675.1,35909019,36425059,36425061,G,GAC,2
NC_037353.1,NC_032675.1,35925840,36441883,36441884,C,CY,1
NC_037353.1,NC_032675.1,35926503,36442546,36442548,A,AAT,2
NC_037353.1,NC_032675.1,35940011,36456055,36456056,t,ta,1
NC_037353.1,NC_032675.1,35940727,36456772,36456773,G,GC,1
NC_037353.1,NC_032675.1,35946543,36462590,36462591,A,AC,1
NC_037353.1,NC_032675.1,36012585,36520039,36520040,G,GC,1
NC_037353.1,NC_032675.1,36024318,36531773,36531777,T,TTGAA,4
NC_037353.1,NC_032675.1,36032004,36539465,36539466,T,TC,1
NC_037353.1,NC_032675.1,36039344,36546805,36546806,G,GT,1
NC_037353.1,NC_032675.1,36049891,36557346,36557349,g,gtct,3
NC_037353.1,NC_032675.1,36054089,36561542,36561546,G,GTACA,4
NC_037353.1,NC_032675.1,36054708,36562165,36562166,A,AG,1
NC_037353.1,NC_032675.1,36054854,36562312,36562318,c,ccctatg,6
NC_037353.1,NC_032675.1,36090771,36597545,36597546,g,gc,1
NC_037353.1,NC_032675.1,36093346,36600121,36600122,t,ta,1
NC_037353.1,NC_032675.1,36093429,36600205,36600206,t,ta,1
NC_037353.1,NC_032675.1,36112745,36620335,36620336,t,ta,1
NC_037353.1,NC_032675.1,36240911,36748628,36748629,C,CT,1
NC_037353.1,NC_032675.1,36268306,36776019,36776020,T,TC,1
NC_037353.1,NC_032675.1,36270442,36778157,36778160,C,CAGA,3
NC_037353.1,NC_032675.1,36279727,36787444,36787445,c,ct,1
NC_037353.1,NC_032675.1,36310745,36818399,36818401,g,gtc,2
NC_037353.1,NC_032675.1,36317647,36825399,36825402,c,ctca,3
NC_037353.1,NC_032675.1,36318250,36826005,36826008,c,ctct,3
NC_037353.1,NC_032675.1,36319187,36826947,36826948,t,tg,1
NC_037353.1,NC_032675.1,36319967,36827720,36827721,t,tg,1
NC_037353.1,NC_032675.1,36321391,36829147,36829156,a,atgtgagagt,9
NC_037353.1,NC_032675.1,36321395,36829160,36829162,a,act,2
NC_037353.1,NC_032675.1,36323867,36831635,36831637,c,cct,2
NC_037353.1,NC_032675.1,36346705,36854476,36854477,t,tg,1
NC_037353.1,NC_032675.1,36365446,36873608,36873609,G,GT,1
NC_037353.1,NC_032675.1,36374031,36882348,36882350,C,CCW,2
NC_037353.1,NC_032675.1,36387575,36895283,36895292,a,acactgtttc,9
NC_037353.1,NC_032675.1,36388055,36895772,36895773,a,ag,1
NC_037353.1,NC_032675.1,36388825,36896531,36896534,t,tctc,3
NC_037353.1,NC_032675.1,36390295,36898004,36898005,a,ac,1
NC_037353.1,NC_032675.1,36393544,36901251,36901252,t,tg,1
NC_037353.1,NC_032675.1,36395620,36903328,36903329,g,gt,1
NC_037353.1,NC_032675.1,36395631,36903340,36903341,g,gt,1
NC_037353.1,NC_032675.1,36402269,36909761,36909766,C,CAGATG,5
NC_037353.1,NC_032675.1,36413742,36921661,36921662,T,TY,1
NC_037353.1,NC_032675.1,36427856,36935795,36935796,a,at,1
NC_037353.1,NC_032675.1,36437042,36944979,36944980,A,AR,1
NC_037353.1,NC_032675.1,36488099,36996039,36996040,G,GC,1
NC_037353.1,NC_032675.1,36525835,37033862,37033863,c,ct,1
NC_037353.1,NC_032675.1,36538352,37046375,37046376,c,ct,1
NC_037353.1,NC_032675.1,36630734,37140992,37140993,T,TY,1
NC_037353.1,NC_032675.1,36660584,37170843,37170844,G,GA,1
NC_037353.1,NC_032675.1,36695719,37205983,37205984,g,gt,1
NC_037353.1,NC_032675.1,36920884,37429246,37429249,a,aNNN,3
NC_037353.1,NC_032675.1,36920955,37429320,37429321,g,gt,1
NC_037353.1,NC_032675.1,36920971,37429337,37429338,g,gt,1
NC_037353.1,NC_032675.1,36921102,37429469,37429470,t,tN,1
NC_037353.1,NC_032675.1,36925282,37433651,37433652,c,ca,1
NC_037353.1,NC_032675.1,36927903,37436274,37436275,t,ta,1
NC_037353.1,NC_032675.1,36980627,37489001,37489002,A,AK,1
NC_037353.1,NC_032675.1,36994276,37502651,37502653,A,AGG,2
NC_037353.1,NC_032675.1,36994314,37502691,37502692,C,CT,1
NC_037353.1,NC_032675.1,36997805,37506183,37506187,T,TCAAA,4
NC_037353.1,NC_032675.1,37025156,37533541,37533542,c,ct,1
NC_037353.1,NC_032675.1,37030062,37538448,37538449,A,AC,1
NC_037353.1,NC_032675.1,37030290,37538677,37538678,T,TN,1
NC_037353.1,NC_032675.1,37086260,37594664,37594665,C,CT,1
NC_037353.1,NC_032675.1,37099147,37607132,37607133,G,GT,1
NC_037353.1,NC_032675.1,37099149,37607135,37607138,A,AATG,3
NC_037353.1,NC_032675.1,37106064,37613089,37613090,A,AG,1
NC_037353.1,NC_032675.1,37110318,37617344,37617345,A,AG,1
NC_037353.1,NC_032675.1,37112512,37619539,37619548,t,tttgttgttg,9
NC_037353.1,NC_032675.1,37351204,37857771,37857772,a,ag,1
NC_037353.1,NC_032675.1,37352591,37859161,37859162,t,ta,1
NC_037353.1,NC_032675.1,37355075,37861686,37861687,t,ta,1
NC_037353.1,NC_032675.1,37357042,37863654,37863655,C,CA,1
NC_037353.1,NC_032675.1,37468468,37975058,37975059,C,CS,1
NC_037353.1,NC_032675.1,37474714,37981228,37981229,T,TA,1
NC_037353.1,NC_032675.1,37530128,38035791,38035792,A,AG,1
NC_037353.1,NC_032675.1,37533020,38038684,38038685,C,CY,1
NC_037353.1,NC_032675.1,37539010,38044687,38044689,G,GTC,2
NC_037353.1,NC_032675.1,37557012,38062985,38062986,T,TA,1
NC_037353.1,NC_032675.1,37557079,38063052,38063053,T,TG,1
NC_037353.1,NC_032675.1,37590756,38096955,38096956,t,ta,1
NC_037353.1,NC_032675.1,37603925,38110128,38110130,T,TTS,2
NC_037353.1,NC_032675.1,37618925,38125136,38125137,C,CM,1
NC_037353.1,NC_032675.1,37629343,38135056,38135057,G,GT,1
NC_037353.1,NC_032675.1,37641583,38147295,38147296,a,at,1
NC_037353.1,NC_032675.1,37661518,38167125,38167134,t,tgacTTCATg,9
NC_037353.1,NC_032675.1,37714354,38219795,38219796,G,GR,1
NC_037353.1,NC_032675.1,37714515,38219957,38219962,A,ATACTW,5
NC_037353.1,NC_032675.1,37714759,38220206,38220207,T,TY,1
NC_037353.1,NC_032675.1,37718668,38224118,38224119,g,ga,1
NC_037353.1,NC_032675.1,37719173,38224626,38224627,C,CM,1
NC_037353.1,NC_032675.1,37735744,38241201,38241202,T,TK,1
NC_037353.1,NC_032675.1,37769017,38289375,38289377,C,CCG,2
NC_037353.1,NC_032675.1,37775849,38296202,38296218,t,tgtgtgtgtgtgcgcgc,16
NC_037353.1,NC_032675.1,37777218,38297582,38297584,T,TTC,2
NC_037353.1,NC_032675.1,37803483,38323474,38323480,g,ggggtta,6
NC_037353.1,NC_032675.1,37841384,38361396,38361397,G,GS,1
NC_037353.1,NC_032675.1,37922496,38442110,38442111,A,AG,1
NC_037353.1,NC_032675.1,37963238,38482859,38482861,c,cca,2
NC_037353.1,NC_032675.1,38145434,38665055,38665057,c,caa,2
NC_037353.1,NC_032675.1,38159664,38679075,38679078,c,cttt,3
NC_037353.1,NC_032675.1,38159830,38679236,38679237,t,tg,1
NC_037353.1,NC_032675.1,38159880,38679287,38679291,g,gtctc,4
NC_037353.1,NC_032675.1,38159995,38679406,38679407,t,ta,1
NC_037353.1,NC_032675.1,38161316,38680727,38680773,g,gaggatagctcagtaggaaaattcagtgaagaaaagaggctgaaata,46
NC_037353.1,NC_032675.1,38860267,39358371,39358372,t,tc,1
NC_037353.1,NC_032675.1,38876067,39374094,39374095,g,ga,1
NC_037353.1,NC_032675.1,38910458,39408316,39408317,t,tc,1
NC_037353.1,NC_032675.1,39016483,39513852,39513853,A,AR,1
NC_037353.1,NC_032675.1,39016644,39514013,39514014,T,TW,1
NC_037353.1,NC_032675.1,39102981,39600315,39600318,a,agag,3
NC_037353.1,NC_032675.1,39463602,40045062,40045064,T,TCC,2
NC_037353.1,NC_032675.1,39733048,40348289,40348290,t,ta,1
NC_037353.1,NC_032675.1,40085452,40700958,40700959,C,CA,1
NC_037353.1,NC_032675.1,40174866,40790944,40790945,G,GC,1
NC_037353.1,NC_032675.1,40220614,40836648,40836713,A,ACCCATGAACTAGTTAGGGAGGGTAAGGGAGAGAACNNNNNNNNNNNNNNNNNNNNNNNNNNACGT,65
NC_037353.1,NC_032675.1,40302985,40919036,40919038,c,ctt,2
NC_037353.1,NC_032675.1,40481806,41097902,41097903,A,AG,1
NC_037353.1,NC_032675.1,40486079,41102179,41102180,t,tc,1
NC_037353.1,NC_032675.1,40487056,41103157,41103158,c,ct,1
NC_037353.1,NC_032675.1,40497089,41113191,41113196,a,actgat,5
NC_037353.1,NC_032675.1,40509078,41125188,41125189,g,ga,1
NC_037353.1,NC_032675.1,40644687,41261086,41261095,T,TGCATTCTTA,9
NC_037353.1,NC_032675.1,40757644,41374067,41374076,C,CCTTTCCAGS,9
NC_037353.1,NC_032675.1,40775625,41392057,41392058,A,AR,1
NC_037353.1,NC_032675.1,40808993,41425446,41425448,a,att,2
NC_037353.1,NC_032675.1,40811814,41428283,41428284,T,TA,1
NC_037353.1,NC_032675.1,40812016,41428486,41428488,c,cat,2
NC_037353.1,NC_032675.1,40814427,41430900,41430901,A,AC,1
NC_037353.1,NC_032675.1,40832789,41449265,41449266,g,gc,1
NC_037353.1,NC_032675.1,40832793,41449270,41449271,t,ta,1
NC_037353.1,NC_032675.1,40881640,41498123,41498132,a,acagaggagc,9
NC_037353.1,NC_032675.1,40909072,41525564,41525565,T,TC,1
NC_037353.1,NC_032675.1,40975917,41662349,41662350,T,TA,1
NC_037353.1,NC_032675.1,40984724,41671157,41671159,c,cgT,2
NC_037353.1,NC_032675.1,40994076,41680511,41680512,T,TC,1
NC_037353.1,NC_032675.1,41011884,41736414,41736415,T,TC,1
NC_037353.1,NC_032675.1,41146644,41870556,41870557,a,ac,1
NC_037353.1,NC_032675.1,41215212,41938986,41939002,t,tcatatatatatatata,16
NC_037353.1,NC_032675.1,41235709,41959501,41959502,a,ag,1
NC_037353.1,NC_032675.1,41275920,41999720,41999721,T,TC,1
NC_037353.1,NC_032675.1,41298290,42022092,42022093,g,ga,1
NC_037353.1,NC_032675.1,41310851,42034655,42034656,A,AC,1
NC_037353.1,NC_032675.1,41311160,42034967,42034988,A,ANNNNNNNNNNNNNNNNNNNNN,21
NC_037353.1,NC_032675.1,41314997,42038825,42038827,t,tgc,2
NC_037353.1,NC_032675.1,41350934,42074810,42074819,T,TGTTTGGAGR,9
NC_037353.1,NC_032675.1,41407121,42130956,42130959,t,ttta,3
NC_037353.1,NC_032675.1,41407784,42131622,42131626,g,gagta,4
NC_037353.1,NC_032675.1,41461496,42185333,42185334,t,ta,1
NC_037353.1,NC_032675.1,41467816,42191654,42191655,G,GA,1
NC_037353.1,NC_032675.1,41485908,42209765,42209767,A,ATT,2
NC_037353.1,NC_032675.1,41487928,42211786,42211787,C,CA,1
NC_037353.1,NC_032675.1,41655295,42378998,42379000,G,GTC,2
NC_037353.1,NC_032675.1,41831445,42553325,42553326,G,GS,1
NC_037353.1,NC_032675.1,41857038,42578918,42578931,c,cttcactttcactt,13
NC_037353.1,NC_032675.1,41860630,42583716,42583717,c,ct,1
NC_037353.1,NC_032675.1,41866931,42590018,42590019,g,ga,1
NC_037353.1,NC_032675.1,41866951,42590039,42590040,t,ta,1
NC_037353.1,NC_032675.1,41942968,42666991,42666999,c,cattttgat,8
NC_037353.1,NC_032675.1,42064362,42789155,42789156,C,CA,1
NC_037353.1,NC_032675.1,42101826,42826621,42826622,G,GC,1
NC_037353.1,NC_032675.1,42108049,42832820,42832821,C,CG,1
NC_037353.1,NC_032675.1,42113935,42838628,42838630,c,ctg,2
NC_037353.1,NC_032675.1,42391676,43115991,43115992,A,AR,1
NC_037353.1,NC_032675.1,42413867,43137962,43137963,T,TG,1
NC_037353.1,NC_032675.1,42415954,43140050,43140052,t,taa,2
NC_037353.1,NC_032675.1,42417903,43142001,43142010,G,GTCCAGGTGT,9
NC_037353.1,NC_032675.1,42419709,43143820,43143821,T,TA,1
NC_037353.1,NC_032675.1,42420580,43144692,43144693,T,TC,1
NC_037353.1,NC_032675.1,42421734,43145847,43145852,A,ATTACC,5
NC_037353.1,NC_032675.1,42422048,43146151,43146155,t,taaaa,4
NC_037353.1,NC_032675.1,42422925,43147031,43147032,C,CA,1
NC_037353.1,NC_032675.1,42674154,43355409,43355410,G,GT,1
NC_037353.1,NC_032675.1,42675122,43356379,43356385,A,AAAACAG,6
NC_037353.1,NC_032675.1,42681587,43362850,43362851,C,CT,1
NC_037353.1,NC_032675.1,42692098,43373362,43373366,A,ATACT,4
NC_037353.1,NC_032675.1,42692304,43373572,43373577,A,AAGGAC,5
NC_037353.1,NC_032675.1,42929629,43612000,43612001,C,CS,1
NC_037353.1,NC_032675.1,42933119,43615492,43615493,T,TY,1
NC_037353.1,NC_032675.1,42966572,43648962,43648963,T,TC,1
NC_037353.1,NC_032675.1,42970464,43653227,43653228,t,ta,1
NC_037353.1,NC_032675.1,43179811,43990262,43990263,C,CA,1
NC_037353.1,NC_032675.1,43197559,44008010,44008017,T,TTCGGTTC,7
NC_037353.1,NC_032675.1,43379761,44190235,44190252,c,ccaagcccgtgtgccaca,17
NC_037353.1,NC_032675.1,43399453,44213056,44213058,t,ttc,2
NC_037353.1,NC_032675.1,43419642,44233227,44233230,C,CNNN,3
NC_037353.1,NC_032675.1,43446150,44259734,44259735,C,CY,1
NC_037353.1,NC_032675.1,43464689,44278267,44278268,T,TG,1
NC_037353.1,NC_032675.1,43483928,44297515,44297523,T,TGAAGGTAA,8
NC_037353.1,NC_032675.1,43798332,44660009,44660010,T,TG,1
NC_037353.1,NC_032675.1,43798444,44660122,44660123,C,CN,1
NC_037353.1,NC_032675.1,43912804,44869801,44869803,G,GAA,2
NC_037353.1,NC_032675.1,43935128,44892124,44892125,G,GC,1
NC_037353.1,NC_032675.1,43968444,44942382,44942388,a,aaacact,6
NC_037353.1,NC_032675.1,43968861,44942806,44942807,c,cg,1
NC_037353.1,NC_032675.1,43995514,44778054,44778058,a,aNNNN,4
NC_037353.1,NC_032675.1,44331862,45293595,45293596,T,TY,1
NC_037353.1,NC_032675.1,44506755,45475273,45475275,a,aNN,2
NC_037353.1,NC_032675.1,44506933,45475456,45475457,a,at,1
NC_037353.1,NC_032675.1,44506955,45475478,45475479,t,tc,1
NC_037353.1,NC_032675.1,44592205,45560732,45560733,A,AG,1
NC_037353.1,NC_032675.1,44651768,45620079,45620080,C,CS,1
NC_037353.1,NC_032675.1,44705496,45673706,45673713,g,gggggggt,7
NC_037353.1,NC_032675.1,44723504,45691324,45691325,a,at,1
NC_037353.1,NC_032675.1,44789488,45753479,45753480,C,CY,1
NC_037353.1,NC_032675.1,44880476,45844473,45844477,A,AATTT,4
NC_037353.1,NC_032675.1,44987832,45952822,45952823,A,AT,1
NC_037353.1,NC_032675.1,45015970,45980961,45980963,A,ACT,2
NC_037353.1,NC_032675.1,45083253,46062229,46062230,a,aS,1
NC_037353.1,NC_032675.1,45213635,46191578,46191579,G,GS,1
NC_037353.1,NC_032675.1,45237441,46231883,46231884,t,tc,1
NC_037353.1,NC_032675.1,45244404,46222312,46222313,t,tN,1
NC_037353.1,NC_032675.1,45389377,46382589,46382590,a,ag,1
NC_037353.1,NC_032675.1,45450295,46443312,46443313,C,CA,1
NC_037353.1,NC_032675.1,45488169,46481259,46481265,T,TGCACAC,6
NC_037353.1,NC_032675.1,45509495,46502598,46502602,A,AAAAW,4
NC_037353.1,NC_032675.1,45513227,46506333,46506335,C,CAG,2
NC_037353.1,NC_032675.1,45518978,46512088,46512090,c,cgt,2
NC_037353.1,NC_032675.1,45541753,46534863,46534864,C,CT,1
NC_037353.1,NC_032675.1,45541816,46534927,46534930,G,GCTA,3
NC_037353.1,NC_032675.1,45564314,46557433,46557434,A,AG,1
NC_037353.1,NC_032675.1,45570848,46563969,46563971,A,ACT,2
NC_037353.1,NC_032675.1,45637258,46630383,46630384,t,ta,1
NC_037353.1,NC_032675.1,45670457,46663594,46663595,g,ga,1
NC_037353.1,NC_032675.1,45744586,46743593,46743599,t,tgctgaa,6
NC_037353.1,NC_032675.1,45787795,46786815,46786816,A,AT,1
NC_037353.1,NC_032675.1,45794379,46793399,46793400,A,AR,1
NC_037353.1,NC_032675.1,45805104,46804139,46804140,G,GR,1
NC_037353.1,NC_032675.1,45823951,46822989,46822990,g,ga,1
NC_037353.1,NC_032675.1,45891229,46890991,46890993,a,aag,2
NC_037353.1,NC_032675.1,45894116,46893880,46893881,c,ca,1
NC_037353.1,NC_032675.1,45924420,46924087,46924088,T,TC,1
NC_037353.1,NC_032675.1,46004070,47003960,47003961,G,GT,1
NC_037353.1,NC_032675.1,46019059,47018261,47018262,C,CG,1
NC_037353.1,NC_032675.1,46311443,47036002,47036003,A,AG,1
NC_037353.1,NC_032675.1,46316226,47040787,47040788,c,cg,1
NC_037353.1,NC_032675.1,46337446,47062016,47062020,A,AAGAT,4
NC_037353.1,NC_032675.1,46343881,47068455,47068456,a,aN,1
NC_037353.1,NC_032675.1,46364240,47089281,47089285,g,gaaaa,4
NC_037353.1,NC_032675.1,46391680,47142728,47142729,C,CT,1
NC_037353.1,NC_032675.1,46410186,47161163,47161165,c,ctt,2
NC_037353.1,NC_032675.1,46413083,47164063,47164065,c,cat,2
NC_037353.1,NC_032675.1,46432776,47183758,47183760,G,GAC,2
NC_037353.1,NC_032675.1,46432784,47183768,47183769,C,CA,1
NC_037353.1,NC_032675.1,46432796,47183781,47183787,G,GTGTGTT,6
NC_037353.1,NC_032675.1,46480561,47231309,47231310,T,TA,1
NC_037353.1,NC_032675.1,46533797,47383418,47383420,T,TGG,2
NC_037353.1,NC_032675.1,46535205,47384824,47384825,T,TC,1
NC_037353.1,NC_032675.1,46536839,47386459,47386460,T,TK,1
NC_037353.1,NC_032675.1,46543230,47392884,47392885,t,ta,1
NC_037353.1,NC_032675.1,46544418,47394073,47394081,g,gttttgttt,8
NC_037353.1,NC_032675.1,46558808,47408465,47408487,G,GGTTCTGGGGAACCTCTTCCCGC,22
NC_037353.1,NC_032675.1,46571715,47421252,47421254,G,GGC,2
NC_037353.1,NC_032675.1,46572999,47422536,47422538,T,TTC,2
NC_037353.1,NC_032675.1,46603846,47453411,47453412,C,CT,1
NC_037353.1,NC_032675.1,46631522,47480992,47480998,g,ggaaaaa,6
NC_037353.1,NC_032675.1,46759087,47634717,47634718,G,GS,1
NC_037353.1,NC_032675.1,46760261,47635893,47635894,T,TY,1
NC_037353.1,NC_032675.1,46788616,47664246,47664247,a,ac,1
NC_037353.1,NC_032675.1,46798399,47674039,47674041,t,ttg,2
NC_037353.1,NC_032675.1,46799357,47674999,47675000,A,AR,1
NC_037353.1,NC_032675.1,46833037,47708685,47708687,a,atg,2
NC_037353.1,NC_032675.1,46837678,47713329,47713331,A,AAC,2
NC_037353.1,NC_032675.1,46842812,47718463,47718464,a,ag,1
NC_037353.1,NC_032675.1,46853784,47729436,47729450,G,GACTCACAAAGCAAA,14
NC_037353.1,NC_032675.1,46868542,47744210,47744211,C,CA,1
NC_037353.1,NC_032675.1,46868937,47744606,47744607,C,CT,1
NC_037353.1,NC_032675.1,46869582,47745252,47745259,C,CCAGGAAG,7
NC_037353.1,NC_032675.1,46889314,47764991,47764995,t,tacac,4
NC_037353.1,NC_032675.1,46951737,47827419,47827420,G,GR,1
NC_037353.1,NC_032675.1,46977122,47852806,47852808,a,aaN,2
NC_037353.1,NC_032675.1,47014418,47890113,47890114,G,GC,1
NC_037353.1,NC_032675.1,47040517,47916229,47916231,t,tta,2
NC_037353.1,NC_032675.1,47072459,47948173,47948231,a,aagcGCNNNNNNNNNNNNNNNNNNNNNNNNNNNNNNNNNNNNNNNGCGAACGCCATAGT,58
NC_037353.1,NC_032675.1,47082907,47958675,47958677,A,ATT,2
NC_037353.1,NC_032675.1,47084566,47960337,47960339,T,TTC,2
NC_037353.1,NC_032675.1,47099902,47975790,47975791,A,AG,1
NC_037353.1,NC_032675.1,47362057,48220911,48220912,t,ta,1
NC_037353.1,NC_032675.1,47392305,48251176,48251179,a,aaag,3
NC_037353.1,NC_032675.1,47415871,48274750,48274752,a,agt,2
NC_037353.1,NC_032675.1,47415890,48274771,48274783,a,atgtgtgtgtgag,12
NC_037353.1,NC_032675.1,47415906,48274799,48274801,g,gta,2
NC_037353.1,NC_032675.1,47417075,48275938,48275940,a,agt,2
NC_037353.1,NC_032675.1,47417105,48275970,48275976,a,agtgtgt,6
NC_037353.1,NC_032675.1,47418769,48277646,48277647,C,CA,1
NC_037353.1,NC_032675.1,47418779,48277657,48277658,C,CA,1
NC_037353.1,NC_032675.1,47554668,48411073,48411074,G,GS,1
NC_037353.1,NC_032675.1,47606577,48463056,48463057,C,CA,1
NC_037353.1,NC_032675.1,47609036,48465516,48465517,c,ct,1
NC_037353.1,NC_032675.1,47613068,48469549,48469550,G,GA,1
NC_037353.1,NC_032675.1,47621603,48478085,48478086,g,ga,1
NC_037353.1,NC_032675.1,47627404,48483875,48483879,a,acatg,4
NC_037353.1,NC_032675.1,47628055,48484532,48484533,G,GA,1
NC_037353.1,NC_032675.1,47656079,48531899,48531930,a,agcctgccagactcctctgtccacgggattct,31
NC_037353.1,NC_032675.1,47657170,48533021,48533022,T,TG,1
NC_037353.1,NC_032675.1,47674826,48550679,48550680,T,TG,1
NC_037353.1,NC_032675.1,47703844,48579122,48579123,G,GA,1
NC_037353.1,NC_032675.1,47805512,48680791,48680792,T,TC,1
NC_037353.1,NC_032675.1,47826443,48701728,48701729,C,CM,1
NC_037353.1,NC_032675.1,47841139,48716430,48716431,C,CG,1
NC_037353.1,NC_032675.1,47876913,48752395,48752412,c,cacacacacacacactca,17
NC_037353.1,NC_032675.1,47876939,48752438,48752440,a,act,2
NC_037353.1,NC_032675.1,47933889,48809403,48809405,A,AAC,2
NC_037353.1,NC_032675.1,47952507,48828023,48828027,t,tYaca,4
NC_037353.1,NC_032675.1,47974765,48850145,48850146,T,TG,1
NC_037353.1,NC_032675.1,47976478,48851859,48851861,A,AAT,2
NC_037353.1,NC_032675.1,48031807,48906488,48906489,A,AG,1
NC_037353.1,NC_032675.1,48057532,48931980,48931982,T,TTC,2
NC_037353.1,NC_032675.1,48167010,49041262,49041263,A,AR,1
NC_037353.1,NC_032675.1,48169899,49044152,49044163,A,ACGAATGTCCAG,11
NC_037353.1,NC_032675.1,48201584,49075764,49075765,g,gt,1
NC_037353.1,NC_032675.1,48214971,49089153,49089154,a,ac,1
NC_037353.1,NC_032675.1,48286126,49160464,49160465,T,TG,1
NC_037353.1,NC_032675.1,48525116,49413492,49413493,G,GA,1
NC_037353.1,NC_032675.1,48549514,49438127,49438128,A,AR,1
NC_037353.1,NC_032675.1,48674967,49576307,49576308,A,AR,1
NC_037353.1,NC_032675.1,48677755,49579033,49579049,C,CAGAACCGCGTGTGCAG,16
NC_037353.1,NC_032675.1,48690363,49591664,49591666,T,TTC,2
NC_037353.1,NC_032675.1,48784232,49685535,49685536,G,GK,1
NC_037353.1,NC_032675.1,48818433,49719737,49719738,A,AT,1
NC_037353.1,NC_032675.1,48825266,49726572,49726573,G,GS,1
NC_037353.1,NC_032675.1,49096213,49997213,49997214,A,AG,1
NC_037353.1,NC_032675.1,49174363,50074900,50074901,G,GA,1
NC_037353.1,NC_032675.1,49178767,50079264,50079270,A,ATAGTAT,6
NC_037353.1,NC_032675.1,49197663,50098277,50098279,g,gga,2
NC_037353.1,NC_032675.1,49242892,50143512,50143513,C,CY,1
NC_037353.1,NC_032675.1,49246258,50146878,50146879,C,CT,1
NC_037353.1,NC_032675.1,49321935,50219917,50219918,G,GA,1
NC_037353.1,NC_032675.1,49328786,50226780,50226781,A,AC,1
NC_037353.1,NC_032675.1,49345739,50243736,50243737,g,gt,1
NC_037353.1,NC_032675.1,49425559,50324378,50324379,T,TK,1
NC_037353.1,NC_032675.1,49436085,50334897,50334898,G,GA,1
NC_037353.1,NC_032675.1,49460152,50358772,50358773,t,tN,1
NC_037353.1,NC_032675.1,49463789,50362410,50362411,C,CY,1
NC_037353.1,NC_032675.1,49467926,50366550,50366551,G,GC,1
NC_037353.1,NC_032675.1,49473264,50371924,50371925,C,CG,1
NC_037353.1,NC_032675.1,49478059,50375828,50375829,G,GR,1
NC_037353.1,NC_032675.1,49479112,50376884,50376890,t,ttttttc,6
NC_037353.1,NC_032675.1,49479925,50379342,50379351,A,AGTAAGTGTG,9
NC_037353.1,NC_032675.1,49499170,50398583,50398584,T,TK,1
NC_037353.1,NC_032675.1,49502906,50402320,50402321,G,GR,1
NC_037353.1,NC_032675.1,49532198,50431619,50431636,c,cccgccaggttcatctgt,17
NC_037353.1,NC_032675.1,49533436,50432867,50432868,T,TY,1
NC_037353.1,NC_032675.1,49553601,50452811,50452812,A,AC,1
NC_037353.1,NC_032675.1,49559130,50458345,50458346,c,ct,1
NC_037353.1,NC_032675.1,49563303,50462505,50462509,G,GTGGA,4
NC_037353.1,NC_032675.1,49563661,50462867,50462868,T,TG,1
NC_037353.1,NC_032675.1,49591598,50490636,50490640,G,GTTGC,4
NC_037353.1,NC_032675.1,49599211,50498253,50498254,A,AG,1
NC_037353.1,NC_032675.1,49646399,50545445,50545446,G,GA,1
NC_037353.1,NC_032675.1,49651725,50550799,50550800,G,GC,1
NC_037353.1,NC_032675.1,49680724,50579571,50579572,g,gc,1
NC_037353.1,NC_032675.1,49693149,50591890,50591891,c,ct,1
NC_037353.1,NC_032675.1,49720698,50618839,50618840,T,TY,1
NC_037353.1,NC_032675.1,49724130,50622272,50622273,C,CT,1
NC_037353.1,NC_032675.1,49792278,50684333,50684334,a,at,1
NC_037353.1,NC_032675.1,50558271,25859173,25859192,a,agactcttgagagtcccttg,19
NC_037353.1,NC_032675.1,50567304,25868219,25868221,t,ttg,2
NC_037353.1,NC_032675.1,50567758,25868675,25868680,T,TTCCCA,5
NC_037353.1,NC_032675.1,51707643,50874081,50874082,T,TA,1
NC_037353.1,NC_032675.1,51715035,50881474,50881480,a,aNNNNNN,6
NC_037353.1,NC_032675.1,51817792,50936914,50936916,G,GGA,2
NC_037353.1,NC_032675.1,51817834,50936958,50936959,T,TA,1
NC_037353.1,NC_032675.1,51828455,50947437,50947439,g,gca,2
NC_037353.1,NC_032675.1,51828916,50947846,50947847,C,CG,1
NC_037353.1,NC_032675.1,51833758,50952514,50952517,T,TATG,3
NC_037353.1,NC_032675.1,51973562,51113899,51113900,T,TK,1
